date_year,nombre_estado,cve_ent,nombre_municipio,cve_mun,hombres,mujeres,total
2015,Aguascalientes,01,Aguascalientes,01001,438715,456097,894812
2015,Aguascalientes,01,Asientos,01002,23991,24268,48259
2015,Aguascalientes,01,Calvillo,01003,28444,29804,58248
2015,Aguascalientes,01,Cosío,01004,7910,8230,16140
2015,Aguascalientes,01,El Llano,01010,10486,10210,20696
2015,Aguascalientes,01,Jesús María,01005,58317,58233,116550
2015,Aguascalientes,01,Pabellón de Arteaga,01006,23000,24056,47056
2015,Aguascalientes,01,Rincón de Romos,01007,27084,27617,54701
2015,Aguascalientes,01,San Francisco de los Romo,01011,22234,22669,44903
2015,Aguascalientes,01,San José de Gracia,01008,4408,4713,9121
2015,Aguascalientes,01,Tepezalá,01009,10480,10859,21339
2015,Baja California,02,Ensenada,02001,247267,247015,494282
2015,Baja California,02,Mexicali,02002,501733,501075,1002808
2015,Baja California,02,Playas de Rosarito,02005,49174,48797,97971
2015,Baja California,02,Tecate,02003,54517,50911,105428
2015,Baja California,02,Tijuana,02004,828653,828652,1657305
2015,Baja California Sur,03,Comondú,03001,39021,37961,76982
2015,Baja California Sur,03,La Paz,03003,138867,138406,277273
2015,Baja California Sur,03,Loreto,03009,9918,9096,19014
2015,Baja California Sur,03,Los Cabos,03008,145745,137039,282784
2015,Baja California Sur,03,Mulegé,03002,33120,30673,63793
2015,Campeche,04,Calakmul,04010,14845,14438,29283
2015,Campeche,04,Calkiní,04001,28831,29728,58559
2015,Campeche,04,Campeche,04002,140113,150155,290268
2015,Campeche,04,Candelaria,04011,22661,22256,44917
2015,Campeche,04,Carmen,04003,124472,125681,250153
2015,Campeche,04,Champotón,04004,45875,45594,91469
2015,Campeche,04,Escárcega,04009,29282,30076,59358
2015,Campeche,04,Hecelchakán,04005,15915,16029,31944
2015,Campeche,04,Hopelchén,04006,20730,19899,40629
2015,Campeche,04,Palizada,04007,4717,4593,9310
2015,Campeche,04,Tenabo,04008,5605,5337,10942
2015,Chiapas,07,Acacoyagua,07001,9238,9153,18391
2015,Chiapas,07,Acala,07002,15966,16124,32090
2015,Chiapas,07,Acapetahua,07003,14681,14647,29328
2015,Chiapas,07,Aldama,07113,3122,3375,6497
2015,Chiapas,07,Altamirano,07004,16479,16287,32766
2015,Chiapas,07,Amatenango de la Frontera,07006,15383,16207,31590
2015,Chiapas,07,Amatenango del Valle,07007,4809,5167,9976
2015,Chiapas,07,Amatán,07005,10781,10468,21249
2015,Chiapas,07,Angel Albino Corzo,07008,14796,14748,29544
2015,Chiapas,07,Arriaga,07009,20760,21940,42700
2015,Chiapas,07,Bejucal de Ocampo,07010,3954,3911,7865
2015,Chiapas,07,Bella Vista,07011,10297,10475,20772
2015,Chiapas,07,Benemérito de las Américas,07114,10001,9832,19833
2015,Chiapas,07,Berriozábal,07012,25142,25097,50239
2015,Chiapas,07,Bochil,07013,17210,17485,34695
2015,Chiapas,07,Cacahoatán,07015,23227,24302,47529
2015,Chiapas,07,Catazajá,07016,9214,8942,18156
2015,Chiapas,07,Chalchihuitán,07022,8255,8369,16624
2015,Chiapas,07,Chamula,07023,40343,46249,86592
2015,Chiapas,07,Chanal,07024,5964,6037,12001
2015,Chiapas,07,Chapultenango,07025,3972,3984,7956
2015,Chiapas,07,Chenalhó,07026,19554,19961,39515
2015,Chiapas,07,Chiapa de Corzo,07027,49327,50761,100088
2015,Chiapas,07,Chiapilla,07028,3084,2946,6030
2015,Chiapas,07,Chicoasén,07029,2713,2683,5396
2015,Chiapas,07,Chicomuselo,07030,17390,17575,34965
2015,Chiapas,07,Chilón,07031,62349,63494,125843
2015,Chiapas,07,Cintalapa,07017,43491,43411,86902
2015,Chiapas,07,Coapilla,07018,4649,4718,9367
2015,Chiapas,07,Comitán de Domínguez,07019,74706,81478,156184
2015,Chiapas,07,Copainalá,07021,11241,11637,22878
2015,Chiapas,07,El Bosque,07014,10532,11269,21801
2015,Chiapas,07,El Porvenir,07070,7274,7276,14550
2015,Chiapas,07,Escuintla,07032,16076,16625,32701
2015,Chiapas,07,Francisco León,07033,3870,3774,7644
2015,Chiapas,07,Frontera Comalapa,07034,35843,38163,74006
2015,Chiapas,07,Frontera Hidalgo,07035,7043,7334,14377
2015,Chiapas,07,Huehuetán,07037,17639,18552,36191
2015,Chiapas,07,Huitiupán,07039,12032,11884,23916
2015,Chiapas,07,Huixtla,07040,27173,28994,56167
2015,Chiapas,07,Huixtán,07038,11666,12042,23708
2015,Chiapas,07,Ixhuatán,07042,5607,5747,11354
2015,Chiapas,07,Ixtacomitán,07043,5543,5629,11172
2015,Chiapas,07,Ixtapa,07044,13615,13781,27396
2015,Chiapas,07,Ixtapangajoya,07045,2871,2811,5682
2015,Chiapas,07,Jiquipilas,07046,20276,20703,40979
2015,Chiapas,07,Jitotol,07047,10384,10087,20471
2015,Chiapas,07,Juárez,07048,11138,11310,22448
2015,Chiapas,07,La Concordia,07020,24107,23718,47825
2015,Chiapas,07,La Grandeza,07036,3726,3778,7504
2015,Chiapas,07,La Independencia,07041,22334,23346,45680
2015,Chiapas,07,La Libertad,07050,2648,2717,5365
2015,Chiapas,07,La Trinitaria,07099,38137,40137,78274
2015,Chiapas,07,Larráinzar,07049,11445,11808,23253
2015,Chiapas,07,Las Margaritas,07052,60933,62154,123087
2015,Chiapas,07,Las Rosas,07075,14315,14593,28908
2015,Chiapas,07,Mapastepec,07051,23803,24478,48281
2015,Chiapas,07,Maravilla Tenejapa,07115,6572,6325,12897
2015,Chiapas,07,Marqués de Comillas,07116,5695,5531,11226
2015,Chiapas,07,Mazapa de Madero,07053,3996,4104,8100
2015,Chiapas,07,Mazatán,07054,14711,14986,29697
2015,Chiapas,07,Metapa,07055,2812,2991,5803
2015,Chiapas,07,Mitontic,07056,5991,6114,12105
2015,Chiapas,07,Montecristo de Guerrero,07117,3966,3833,7799
2015,Chiapas,07,Motozintla,07057,36606,37685,74291
2015,Chiapas,07,Nicolás Ruíz,07058,2310,2193,4503
2015,Chiapas,07,Ocosingo,07059,108999,109625,218624
2015,Chiapas,07,Ocotepec,07060,6325,6516,12841
2015,Chiapas,07,Ocozocoautla de Espinosa,07061,45784,46680,92464
2015,Chiapas,07,Ostuacán,07062,9470,9328,18798
2015,Chiapas,07,Osumacinta,07063,1974,1956,3930
2015,Chiapas,07,Oxchuc,07064,24331,24126,48457
2015,Chiapas,07,Palenque,07065,60093,61723,121816
2015,Chiapas,07,Pantelhó,07066,11180,11324,22504
2015,Chiapas,07,Pantepec,07067,6081,6135,12216
2015,Chiapas,07,Pichucalco,07068,16249,16501,32750
2015,Chiapas,07,Pijijiapan,07069,27208,27804,55012
2015,Chiapas,07,Pueblo Nuevo Solistahuacán,07072,15973,17093,33066
2015,Chiapas,07,Rayón,07073,4870,4909,9779
2015,Chiapas,07,Reforma,07074,22517,22899,45416
2015,Chiapas,07,Sabanilla,07076,13865,13721,27586
2015,Chiapas,07,Salto de Agua,07077,31922,32197,64119
2015,Chiapas,07,San Andrés Duraznal,07118,2565,2705,5270
2015,Chiapas,07,San Cristóbal de las Casas,07078,100814,110418,211232
2015,Chiapas,07,San Fernando,07079,19560,19184,38744
2015,Chiapas,07,San Juan Cancuc,07112,16487,17171,33658
2015,Chiapas,07,San Lucas,07110,3691,3667,7358
2015,Chiapas,07,Santiago el Pinar,07119,1843,1830,3673
2015,Chiapas,07,Siltepec,07080,19448,18845,38293
2015,Chiapas,07,Simojovel,07081,21745,22085,43830
2015,Chiapas,07,Sitalá,07082,6858,6921,13779
2015,Chiapas,07,Socoltenango,07083,9466,9558,19024
2015,Chiapas,07,Solosuchiapa,07084,4291,4281,8572
2015,Chiapas,07,Soyaló,07085,5471,5392,10863
2015,Chiapas,07,Suchiapa,07086,12064,11986,24050
2015,Chiapas,07,Suchiate,07087,19310,20109,39419
2015,Chiapas,07,Sunuapa,07088,1231,1183,2414
2015,Chiapas,07,Tapachula,07089,170741,184960,355701
2015,Chiapas,07,Tapalapa,07090,2033,2162,4195
2015,Chiapas,07,Tapilula,07091,6417,6677,13094
2015,Chiapas,07,Tecpatán,07092,21509,21809,43318
2015,Chiapas,07,Tenejapa,07093,21705,22772,44477
2015,Chiapas,07,Teopisca,07094,20817,21973,42790
2015,Chiapas,07,Tila,07096,39415,39255,78670
2015,Chiapas,07,Tonalá,07097,45770,46879,92649
2015,Chiapas,07,Totolapa,07098,3661,3639,7300
2015,Chiapas,07,Tumbalá,07100,17106,17812,34918
2015,Chiapas,07,Tuxtla Chico,07102,20648,21687,42335
2015,Chiapas,07,Tuxtla Gutiérrez,07101,294324,321942,616266
2015,Chiapas,07,Tuzantán,07103,15604,16055,31659
2015,Chiapas,07,Tzimol,07104,7670,7988,15658
2015,Chiapas,07,Unión Juárez,07105,7689,8070,15759
2015,Chiapas,07,Venustiano Carranza,07106,33549,33555,67104
2015,Chiapas,07,Villa Comaltitlán,07071,14928,15203,30131
2015,Chiapas,07,Villa Corzo,07107,40164,41230,81394
2015,Chiapas,07,Villaflores,07108,53441,55311,108752
2015,Chiapas,07,Yajalón,07109,18768,19511,38279
2015,Chiapas,07,Zinacantán,07111,19309,21782,41091
2015,Chihuahua,08,Ahumada,08001,6367,6149,12516
2015,Chihuahua,08,Aldama,08002,12113,12205,24318
2015,Chihuahua,08,Allende,08003,4543,4434,8977
2015,Chihuahua,08,Aquiles Serdán,08004,8314,7759,16073
2015,Chihuahua,08,Ascensión,08005,12854,12441,25295
2015,Chihuahua,08,Bachíniva,08006,3240,3101,6341
2015,Chihuahua,08,Balleza,08007,8907,8579,17486
2015,Chihuahua,08,Batopilas,08008,6634,6556,13190
2015,Chihuahua,08,Bocoyna,08009,14543,15029,29572
2015,Chihuahua,08,Buenaventura,08010,11925,11690,23615
2015,Chihuahua,08,Camargo,08011,25671,26523,52194
2015,Chihuahua,08,Carichí,08012,4692,4617,9309
2015,Chihuahua,08,Casas Grandes,08013,5720,5459,11179
2015,Chihuahua,08,Chihuahua,08019,431408,453401,884809
2015,Chihuahua,08,Chínipas,08020,4310,3893,8203
2015,Chihuahua,08,Coronado,08014,1160,1067,2227
2015,Chihuahua,08,Coyame del Sotol,08015,927,777,1704
2015,Chihuahua,08,Cuauhtémoc,08017,80963,85476,166439
2015,Chihuahua,08,Cusihuiriachi,08018,2607,2446,5053
2015,Chihuahua,08,Delicias,08021,72883,75836,148719
2015,Chihuahua,08,Dr. Belisario Domínguez,08022,1387,1344,2731
2015,Chihuahua,08,El Tule,08064,932,894,1826
2015,Chihuahua,08,Galeana,08023,3179,3186,6365
2015,Chihuahua,08,Gran Morelos,08026,1461,1399,2860
2015,Chihuahua,08,Guachochi,08027,23874,24609,48483
2015,Chihuahua,08,Guadalupe,08028,3089,3067,6156
2015,Chihuahua,08,Guadalupe y Calvo,08029,28579,27936,56515
2015,Chihuahua,08,Guazapares,08030,4291,4107,8398
2015,Chihuahua,08,Guerrero,08031,20414,20143,40557
2015,Chihuahua,08,Gómez Farías,08025,4486,4509,8995
2015,Chihuahua,08,Hidalgo del Parral,08032,54660,57996,112656
2015,Chihuahua,08,Huejotitán,08033,519,513,1032
2015,Chihuahua,08,Ignacio Zaragoza,08034,3622,3541,7163
2015,Chihuahua,08,Janos,08035,5725,5237,10962
2015,Chihuahua,08,Jiménez,08036,21754,21917,43671
2015,Chihuahua,08,Julimes,08038,2450,2340,4790
2015,Chihuahua,08,Juárez,08037,709404,706671,1416075
2015,Chihuahua,08,La Cruz,08016,2041,1950,3991
2015,Chihuahua,08,López,08039,2161,2001,4162
2015,Chihuahua,08,Madera,08040,15572,15258,30830
2015,Chihuahua,08,Maguarichi,08041,937,874,1811
2015,Chihuahua,08,Manuel Benavides,08042,823,699,1522
2015,Chihuahua,08,Matachí,08043,1594,1573,3167
2015,Chihuahua,08,Matamoros,08044,2336,2243,4579
2015,Chihuahua,08,Meoqui,08045,22806,23113,45919
2015,Chihuahua,08,Morelos,08046,4258,4166,8424
2015,Chihuahua,08,Moris,08047,2798,2580,5378
2015,Chihuahua,08,Namiquipa,08048,12087,11606,23693
2015,Chihuahua,08,Nonoava,08049,1432,1347,2779
2015,Chihuahua,08,Nuevo Casas Grandes,08050,31049,32335,63384
2015,Chihuahua,08,Ocampo,08051,3984,3614,7598
2015,Chihuahua,08,Ojinaga,08052,13921,13709,27630
2015,Chihuahua,08,Praxedis G. Guerrero,08053,3013,2925,5938
2015,Chihuahua,08,Riva Palacio,08054,4191,4039,8230
2015,Chihuahua,08,Rosales,08055,8823,8636,17459
2015,Chihuahua,08,Rosario,08056,1093,1068,2161
2015,Chihuahua,08,San Francisco de Borja,08057,1180,1124,2304
2015,Chihuahua,08,San Francisco de Conchos,08058,1432,1329,2761
2015,Chihuahua,08,San Francisco del Oro,08059,2575,2547,5122
2015,Chihuahua,08,Santa Bárbara,08060,5444,5499,10943
2015,Chihuahua,08,Santa Isabel,08024,2083,2091,4174
2015,Chihuahua,08,Satevó,08061,1830,1687,3517
2015,Chihuahua,08,Saucillo,08062,16210,16103,32313
2015,Chihuahua,08,Temósachic,08063,3408,3211,6619
2015,Chihuahua,08,Urique,08065,10812,10480,21292
2015,Chihuahua,08,Uruachi,08066,3616,3452,7068
2015,Chihuahua,08,Valle de Zaragoza,08067,2689,2570,5259
2015,Ciudad de México,09,Azcapotzalco,09002,197278,220390,417668
2015,Ciudad de México,09,Benito Juárez,09014,190010,224751,414761
2015,Ciudad de México,09,Coyoacán,09003,297522,334990,632512
2015,Ciudad de México,09,Cuajimalpa de Morelos,09004,93271,101580,194851
2015,Ciudad de México,09,Cuauhtémoc,09015,257526,286118,543644
2015,Ciudad de México,09,Gustavo A. Madero,09005,576478,622151,1198629
2015,Ciudad de México,09,Iztacalco,09006,188903,208913,397816
2015,Ciudad de México,09,Iztapalapa,09007,899221,949733,1848954
2015,Ciudad de México,09,La Magdalena Contreras,09008,117649,127136,244785
2015,Ciudad de México,09,Miguel Hidalgo,09016,173003,201776,374779
2015,Ciudad de México,09,Milpa Alta,09009,66188,69084,135272
2015,Ciudad de México,09,Tlalpan,09012,323351,350568,673919
2015,Ciudad de México,09,Tláhuac,09011,176935,189739,366674
2015,Ciudad de México,09,Venustiano Carranza,09017,208090,232502,440592
2015,Ciudad de México,09,Xochimilco,09013,207257,214436,421693
2015,Ciudad de México,09,Álvaro Obregón,09010,358767,393418,752185
2015,Coahuila,05,Abasolo,05001,548,542,1090
2015,Coahuila,05,Acuña,05002,77876,76342,154218
2015,Coahuila,05,Allende,05003,11687,11926,23613
2015,Coahuila,05,Arteaga,05004,12243,11629,23872
2015,Coahuila,05,Candela,05005,970,878,1848
2015,Coahuila,05,Castaños,05006,14256,14196,28452
2015,Coahuila,05,Cuatro Ciénegas,05007,7061,6859,13920
2015,Coahuila,05,Escobedo,05008,1601,1557,3158
2015,Coahuila,05,Francisco I. Madero,05009,29893,29899,59792
2015,Coahuila,05,Frontera,05010,41437,40971,82408
2015,Coahuila,05,General Cepeda,05011,6674,6095,12769
2015,Coahuila,05,Guerrero,05012,1045,906,1951
2015,Coahuila,05,Hidalgo,05013,938,885,1823
2015,Coahuila,05,Jiménez,05014,5443,5233,10676
2015,Coahuila,05,Juárez,05015,850,793,1643
2015,Coahuila,05,Lamadrid,05016,971,922,1893
2015,Coahuila,05,Matamoros,05017,56624,56451,113075
2015,Coahuila,05,Monclova,05018,117690,118390,236080
2015,Coahuila,05,Morelos,05019,4463,4325,8788
2015,Coahuila,05,Múzquiz,05020,36107,35362,71469
2015,Coahuila,05,Nadadores,05021,3450,3358,6808
2015,Coahuila,05,Nava,05022,15892,15061,30953
2015,Coahuila,05,Ocampo,05023,6145,5647,11792
2015,Coahuila,05,Parras,05024,24306,23236,47542
2015,Coahuila,05,Piedras Negras,05025,83924,83238,167162
2015,Coahuila,05,Progreso,05026,1835,1716,3551
2015,Coahuila,05,Ramos Arizpe,05027,45554,43877,89431
2015,Coahuila,05,Sabinas,05028,32548,32442,64990
2015,Coahuila,05,Sacramento,05029,1243,1199,2442
2015,Coahuila,05,Saltillo,05030,400553,401680,802233
2015,Coahuila,05,San Buenaventura,05031,12017,11981,23998
2015,Coahuila,05,San Juan de Sabinas,05032,22184,22834,45018
2015,Coahuila,05,San Pedro,05033,54633,54503,109136
2015,Coahuila,05,Sierra Mojada,05034,3571,3284,6855
2015,Coahuila,05,Torreón,05035,339637,353786,693423
2015,Coahuila,05,Viesca,05036,11322,10964,22286
2015,Coahuila,05,Villa Unión,05037,3423,3232,6655
2015,Coahuila,05,Zaragoza,05038,6929,6814,13743
2015,Colima,06,Armería,06001,15271,15191,30462
2015,Colima,06,Colima,06002,76800,81010,157810
2015,Colima,06,Comala,06003,11300,11239,22539
2015,Colima,06,Coquimatlán,06004,10493,10401,20894
2015,Colima,06,Cuauhtémoc,06005,15320,15337,30657
2015,Colima,06,Ixtlahuacán,06006,2870,2844,5714
2015,Colima,06,Manzanillo,06007,92538,91210,183748
2015,Colima,06,Minatitlán,06008,4696,4374,9070
2015,Colima,06,Tecomán,06009,62599,61833,124432
2015,Colima,06,Villa de Álvarez,06010,66412,69958,136370
2015,Durango,10,Canatlán,10001,16655,16920,33575
2015,Durango,10,Canelas,10002,2430,2221,4651
2015,Durango,10,Coneto de Comonfort,10003,2269,2322,4591
2015,Durango,10,Cuencamé,10004,18211,17952,36163
2015,Durango,10,Durango,10005,317032,336370,653402
2015,Durango,10,El Oro,10018,5906,5985,11891
2015,Durango,10,General Simón Bolívar,10006,5273,5352,10625
2015,Durango,10,Guadalupe Victoria,10008,18027,18428,36455
2015,Durango,10,Guanaceví,10009,5416,5081,10497
2015,Durango,10,Gómez Palacio,10007,175320,178033,353353
2015,Durango,10,Hidalgo,10010,2136,2072,4208
2015,Durango,10,Indé,10011,2624,2626,5250
2015,Durango,10,Lerdo,10012,77307,77959,155266
2015,Durango,10,Mapimí,10013,13447,13436,26883
2015,Durango,10,Mezquital,10014,18742,19333,38075
2015,Durango,10,Nazas,10015,6669,6707,13376
2015,Durango,10,Nombre de Dios,10016,9945,10065,20010
2015,Durango,10,Nuevo Ideal,10039,13812,13957,27769
2015,Durango,10,Ocampo,10017,5127,4891,10018
2015,Durango,10,Otáez,10019,2807,2636,5443
2015,Durango,10,Peñón Blanco,10021,5629,5581,11210
2015,Durango,10,Poanas,10022,12910,13284,26194
2015,Durango,10,Pueblo Nuevo,10023,25949,26077,52026
2015,Durango,10,Pánuco de Coronado,10020,6273,6461,12734
2015,Durango,10,Rodeo,10024,6825,6840,13665
2015,Durango,10,San Bernardo,10025,1858,1650,3508
2015,Durango,10,San Dimas,10026,10465,9817,20282
2015,Durango,10,San Juan de Guadalupe,10027,2942,3015,5957
2015,Durango,10,San Juan del Río,10028,6308,6454,12762
2015,Durango,10,San Luis del Cordero,10029,1108,1085,2193
2015,Durango,10,San Pedro del Gallo,10030,826,783,1609
2015,Durango,10,Santa Clara,10031,3625,3683,7308
2015,Durango,10,Santiago Papasquiaro,10032,24539,24486,49025
2015,Durango,10,Súchil,10033,3309,3564,6873
2015,Durango,10,Tamazula,10034,14485,13237,27722
2015,Durango,10,Tepehuanes,10035,5755,5843,11598
2015,Durango,10,Tlahualilo,10036,11768,11617,23385
2015,Durango,10,Topia,10037,4804,4547,9351
2015,Durango,10,Vicente Guerrero,10038,11022,11650,22672
2015,Estado de México,15,Acambay de Ruíz Castañeda,15001,32070,34130,66200
2015,Estado de México,15,Acolman,15002,80609,80318,160927
2015,Estado de México,15,Aculco,15003,24084,24834,48918
2015,Estado de México,15,Almoloya de Alquisiras,15004,7375,8074,15449
2015,Estado de México,15,Almoloya de Juárez,15005,84090,86166,170256
2015,Estado de México,15,Almoloya del Río,15006,5452,5895,11347
2015,Estado de México,15,Amanalco,15007,12050,12518,24568
2015,Estado de México,15,Amatepec,15008,13618,14493,28111
2015,Estado de México,15,Amecameca,15009,25380,27201,52581
2015,Estado de México,15,Apaxco,15010,14721,15108,29829
2015,Estado de México,15,Atenco,15011,31076,31620,62696
2015,Estado de México,15,Atizapán,15012,5612,5935,11547
2015,Estado de México,15,Atizapán de Zaragoza,15013,261876,276680,538556
2015,Estado de México,15,Atlacomulco,15014,47954,51960,99914
2015,Estado de México,15,Atlautla,15015,14934,15715,30649
2015,Estado de México,15,Axapusco,15016,13781,13948,27729
2015,Estado de México,15,Ayapango,15017,4840,5031,9871
2015,Estado de México,15,Calimaya,15018,26478,27945,54423
2015,Estado de México,15,Capulhuac,15019,17642,18591,36233
2015,Estado de México,15,Chalco,15025,169880,178154,348034
2015,Estado de México,15,Chapa de Mota,15026,13935,14452,28387
2015,Estado de México,15,Chapultepec,15027,5533,5797,11330
2015,Estado de México,15,Chiautla,15028,14196,14800,28996
2015,Estado de México,15,Chicoloapan,15029,97906,103300,201206
2015,Estado de México,15,Chiconcuac,15030,12392,12848,25240
2015,Estado de México,15,Chimalhuacán,15031,332641,344615,677256
2015,Estado de México,15,Coacalco de Berriozábal,15020,146343,156531,302874
2015,Estado de México,15,Coatepec Harinas,15021,18901,20502,39403
2015,Estado de México,15,Cocotitlán,15022,6969,7273,14242
2015,Estado de México,15,Coyotepec,15023,21128,21544,42672
2015,Estado de México,15,Cuautitlán,15024,77316,79364,156680
2015,Estado de México,15,Cuautitlán Izcalli,15121,270393,284296,554689
2015,Estado de México,15,Donato Guerra,15032,16975,17462,34437
2015,Estado de México,15,Ecatepec de Morelos,15033,827678,846921,1674599
2015,Estado de México,15,Ecatzingo,15034,4749,4883,9632
2015,Estado de México,15,El Oro,15064,18146,19210,37356
2015,Estado de México,15,Huehuetoca,15035,61177,63172,124349
2015,Estado de México,15,Hueypoxtla,15036,21958,21779,43737
2015,Estado de México,15,Huixquilucan,15037,129717,140206,269923
2015,Estado de México,15,Isidro Fabela,15038,5696,5825,11521
2015,Estado de México,15,Ixtapaluca,15039,248923,258902,507825
2015,Estado de México,15,Ixtapan de la Sal,15040,17256,18739,35995
2015,Estado de México,15,Ixtapan del Oro,15041,3525,3453,6978
2015,Estado de México,15,Ixtlahuaca,15042,73782,79014,152796
2015,Estado de México,15,Jaltenco,15044,14178,14967,29145
2015,Estado de México,15,Jilotepec,15045,43620,45045,88665
2015,Estado de México,15,Jilotzingo,15046,9423,9928,19351
2015,Estado de México,15,Jiquipilco,15047,35805,38146,73951
2015,Estado de México,15,Jocotitlán,15048,31975,34115,66090
2015,Estado de México,15,Joquicingo,15049,6710,7114,13824
2015,Estado de México,15,Juchitepec,15050,12532,12936,25468
2015,Estado de México,15,La Paz,15070,142057,146251,288308
2015,Estado de México,15,Lerma,15051,71861,73866,145727
2015,Estado de México,15,Luvianos,15123,14310,14748,29058
2015,Estado de México,15,Malinalco,15052,13588,14097,27685
2015,Estado de México,15,Melchor Ocampo,15053,27035,28252,55287
2015,Estado de México,15,Metepec,15054,113861,121312,235173
2015,Estado de México,15,Mexicaltzingo,15055,6158,6569,12727
2015,Estado de México,15,Morelos,15056,14555,15857,30412
2015,Estado de México,15,Naucalpan de Juárez,15057,430153,456308,886461
2015,Estado de México,15,Nextlalpan,15059,18860,19394,38254
2015,Estado de México,15,Nezahualcóyotl,15058,548367,586659,1135026
2015,Estado de México,15,Nicolás Romero,15060,197909,205437,403346
2015,Estado de México,15,Nopaltepec,15061,4658,4663,9321
2015,Estado de México,15,Ocoyoacac,15062,32807,33925,66732
2015,Estado de México,15,Ocuilan,15063,16663,17357,34020
2015,Estado de México,15,Otumba,15065,18091,17938,36029
2015,Estado de México,15,Otzoloapan,15066,2255,2224,4479
2015,Estado de México,15,Otzolotepec,15067,41322,42616,83938
2015,Estado de México,15,Ozumba,15068,14074,15228,29302
2015,Estado de México,15,Papalotla,15069,2051,2165,4216
2015,Estado de México,15,Polotitlán,15071,6923,7216,14139
2015,Estado de México,15,Rayón,15072,6628,6851,13479
2015,Estado de México,15,San Antonio la Isla,15073,13235,13671,26906
2015,Estado de México,15,San Felipe del Progreso,15074,66395,73693,140088
2015,Estado de México,15,San José del Rincón,15124,46878,47593,94471
2015,Estado de México,15,San Martín de las Pirámides,15075,13351,13685,27036
2015,Estado de México,15,San Mateo Atenco,15076,37825,39179,77004
2015,Estado de México,15,San Simón de Guerrero,15077,3053,3246,6299
2015,Estado de México,15,Santo Tomás,15078,4850,5011,9861
2015,Estado de México,15,Soyaniquilpan de Juárez,15079,6542,6673,13215
2015,Estado de México,15,Sultepec,15080,13035,14455,27490
2015,Estado de México,15,Tecámac,15081,210686,221528,432214
2015,Estado de México,15,Tejupilco,15082,38168,41325,79493
2015,Estado de México,15,Temamatla,15083,6187,6511,12698
2015,Estado de México,15,Temascalapa,15084,19548,19624,39172
2015,Estado de México,15,Temascalcingo,15085,31489,33964,65453
2015,Estado de México,15,Temascaltepec,15086,16318,16923,33241
2015,Estado de México,15,Temoaya,15087,48831,51674,100505
2015,Estado de México,15,Tenancingo,15088,47682,50447,98129
2015,Estado de México,15,Tenango del Aire,15089,5992,6177,12169
2015,Estado de México,15,Tenango del Valle,15090,41875,43775,85650
2015,Estado de México,15,Teoloyucan,15091,34809,35410,70219
2015,Estado de México,15,Teotihuacán,15092,28273,29104,57377
2015,Estado de México,15,Tepetlaoxtoc,15093,15231,15594,30825
2015,Estado de México,15,Tepetlixpa,15094,9869,10181,20050
2015,Estado de México,15,Tepotzotlán,15095,46804,48488,95292
2015,Estado de México,15,Tequixquiac,15096,18402,18710,37112
2015,Estado de México,15,Texcaltitlán,15097,9185,9859,19044
2015,Estado de México,15,Texcalyacac,15098,2646,2732,5378
2015,Estado de México,15,Texcoco,15099,121670,127217,248887
2015,Estado de México,15,Tezoyuca,15100,20178,20532,40710
2015,Estado de México,15,Tianguistenco,15101,37545,39675,77220
2015,Estado de México,15,Timilpan,15102,7819,8393,16212
2015,Estado de México,15,Tlalmanalco,15103,23848,25492,49340
2015,Estado de México,15,Tlalnepantla de Baz,15104,354544,378056,732600
2015,Estado de México,15,Tlatlaya,15105,17620,18547,36167
2015,Estado de México,15,Toluca,15106,428672,459371,888043
2015,Estado de México,15,Tonanitla,15125,5169,5307,10476
2015,Estado de México,15,Tonatico,15107,6193,6649,12842
2015,Estado de México,15,Tultepec,15108,72173,75174,147347
2015,Estado de México,15,Tultitlán,15109,262720,272744,535464
2015,Estado de México,15,Valle de Bravo,15110,32803,34154,66957
2015,Estado de México,15,Valle de Chalco Solidaridad,15122,194221,200306,394527
2015,Estado de México,15,Villa Guerrero,15113,32461,33771,66232
2015,Estado de México,15,Villa Victoria,15114,50350,51054,101404
2015,Estado de México,15,Villa de Allende,15111,25352,26236,51588
2015,Estado de México,15,Villa del Carbón,15112,23893,23708,47601
2015,Estado de México,15,Xalatlaco,15043,14160,14967,29127
2015,Estado de México,15,Xonacatlán,15115,25836,25964,51800
2015,Estado de México,15,Zacazonapan,15116,2140,2120,4260
2015,Estado de México,15,Zacualpan,15117,7425,8170,15595
2015,Estado de México,15,Zinacantepec,15118,90551,93337,183888
2015,Estado de México,15,Zumpahuacán,15119,8340,9081,17421
2015,Estado de México,15,Zumpango,15120,92610,99345,191955
2015,Guanajuato,11,Abasolo,11001,44270,47519,91789
2015,Guanajuato,11,Acámbaro,11002,55494,60399,115893
2015,Guanajuato,11,Apaseo el Alto,11004,33807,35505,69312
2015,Guanajuato,11,Apaseo el Grande,11005,44964,47731,92695
2015,Guanajuato,11,Atarjea,11006,2696,2800,5496
2015,Guanajuato,11,Celaya,11007,245434,259489,504923
2015,Guanajuato,11,Comonfort,11009,39609,43915,83524
2015,Guanajuato,11,Coroneo,11010,5935,6543,12478
2015,Guanajuato,11,Cortazar,11011,47299,50005,97304
2015,Guanajuato,11,Cuerámaro,11012,13838,15030,28868
2015,Guanajuato,11,Doctor Mora,11013,11924,12766,24690
2015,Guanajuato,11,Dolores Hidalgo Cuna de la Independencia Nacional,11014,74142,81739,155881
2015,Guanajuato,11,Guanajuato,11015,91863,95351,187214
2015,Guanajuato,11,Huanímaro,11016,10317,11507,21824
2015,Guanajuato,11,Irapuato,11017,281552,296050,577602
2015,Guanajuato,11,Jaral del Progreso,11018,19020,20028,39048
2015,Guanajuato,11,Jerécuaro,11019,24183,27248,51431
2015,Guanajuato,11,León,11020,786737,798205,1584942
2015,Guanajuato,11,Manuel Doblado,11008,18749,20825,39574
2015,Guanajuato,11,Moroleón,11021,25073,27533,52606
2015,Guanajuato,11,Ocampo,11022,11557,12350,23907
2015,Guanajuato,11,Pueblo Nuevo,11024,5640,6343,11983
2015,Guanajuato,11,Purísima del Rincón,11025,38895,39086,77981
2015,Guanajuato,11,Pénjamo,11023,74544,81827,156371
2015,Guanajuato,11,Romita,11026,29237,31259,60496
2015,Guanajuato,11,Salamanca,11027,136610,143564,280174
2015,Guanajuato,11,Salvatierra,11028,49420,54388,103808
2015,Guanajuato,11,San Diego de la Unión,11029,18713,21238,39951
2015,Guanajuato,11,San Felipe,11030,55178,58626,113804
2015,Guanajuato,11,San Francisco del Rincón,11031,59421,62250,121671
2015,Guanajuato,11,San José Iturbide,11032,37768,40231,77999
2015,Guanajuato,11,San Luis de la Paz,11033,58439,63876,122315
2015,Guanajuato,11,San Miguel de Allende,11003,83194,89783,172977
2015,Guanajuato,11,Santa Catarina,11034,2571,2799,5370
2015,Guanajuato,11,Santa Cruz de Juventino Rosas,11035,40805,43697,84502
2015,Guanajuato,11,Santiago Maravatío,11036,3320,3734,7054
2015,Guanajuato,11,Silao de la Victoria,11037,92933,95283,188216
2015,Guanajuato,11,Tarandacuao,11038,5898,6508,12406
2015,Guanajuato,11,Tarimoro,11039,17429,18834,36263
2015,Guanajuato,11,Tierra Blanca,11040,9316,9876,19192
2015,Guanajuato,11,Uriangato,11041,31003,33088,64091
2015,Guanajuato,11,Valle de Santiago,11042,70369,77377,147746
2015,Guanajuato,11,Victoria,11043,9946,10898,20844
2015,Guanajuato,11,Villagrán,11044,29248,30626,59874
2015,Guanajuato,11,Xichú,11045,5762,6192,11954
2015,Guanajuato,11,Yuriria,11046,34401,38174,72575
2015,Guerrero,12,Acapulco de Juárez,12001,397684,426076,823760
2015,Guerrero,12,Acatepec,12076,18264,19147,37411
2015,Guerrero,12,Ahuacuotzingo,12002,12388,14082,26470
2015,Guerrero,12,Ajuchitlán del Progreso,12003,18976,20427,39403
2015,Guerrero,12,Alcozauca de Guerrero,12004,9079,10276,19355
2015,Guerrero,12,Alpoyeca,12005,3175,3603,6778
2015,Guerrero,12,Apaxtla,12006,5773,6252,12025
2015,Guerrero,12,Arcelia,12007,15964,16940,32904
2015,Guerrero,12,Atenango del Río,12008,4178,4607,8785
2015,Guerrero,12,Atlamajalcingo del Monte,12009,2650,2889,5539
2015,Guerrero,12,Atlixtac,12010,13120,14069,27189
2015,Guerrero,12,Atoyac de Álvarez,12011,30800,31982,62782
2015,Guerrero,12,Ayutla de los Libres,12012,33257,34547,67804
2015,Guerrero,12,Azoyú,12013,7446,7882,15328
2015,Guerrero,12,Benito Juárez,12014,7731,8113,15844
2015,Guerrero,12,Buenavista de Cuéllar,12015,6594,6975,13569
2015,Guerrero,12,Chilapa de Álvarez,12028,60945,67089,128034
2015,Guerrero,12,Chilpancingo de los Bravo,12029,128767,139953,268720
2015,Guerrero,12,Coahuayutla de José María Izazaga,12016,6737,6541,13278
2015,Guerrero,12,Cochoapa el Grande,12078,9043,9980,19023
2015,Guerrero,12,Cocula,12017,6893,7485,14378
2015,Guerrero,12,Copala,12018,7005,7277,14282
2015,Guerrero,12,Copalillo,12019,7121,7858,14979
2015,Guerrero,12,Copanatoyac,12020,9563,10381,19944
2015,Guerrero,12,Coyuca de Benítez,12021,38051,39557,77608
2015,Guerrero,12,Coyuca de Catalán,12022,21005,20856,41861
2015,Guerrero,12,Cuajinicuilapa,12023,13591,13686,27277
2015,Guerrero,12,Cualác,12024,3647,3946,7593
2015,Guerrero,12,Cuautepec,12025,8168,8186,16354
2015,Guerrero,12,Cuetzala del Progreso,12026,4417,4693,9110
2015,Guerrero,12,Cutzamala de Pinzón,12027,10250,10798,21048
2015,Guerrero,12,Eduardo Neri,12075,24630,25752,50382
2015,Guerrero,12,Florencio Villarreal,12030,10427,10695,21122
2015,Guerrero,12,General Canuto A. Neri,12031,2944,3222,6166
2015,Guerrero,12,General Heliodoro Castillo,12032,18852,18807,37659
2015,Guerrero,12,Huamuxtitlán,12033,7245,8201,15446
2015,Guerrero,12,Huitzuco de los Figueroa,12034,18330,20045,38375
2015,Guerrero,12,Iguala de la Independencia,12035,73487,79008,152495
2015,Guerrero,12,Igualapa,12036,5624,5831,11455
2015,Guerrero,12,Iliatenco,12081,5312,5802,11114
2015,Guerrero,12,Ixcateopan de Cuauhtémoc,12037,3076,3438,6514
2015,Guerrero,12,José Joaquín de Herrera,12079,8523,8706,17229
2015,Guerrero,12,Juan R. Escudero,12039,12335,13075,25410
2015,Guerrero,12,Juchitán,12080,3809,3812,7621
2015,Guerrero,12,La Unión de Isidoro Montes de Oca,12068,13797,13315,27112
2015,Guerrero,12,Leonardo Bravo,12040,12961,13285,26246
2015,Guerrero,12,Malinaltepec,12041,13873,15271,29144
2015,Guerrero,12,Marquelia,12077,6873,6966,13839
2015,Guerrero,12,Metlatónoc,12043,9664,11010,20674
2015,Guerrero,12,Mochitlán,12044,6165,6423,12588
2015,Guerrero,12,Mártir de Cuilapan,12042,8773,9601,18374
2015,Guerrero,12,Olinalá,12045,12359,13341,25700
2015,Guerrero,12,Ometepec,12046,32519,34093,66612
2015,Guerrero,12,Pedro Ascencio Alquisiras,12047,3293,3864,7157
2015,Guerrero,12,Petatlán,12048,22905,23219,46124
2015,Guerrero,12,Pilcaya,12049,6188,6610,12798
2015,Guerrero,12,Pungarabato,12050,18917,20077,38994
2015,Guerrero,12,Quechultenango,12051,17747,18640,36387
2015,Guerrero,12,San Luis Acatlán,12052,21990,22510,44500
2015,Guerrero,12,San Marcos,12053,24653,25654,50307
2015,Guerrero,12,San Miguel Totolapan,12054,14082,14525,28607
2015,Guerrero,12,Taxco de Alarcón,12055,53389,57423,110812
2015,Guerrero,12,Tecoanapa,12056,23229,23811,47040
2015,Guerrero,12,Teloloapan,12058,27161,30530,57691
2015,Guerrero,12,Tepecoacuilco de Trujano,12059,15382,16778,32160
2015,Guerrero,12,Tetipac,12060,7024,7450,14474
2015,Guerrero,12,Tixtla de Guerrero,12061,20675,22292,42967
2015,Guerrero,12,Tlacoachistlahuaca,12062,10725,11952,22677
2015,Guerrero,12,Tlacoapa,12063,4757,5258,10015
2015,Guerrero,12,Tlalchapa,12064,6179,6282,12461
2015,Guerrero,12,Tlalixtaquilla de Maldonado,12065,3546,3877,7423
2015,Guerrero,12,Tlapa de Comonfort,12066,41501,45781,87282
2015,Guerrero,12,Tlapehuala,12067,10962,11807,22769
2015,Guerrero,12,Técpan de Galeana,12057,32559,33087,65646
2015,Guerrero,12,Xalpatláhuac,12069,5750,6602,12352
2015,Guerrero,12,Xochihuehuetlán,12070,3444,3987,7431
2015,Guerrero,12,Xochistlahuaca,12071,14199,14998,29197
2015,Guerrero,12,Zapotitlán Tablas,12072,5310,5854,11164
2015,Guerrero,12,Zihuatanejo de Azueta,12038,62387,63772,126159
2015,Guerrero,12,Zirándaro,12073,9795,9518,19313
2015,Guerrero,12,Zitlala,12074,10867,12106,22973
2015,Hidalgo,13,Acatlán,13001,10310,11037,21347
2015,Hidalgo,13,Acaxochitlán,13002,21024,22647,43671
2015,Hidalgo,13,Actopan,13003,27485,30591,58076
2015,Hidalgo,13,Agua Blanca de Iturbide,13004,4514,4933,9447
2015,Hidalgo,13,Ajacuba,13005,9165,9634,18799
2015,Hidalgo,13,Alfajayucan,13006,10038,10631,20669
2015,Hidalgo,13,Almoloya,13007,6229,6303,12532
2015,Hidalgo,13,Apan,13008,22047,23900,45947
2015,Hidalgo,13,Atitalaquia,13010,14898,15192,30090
2015,Hidalgo,13,Atlapexco,13011,10073,10772,20845
2015,Hidalgo,13,Atotonilco de Tula,13013,18123,19157,37280
2015,Hidalgo,13,Atotonilco el Grande,13012,13288,14966,28254
2015,Hidalgo,13,Calnali,13014,8697,9290,17987
2015,Hidalgo,13,Cardonal,13015,9111,9879,18990
2015,Hidalgo,13,Chapantongo,13017,6757,7062,13819
2015,Hidalgo,13,Chapulhuacán,13018,12241,12067,24308
2015,Hidalgo,13,Chilcuautla,13019,9080,9487,18567
2015,Hidalgo,13,Cuautepec de Hinojosa,13016,27969,30565,58534
2015,Hidalgo,13,El Arenal,13009,9032,9847,18879
2015,Hidalgo,13,Eloxochitlán,13020,1338,1516,2854
2015,Hidalgo,13,Emiliano Zapata,13021,7113,7793,14906
2015,Hidalgo,13,Epazoyucan,13022,7239,7660,14899
2015,Hidalgo,13,Francisco I. Madero,13023,17431,19082,36513
2015,Hidalgo,13,Huasca de Ocampo,13024,8680,9490,18170
2015,Hidalgo,13,Huautla,13025,11169,12019,23188
2015,Hidalgo,13,Huazalingo,13026,6915,7202,14117
2015,Hidalgo,13,Huehuetla,13027,12791,13490,26281
2015,Hidalgo,13,Huejutla de Reyes,13028,65782,67749,133531
2015,Hidalgo,13,Huichapan,13029,22633,24695,47328
2015,Hidalgo,13,Ixmiquilpan,13030,44230,49533,93763
2015,Hidalgo,13,Jacala de Ledezma,13031,6562,7296,13858
2015,Hidalgo,13,Jaltocán,13032,5968,6133,12101
2015,Hidalgo,13,Juárez Hidalgo,13033,1591,1702,3293
2015,Hidalgo,13,La Misión,13040,5320,5464,10784
2015,Hidalgo,13,Lolotla,13034,4972,5182,10154
2015,Hidalgo,13,Metepec,13035,5619,6322,11941
2015,Hidalgo,13,Metztitlán,13037,10307,11483,21790
2015,Hidalgo,13,Mineral de la Reforma,13051,75219,82246,157465
2015,Hidalgo,13,Mineral del Chico,13038,4311,4571,8882
2015,Hidalgo,13,Mineral del Monte,13039,7054,7814,14868
2015,Hidalgo,13,Mixquiahuala de Juárez,13041,22400,24340,46740
2015,Hidalgo,13,Molango de Escamilla,13042,5901,6115,12016
2015,Hidalgo,13,Nicolás Flores,13043,3376,3772,7148
2015,Hidalgo,13,Nopala de Villagrán,13044,8545,8814,17359
2015,Hidalgo,13,Omitlán de Juárez,13045,4679,5130,9809
2015,Hidalgo,13,Pachuca de Soto,13048,131169,143306,274475
2015,Hidalgo,13,Pacula,13047,2457,2833,5290
2015,Hidalgo,13,Pisaflores,13049,9279,9222,18501
2015,Hidalgo,13,Progreso de Obregón,13050,11350,12622,23972
2015,Hidalgo,13,San Agustín Metzquititlán,13036,4722,5197,9919
2015,Hidalgo,13,San Agustín Tlaxiaca,13052,17519,18301,35820
2015,Hidalgo,13,San Bartolo Tutotepec,13053,9733,9849,19582
2015,Hidalgo,13,San Felipe Orizatlán,13046,20344,20780,41124
2015,Hidalgo,13,San Salvador,13054,17295,18508,35803
2015,Hidalgo,13,Santiago Tulantepec de Lugo Guerrero,13056,17828,19496,37324
2015,Hidalgo,13,Santiago de Anaya,13055,8414,8877,17291
2015,Hidalgo,13,Singuilucan,13057,8034,8288,16322
2015,Hidalgo,13,Tasquillo,13058,7984,9362,17346
2015,Hidalgo,13,Tecozautla,13059,18243,19964,38207
2015,Hidalgo,13,Tenango de Doria,13060,9022,9834,18856
2015,Hidalgo,13,Tepeapulco,13061,27304,29177,56481
2015,Hidalgo,13,Tepehuacán de Guerrero,13062,15997,15392,31389
2015,Hidalgo,13,Tepeji del Río de Ocampo,13063,43390,44715,88105
2015,Hidalgo,13,Tepetitlán,13064,5376,5679,11055
2015,Hidalgo,13,Tetepango,13065,5901,5983,11884
2015,Hidalgo,13,Tezontepec de Aldama,13067,26206,26835,53041
2015,Hidalgo,13,Tianguistengo,13068,7516,7882,15398
2015,Hidalgo,13,Tizayuca,13069,57987,59490,117477
2015,Hidalgo,13,Tlahuelilpan,13070,9488,9819,19307
2015,Hidalgo,13,Tlahuiltepa,13071,5254,5362,10616
2015,Hidalgo,13,Tlanalapa,13072,5191,5515,10706
2015,Hidalgo,13,Tlanchinol,13073,19817,20185,40002
2015,Hidalgo,13,Tlaxcoapan,13074,14374,14821,29195
2015,Hidalgo,13,Tolcayuca,13075,7873,8336,16209
2015,Hidalgo,13,Tula de Allende,13076,54659,57635,112294
2015,Hidalgo,13,Tulancingo de Bravo,13077,75167,83703,158870
2015,Hidalgo,13,Villa de Tezontepec,13066,6238,6430,12668
2015,Hidalgo,13,Xochiatipan,13078,9962,10446,20408
2015,Hidalgo,13,Xochicoatlán,13079,3921,4038,7959
2015,Hidalgo,13,Yahualica,13080,12290,12783,25073
2015,Hidalgo,13,Zacualtipán de Ángeles,13081,16581,18222,34803
2015,Hidalgo,13,Zapotlán de Juárez,13082,9349,10072,19421
2015,Hidalgo,13,Zempoala,13083,21642,22832,44474
2015,Hidalgo,13,Zimapán,13084,19034,21995,41029
2015,Jalisco,14,Acatic,14001,10778,11248,22026
2015,Jalisco,14,Acatlán de Juárez,14002,12401,11396,23797
2015,Jalisco,14,Ahualulco de Mercado,14003,11756,12097,23853
2015,Jalisco,14,Amacueca,14004,2757,2924,5681
2015,Jalisco,14,Amatitán,14005,7795,7851,15646
2015,Jalisco,14,Ameca,14006,30462,31689,62151
2015,Jalisco,14,Arandas,14008,38670,41513,80183
2015,Jalisco,14,Atemajac de Brizuela,14010,3441,3486,6927
2015,Jalisco,14,Atengo,14011,2931,2729,5660
2015,Jalisco,14,Atenguillo,14012,2069,2146,4215
2015,Jalisco,14,Atotonilco el Alto,14013,30131,31364,61495
2015,Jalisco,14,Atoyac,14014,4143,4490,8633
2015,Jalisco,14,Autlán de Navarro,14015,30555,31415,61970
2015,Jalisco,14,Ayotlán,14016,19260,20221,39481
2015,Jalisco,14,Ayutla,14017,6533,6563,13096
2015,Jalisco,14,Bolaños,14019,3678,3698,7376
2015,Jalisco,14,Cabo Corrientes,14020,5522,5062,10584
2015,Jalisco,14,Casimiro Castillo,14021,11097,11152,22249
2015,Jalisco,14,Cañadas de Obregón,14117,2088,2226,4314
2015,Jalisco,14,Chapala,14030,25504,26491,51995
2015,Jalisco,14,Chimaltitán,14031,1800,1844,3644
2015,Jalisco,14,Chiquilistlán,14032,3086,3073,6159
2015,Jalisco,14,Cihuatlán,14022,20820,20278,41098
2015,Jalisco,14,Cocula,14024,13498,14260,27758
2015,Jalisco,14,Colotlán,14025,9012,9649,18661
2015,Jalisco,14,Concepción de Buenos Aires,14026,3175,3072,6247
2015,Jalisco,14,Cuautitlán de García Barragán,14027,9423,9094,18517
2015,Jalisco,14,Cuautla,14028,1070,1161,2231
2015,Jalisco,14,Cuquío,14029,8881,9695,18576
2015,Jalisco,14,Degollado,14033,10621,11425,22046
2015,Jalisco,14,Ejutla,14034,1041,995,2036
2015,Jalisco,14,El Arenal,14009,9639,9849,19488
2015,Jalisco,14,El Grullo,14037,12330,12854,25184
2015,Jalisco,14,El Limón,14054,2874,2875,5749
2015,Jalisco,14,El Salto,14070,88259,89198,177457
2015,Jalisco,14,Encarnación de Díaz,14035,26289,28360,54649
2015,Jalisco,14,Etzatlán,14036,9910,10272,20182
2015,Jalisco,14,Guachinango,14038,2253,2181,4434
2015,Jalisco,14,Guadalajara,14039,735280,773605,1508885
2015,Jalisco,14,Gómez Farías,14079,7102,7586,14688
2015,Jalisco,14,Hostotipaquillo,14040,5566,4861,10427
2015,Jalisco,14,Huejuquilla el Alto,14042,4335,4726,9061
2015,Jalisco,14,Huejúcar,14041,2845,3149,5994
2015,Jalisco,14,Ixtlahuacán de los Membrillos,14044,25288,25950,51238
2015,Jalisco,14,Ixtlahuacán del Río,14045,9602,10245,19847
2015,Jalisco,14,Jalostotitlán,14046,16730,17387,34117
2015,Jalisco,14,Jamay,14047,12478,12515,24993
2015,Jalisco,14,Jesús María,14048,9128,10719,19847
2015,Jalisco,14,Jilotlán de los Dolores,14049,5137,4913,10050
2015,Jalisco,14,Jocotepec,14050,22994,23289,46283
2015,Jalisco,14,Juanacatlán,14051,8684,8718,17402
2015,Jalisco,14,Juchitlán,14052,2815,3020,5835
2015,Jalisco,14,La Barca,14018,32612,34844,67456
2015,Jalisco,14,La Huerta,14043,12586,12229,24815
2015,Jalisco,14,La Manzanilla de la Paz,14057,1878,2042,3920
2015,Jalisco,14,Lagos de Moreno,14053,81085,84980,166065
2015,Jalisco,14,Magdalena,14055,11355,11456,22811
2015,Jalisco,14,Mascota,14058,7369,7609,14978
2015,Jalisco,14,Mazamitla,14059,6726,7303,14029
2015,Jalisco,14,Mexticacán,14060,2646,3129,5775
2015,Jalisco,14,Mezquitic,14061,9385,9881,19266
2015,Jalisco,14,Mixtlán,14062,1847,1841,3688
2015,Jalisco,14,Ocotlán,14063,49956,51507,101463
2015,Jalisco,14,Ojuelos de Jalisco,14064,15892,16606,32498
2015,Jalisco,14,Pihuamo,14065,6055,5996,12051
2015,Jalisco,14,Poncitlán,14066,25777,26436,52213
2015,Jalisco,14,Puerto Vallarta,14067,140586,137243,277829
2015,Jalisco,14,Quitupan,14069,4178,4698,8876
2015,Jalisco,14,San Cristóbal de la Barranca,14071,1613,1651,3264
2015,Jalisco,14,San Diego de Alejandría,14072,3500,3807,7307
2015,Jalisco,14,San Gabriel,14113,7964,8324,16288
2015,Jalisco,14,San Ignacio Cerro Gordo,14125,9301,9841,19142
2015,Jalisco,14,San Juan de los Lagos,14073,34596,35340,69936
2015,Jalisco,14,San Juanito de Escobedo,14007,4818,4758,9576
2015,Jalisco,14,San Julián,14074,7621,8520,16141
2015,Jalisco,14,San Marcos,14075,2000,1931,3931
2015,Jalisco,14,San Martín Hidalgo,14077,13768,14525,28293
2015,Jalisco,14,San Martín de Bolaños,14076,1695,1663,3358
2015,Jalisco,14,San Miguel el Alto,14078,16096,17100,33196
2015,Jalisco,14,San Pedro Tlaquepaque,14098,332556,334993,667549
2015,Jalisco,14,San Sebastián del Oeste,14080,3104,2844,5948
2015,Jalisco,14,Santa María de los Ángeles,14081,1647,1844,3491
2015,Jalisco,14,Santa María del Oro,14056,1185,1175,2360
2015,Jalisco,14,Sayula,14082,18284,19551,37835
2015,Jalisco,14,Tala,14083,38599,39221,77820
2015,Jalisco,14,Talpa de Allende,14084,7774,7674,15448
2015,Jalisco,14,Tamazula de Gordiano,14085,19537,20437,39974
2015,Jalisco,14,Tapalpa,14086,9575,9931,19506
2015,Jalisco,14,Tecalitlán,14087,8520,8885,17405
2015,Jalisco,14,Techaluta de Montenegro,14089,1838,1906,3744
2015,Jalisco,14,Tecolotlán,14088,8826,8796,17622
2015,Jalisco,14,Tenamaxtlán,14090,3715,3700,7415
2015,Jalisco,14,Teocaltiche,14091,20129,22205,42334
2015,Jalisco,14,Teocuitatlán de Corona,14092,5376,5624,11000
2015,Jalisco,14,Tepatitlán de Morelos,14093,71067,73941,145008
2015,Jalisco,14,Tequila,14094,21507,21668,43175
2015,Jalisco,14,Teuchitlán,14095,4729,4967,9696
2015,Jalisco,14,Tizapán el Alto,14096,10564,11105,21669
2015,Jalisco,14,Tlajomulco de Zúñiga,14097,265918,270673,536591
2015,Jalisco,14,Tolimán,14099,5127,5249,10376
2015,Jalisco,14,Tomatlán,14100,18844,17877,36721
2015,Jalisco,14,Tonalá,14101,268632,266379,535011
2015,Jalisco,14,Tonaya,14102,3035,3159,6194
2015,Jalisco,14,Tonila,14103,3996,4055,8051
2015,Jalisco,14,Totatiche,14104,2273,2310,4583
2015,Jalisco,14,Tototlán,14105,11523,11883,23406
2015,Jalisco,14,Tuxcacuesco,14106,2235,2153,4388
2015,Jalisco,14,Tuxcueca,14107,3131,3341,6472
2015,Jalisco,14,Tuxpan,14108,17383,18462,35845
2015,Jalisco,14,Unión de San Antonio,14109,8762,9471,18233
2015,Jalisco,14,Unión de Tula,14110,6844,7337,14181
2015,Jalisco,14,Valle de Guadalupe,14111,3511,3587,7098
2015,Jalisco,14,Valle de Juárez,14112,2805,2985,5790
2015,Jalisco,14,Villa Corona,14114,8908,9208,18116
2015,Jalisco,14,Villa Guerrero,14115,2804,2914,5718
2015,Jalisco,14,Villa Hidalgo,14116,9885,10530,20415
2015,Jalisco,14,Villa Purificación,14068,5947,5614,11561
2015,Jalisco,14,Yahualica de González Gallo,14118,11343,12473,23816
2015,Jalisco,14,Zacoalco de Torres,14119,14424,14759,29183
2015,Jalisco,14,Zapopan,14120,668515,688487,1357002
2015,Jalisco,14,Zapotiltic,14121,14866,15560,30426
2015,Jalisco,14,Zapotitlán de Vadillo,14122,3588,3588,7176
2015,Jalisco,14,Zapotlanejo,14124,33703,34885,68588
2015,Jalisco,14,Zapotlán del Rey,14123,9189,9284,18473
2015,Jalisco,14,Zapotlán el Grande,14023,52950,55671,108621
2015,Michoacán,16,Acuitzio,16001,5567,6029,11596
2015,Michoacán,16,Aguililla,16002,8162,8020,16182
2015,Michoacán,16,Angamacutiro,16004,7196,8036,15232
2015,Michoacán,16,Angangueo,16005,5517,5849,11366
2015,Michoacán,16,Apatzingán,16006,64888,66073,130961
2015,Michoacán,16,Aporo,16007,1591,1696,3287
2015,Michoacán,16,Aquila,16008,12702,12243,24945
2015,Michoacán,16,Ario,16009,17966,18982,36948
2015,Michoacán,16,Arteaga,16010,11333,11390,22723
2015,Michoacán,16,Briseñas,16011,5537,5868,11405
2015,Michoacán,16,Buenavista,16012,23694,23020,46714
2015,Michoacán,16,Carácuaro,16013,4861,4862,9723
2015,Michoacán,16,Charapan,16021,5902,6687,12589
2015,Michoacán,16,Charo,16022,11715,10819,22534
2015,Michoacán,16,Chavinda,16023,5076,5451,10527
2015,Michoacán,16,Cherán,16024,9217,9918,19135
2015,Michoacán,16,Chilchota,16025,18641,20104,38745
2015,Michoacán,16,Chinicuila,16026,2757,2549,5306
2015,Michoacán,16,Chucándiro,16027,2280,2739,5019
2015,Michoacán,16,Churintzio,16028,2503,2910,5413
2015,Michoacán,16,Churumuco,16029,7714,7745,15459
2015,Michoacán,16,Coahuayana,16014,7515,7041,14556
2015,Michoacán,16,Coalcomán de Vázquez Pallares,16015,9342,9548,18890
2015,Michoacán,16,Coeneo,16016,9722,11596,21318
2015,Michoacán,16,Cojumatlán de Régules,16074,5171,5448,10619
2015,Michoacán,16,Contepec,16017,16946,17889,34835
2015,Michoacán,16,Copándaro,16018,4366,4929,9295
2015,Michoacán,16,Cotija,16019,9379,10472,19851
2015,Michoacán,16,Cuitzeo,16020,14272,15851,30123
2015,Michoacán,16,Ecuandureo,16030,6038,7240,13278
2015,Michoacán,16,Epitacio Huerta,16031,8375,8758,17133
2015,Michoacán,16,Erongarícuaro,16032,7469,7998,15467
2015,Michoacán,16,Gabriel Zamora,16033,11420,11505,22925
2015,Michoacán,16,Hidalgo,16034,60644,64300,124944
2015,Michoacán,16,Huandacareo,16036,5621,6505,12126
2015,Michoacán,16,Huaniqueo,16037,3751,4549,8300
2015,Michoacán,16,Huetamo,16038,20961,22011,42972
2015,Michoacán,16,Huiramba,16039,4285,4464,8749
2015,Michoacán,16,Indaparapeo,16040,8329,8923,17252
2015,Michoacán,16,Irimbo,16041,7223,7986,15209
2015,Michoacán,16,Ixtlán,16042,6599,6939,13538
2015,Michoacán,16,Jacona,16043,34025,35993,70018
2015,Michoacán,16,Jiménez,16044,6282,6981,13263
2015,Michoacán,16,Jiquilpan,16045,16447,18196,34643
2015,Michoacán,16,José Sixto Verduzco,16113,12623,14183,26806
2015,Michoacán,16,Jungapeo,16047,10724,10925,21649
2015,Michoacán,16,Juárez,16046,7066,7446,14512
2015,Michoacán,16,La Huacana,16035,17268,17546,34814
2015,Michoacán,16,La Piedad,16069,50512,55193,105705
2015,Michoacán,16,Lagunillas,16048,2769,2905,5674
2015,Michoacán,16,Los Reyes,16075,33548,35208,68756
2015,Michoacán,16,Lázaro Cárdenas,16052,94609,93543,188152
2015,Michoacán,16,Madero,16049,9125,9090,18215
2015,Michoacán,16,Maravatío,16050,41960,45373,87333
2015,Michoacán,16,Marcos Castellanos,16051,6622,7155,13777
2015,Michoacán,16,Morelia,16053,381429,408599,790028
2015,Michoacán,16,Morelos,16054,3699,4539,8238
2015,Michoacán,16,Múgica,16055,23071,23546,46617
2015,Michoacán,16,Nahuatzen,16056,13908,14790,28698
2015,Michoacán,16,Nocupétaro,16057,4119,4213,8332
2015,Michoacán,16,Nuevo Parangaricutiro,16058,9637,10110,19747
2015,Michoacán,16,Nuevo Urecho,16059,4199,4179,8378
2015,Michoacán,16,Numarán,16060,4806,5309,10115
2015,Michoacán,16,Ocampo,16061,12212,12233,24445
2015,Michoacán,16,Pajacuarán,16062,9657,10434,20091
2015,Michoacán,16,Panindícuaro,16063,7686,8754,16440
2015,Michoacán,16,Paracho,16065,17887,19669,37556
2015,Michoacán,16,Parácuaro,16064,13572,13379,26951
2015,Michoacán,16,Penjamillo,16067,8136,9467,17603
2015,Michoacán,16,Peribán,16068,13724,13732,27456
2015,Michoacán,16,Puruándiro,16071,32928,37108,70036
2015,Michoacán,16,Purépero,16070,7814,8248,16062
2015,Michoacán,16,Pátzcuaro,16066,45142,48975,94117
2015,Michoacán,16,Queréndaro,16072,6862,7256,14118
2015,Michoacán,16,Quiroga,16073,13314,14543,27857
2015,Michoacán,16,Sahuayo,16076,37563,39510,77073
2015,Michoacán,16,Salvador Escalante,16079,23667,25195,48862
2015,Michoacán,16,San Lucas,16077,9246,9495,18741
2015,Michoacán,16,Santa Ana Maya,16078,6019,6938,12957
2015,Michoacán,16,Senguio,16080,9290,9930,19220
2015,Michoacán,16,Susupuato,16081,4429,4539,8968
2015,Michoacán,16,Tacámbaro,16082,37058,38806,75864
2015,Michoacán,16,Tancítaro,16083,15742,15531,31273
2015,Michoacán,16,Tangamandapio,16084,14252,15449,29701
2015,Michoacán,16,Tangancícuaro,16085,16552,17770,34322
2015,Michoacán,16,Tanhuato,16086,7736,8202,15938
2015,Michoacán,16,Taretan,16087,7279,7499,14778
2015,Michoacán,16,Tarímbaro,16088,48914,53168,102082
2015,Michoacán,16,Tepalcatepec,16089,12336,12074,24410
2015,Michoacán,16,Tingambato,16090,7312,7784,15096
2015,Michoacán,16,Tingüindín,16091,7003,7638,14641
2015,Michoacán,16,Tiquicheo de Nicolás Romero,16092,7093,7249,14342
2015,Michoacán,16,Tlalpujahua,16093,13822,15337,29159
2015,Michoacán,16,Tlazazalca,16094,3213,3497,6710
2015,Michoacán,16,Tocumbo,16095,5946,6135,12081
2015,Michoacán,16,Tumbiscatío,16096,3893,3757,7650
2015,Michoacán,16,Turicato,16097,16044,16972,33016
2015,Michoacán,16,Tuxpan,16098,13410,14402,27812
2015,Michoacán,16,Tuzantla,16099,8038,8196,16234
2015,Michoacán,16,Tzintzuntzan,16100,6856,7646,14502
2015,Michoacán,16,Tzitzio,16101,4738,4639,9377
2015,Michoacán,16,Uruapan,16102,164230,173658,337888
2015,Michoacán,16,Venustiano Carranza,16103,12202,12783,24985
2015,Michoacán,16,Villamar,16104,8340,9168,17508
2015,Michoacán,16,Vista Hermosa,16105,10131,10520,20651
2015,Michoacán,16,Yurécuaro,16106,15409,16267,31676
2015,Michoacán,16,Zacapu,16107,37644,40415,78059
2015,Michoacán,16,Zamora,16108,96747,102610,199357
2015,Michoacán,16,Zinapécuaro,16110,23320,25388,48708
2015,Michoacán,16,Zináparo,16109,1516,1819,3335
2015,Michoacán,16,Ziracuaretiro,16111,8426,8655,17081
2015,Michoacán,16,Zitácuaro,16112,79504,85832,165336
2015,Michoacán,16,Álvaro Obregón,16003,10525,11423,21948
2015,Morelos,17,Amacuzac,17001,8792,9304,18096
2015,Morelos,17,Atlatlahucan,17002,10643,11149,21792
2015,Morelos,17,Axochiapan,17003,17726,18410,36136
2015,Morelos,17,Ayala,17004,41426,44286,85712
2015,Morelos,17,Coatlán del Río,17005,4890,5073,9963
2015,Morelos,17,Cuautla,17006,93744,101198,194942
2015,Morelos,17,Cuernavaca,17007,182264,203494,385758
2015,Morelos,17,Emiliano Zapata,17008,47089,48878,95967
2015,Morelos,17,Huitzilac,17009,9492,9556,19048
2015,Morelos,17,Jantetelco,17010,8356,8783,17139
2015,Morelos,17,Jiutepec,17011,104936,111872,216808
2015,Morelos,17,Jojutla,17012,28424,30523,58947
2015,Morelos,17,Jonacatepec,17013,7641,8280,15921
2015,Morelos,17,Mazatepec,17014,4977,5218,10195
2015,Morelos,17,Miacatlán,17015,13108,13863,26971
2015,Morelos,17,Ocuituco,17016,9097,9377,18474
2015,Morelos,17,Puente de Ixtla,17017,32769,34157,66926
2015,Morelos,17,Temixco,17018,57211,60080,117291
2015,Morelos,17,Temoac,17033,7615,8120,15735
2015,Morelos,17,Tepalcingo,17019,13402,14063,27465
2015,Morelos,17,Tepoztlán,17020,22898,23694,46592
2015,Morelos,17,Tetecala,17021,3929,3966,7895
2015,Morelos,17,Tetela del Volcán,17022,10009,10641,20650
2015,Morelos,17,Tlalnepantla,17023,3633,3573,7206
2015,Morelos,17,Tlaltizapán de Zapata,17024,25720,27104,52824
2015,Morelos,17,Tlaquiltenango,17025,16929,17413,34342
2015,Morelos,17,Tlayacapan,17026,8854,9040,17894
2015,Morelos,17,Totolapan,17027,5905,6069,11974
2015,Morelos,17,Xochitepec,17028,34845,34041,68886
2015,Morelos,17,Yautepec,17029,50645,53446,104091
2015,Morelos,17,Yecapixtla,17030,25539,26200,51739
2015,Morelos,17,Zacatepec,17031,18033,19508,37541
2015,Morelos,17,Zacualpan,17032,4675,4910,9585
2015,Nayarit,18,Acaponeta,18001,19550,19428,38978
2015,Nayarit,18,Ahuacatlán,18002,8238,8188,16426
2015,Nayarit,18,Amatlán de Cañas,18003,6169,5975,12144
2015,Nayarit,18,Bahía de Banderas,18020,76020,73540,149560
2015,Nayarit,18,Compostela,18004,38622,38395,77017
2015,Nayarit,18,Del Nayar,18009,20636,20527,41163
2015,Nayarit,18,Huajicori,18005,6479,6199,12678
2015,Nayarit,18,Ixtlán del Río,18006,14569,15489,30058
2015,Nayarit,18,Jala,18007,9422,9597,19019
2015,Nayarit,18,La Yesca,18019,7407,7094,14501
2015,Nayarit,18,Rosamorada,18010,18304,17565,35869
2015,Nayarit,18,Ruíz,18011,12829,12498,25327
2015,Nayarit,18,San Blas,18012,23905,21582,45487
2015,Nayarit,18,San Pedro Lagunillas,18013,4011,3916,7927
2015,Nayarit,18,Santa María del Oro,18014,12550,11867,24417
2015,Nayarit,18,Santiago Ixcuintla,18015,51027,49479,100506
2015,Nayarit,18,Tecuala,18016,21205,20500,41705
2015,Nayarit,18,Tepic,18017,202536,211489,414025
2015,Nayarit,18,Tuxpan,18018,15939,16066,32005
2015,Nayarit,18,Xalisco,18008,27802,28868,56670
2015,Nuevo León,19,Abasolo,19001,1460,1440,2900
2015,Nuevo León,19,Agualeguas,19002,1451,1388,2839
2015,Nuevo León,19,Allende,19004,18056,17679,35735
2015,Nuevo León,19,Anáhuac,19005,9762,9768,19530
2015,Nuevo León,19,Apodaca,19006,300432,295988,596420
2015,Nuevo León,19,Aramberri,19007,8576,8311,16887
2015,Nuevo León,19,Bustamante,19008,2061,2061,4122
2015,Nuevo León,19,Cadereyta Jiménez,19009,50389,47286,97675
2015,Nuevo León,19,Cerralvo,19011,4335,4086,8421
2015,Nuevo León,19,China,19013,5964,5654,11618
2015,Nuevo León,19,Ciénega de Flores,19012,21318,20595,41913
2015,Nuevo León,19,Doctor Arroyo,19014,18435,18145,36580
2015,Nuevo León,19,Doctor Coss,19015,915,875,1790
2015,Nuevo León,19,Doctor González,19016,1666,1584,3250
2015,Nuevo León,19,El Carmen,19010,19312,19019,38331
2015,Nuevo León,19,Galeana,19017,21913,21328,43241
2015,Nuevo León,19,García,19018,121378,120877,242255
2015,Nuevo León,19,General Bravo,19020,3039,2837,5876
2015,Nuevo León,19,General Escobedo,19021,212077,210678,422755
2015,Nuevo León,19,General Terán,19022,7851,7853,15704
2015,Nuevo León,19,General Treviño,19023,616,627,1243
2015,Nuevo León,19,General Zaragoza,19024,3292,3058,6350
2015,Nuevo León,19,General Zuazua,19025,37474,36927,74401
2015,Nuevo León,19,Guadalupe,19026,353103,341933,695036
2015,Nuevo León,19,Hidalgo,19047,7996,7906,15902
2015,Nuevo León,19,Higueras,19028,856,790,1646
2015,Nuevo León,19,Hualahuises,19029,3659,3750,7409
2015,Nuevo León,19,Iturbide,19030,1975,1846,3821
2015,Nuevo León,19,Juárez,19031,166924,163963,330887
2015,Nuevo León,19,Lampazos de Naranjo,19032,2794,2717,5511
2015,Nuevo León,19,Linares,19033,41813,42094,83907
2015,Nuevo León,19,Los Aldamas,19003,750,728,1478
2015,Nuevo León,19,Los Herreras,19027,1004,1014,2018
2015,Nuevo León,19,Los Ramones,19042,2713,2634,5347
2015,Nuevo León,19,Marín,19034,3075,2880,5955
2015,Nuevo León,19,Melchor Ocampo,19035,521,508,1029
2015,Nuevo León,19,Mier y Noriega,19036,3775,3691,7466
2015,Nuevo León,19,Mina,19037,2943,2784,5727
2015,Nuevo León,19,Montemorelos,19038,31938,31838,63776
2015,Nuevo León,19,Monterrey,19039,535042,553513,1088555
2015,Nuevo León,19,Parás,19040,552,533,1085
2015,Nuevo León,19,Pesquería,19041,45151,45270,90421
2015,Nuevo León,19,Rayones,19043,1466,1359,2825
2015,Nuevo León,19,Sabinas Hidalgo,19044,18490,18888,37378
2015,Nuevo León,19,Salinas Victoria,19045,27119,25973,53092
2015,Nuevo León,19,San Nicolás de los Garza,19046,236198,241398,477596
2015,Nuevo León,19,San Pedro Garza García,19019,62886,70480,133366
2015,Nuevo León,19,Santa Catarina,19048,152588,150916,303504
2015,Nuevo León,19,Santiago,19049,22406,22098,44504
2015,Nuevo León,19,Vallecillo,19050,1027,877,1904
2015,Nuevo León,19,Villaldama,19051,2235,2209,4444
2015,Oaxaca,20,Abejones,20001,499,616,1115
2015,Oaxaca,20,Acatlán de Pérez Figueroa,20002,22937,23954,46891
2015,Oaxaca,20,Asunción Cacalotepec,20003,1088,1162,2250
2015,Oaxaca,20,Asunción Cuyotepeji,20004,463,534,997
2015,Oaxaca,20,Asunción Ixtaltepec,20005,7781,7860,15641
2015,Oaxaca,20,Asunción Nochixtlán,20006,8768,9805,18573
2015,Oaxaca,20,Asunción Ocotlán,20007,1241,1527,2768
2015,Oaxaca,20,Asunción Tlacolulita,20008,394,411,805
2015,Oaxaca,20,Ayoquezco de Aldama,20398,2140,2425,4565
2015,Oaxaca,20,Ayotzintepec,20009,3559,3600,7159
2015,Oaxaca,20,Calihualá,20011,590,617,1207
2015,Oaxaca,20,Candelaria Loxicha,20012,5049,5363,10412
2015,Oaxaca,20,Capulálpam de Méndez,20247,696,861,1557
2015,Oaxaca,20,Chahuites,20025,5750,5844,11594
2015,Oaxaca,20,Chalcatongo de Hidalgo,20026,4197,4808,9005
2015,Oaxaca,20,Chiquihuitlán de Benito Juárez,20027,1116,1311,2427
2015,Oaxaca,20,Ciudad Ixtepec,20014,13790,15031,28821
2015,Oaxaca,20,Ciénega de Zimatlán,20013,1412,1572,2984
2015,Oaxaca,20,Coatecas Altas,20015,2393,2615,5008
2015,Oaxaca,20,Coicoyán de las Flores,20016,4485,5053,9538
2015,Oaxaca,20,Concepción Buenavista,20018,410,433,843
2015,Oaxaca,20,Concepción Pápalo,20019,1550,1537,3087
2015,Oaxaca,20,Constancia del Rosario,20020,1856,2148,4004
2015,Oaxaca,20,Cosolapa,20021,7705,8247,15952
2015,Oaxaca,20,Cosoltepec,20022,388,459,847
2015,Oaxaca,20,Cuilápam de Guerrero,20023,10060,10709,20769
2015,Oaxaca,20,Cuyamecalco Villa de Zaragoza,20024,1947,1910,3857
2015,Oaxaca,20,El Barrio de la Soledad,20010,7111,7586,14697
2015,Oaxaca,20,El Espinal,20030,4360,4556,8916
2015,Oaxaca,20,Eloxochitlán de Flores Magón,20029,2053,2273,4326
2015,Oaxaca,20,Fresnillo de Trujano,20032,483,537,1020
2015,Oaxaca,20,Guadalupe Etla,20033,1267,1419,2686
2015,Oaxaca,20,Guadalupe de Ramírez,20034,649,679,1328
2015,Oaxaca,20,Guelatao de Juárez,20035,295,295,590
2015,Oaxaca,20,Guevea de Humboldt,20036,2718,2808,5526
2015,Oaxaca,20,Heroica Ciudad de Ejutla de Crespo,20028,9803,10997,20800
2015,Oaxaca,20,Heroica Ciudad de Huajuapan de León,20039,35833,40101,75934
2015,Oaxaca,20,Heroica Ciudad de Juchitán de Zaragoza,20043,48526,50961,99487
2015,Oaxaca,20,Heroica Ciudad de Tlaxiaco,20397,19034,21497,40531
2015,Oaxaca,20,Huautepec,20040,3009,3400,6409
2015,Oaxaca,20,Huautla de Jiménez,20041,15207,17353,32560
2015,Oaxaca,20,Ixpantepec Nieves,20065,566,701,1267
2015,Oaxaca,20,Ixtlán de Juárez,20042,4072,4198,8270
2015,Oaxaca,20,La Compañía,20017,1638,1819,3457
2015,Oaxaca,20,La Pe,20069,1242,1351,2593
2015,Oaxaca,20,La Reforma,20076,1577,1760,3337
2015,Oaxaca,20,La Trinidad Vista Hermosa,20556,117,140,257
2015,Oaxaca,20,Loma Bonita,20044,20838,22826,43664
2015,Oaxaca,20,Magdalena Apasco,20045,3982,4415,8397
2015,Oaxaca,20,Magdalena Jaltepec,20046,1566,1812,3378
2015,Oaxaca,20,Magdalena Mixtepec,20048,663,688,1351
2015,Oaxaca,20,Magdalena Ocotlán,20049,564,622,1186
2015,Oaxaca,20,Magdalena Peñasco,20050,1700,1944,3644
2015,Oaxaca,20,Magdalena Teitipac,20051,2242,2403,4645
2015,Oaxaca,20,Magdalena Tequisistlán,20052,3085,3221,6306
2015,Oaxaca,20,Magdalena Tlacotepec,20053,608,669,1277
2015,Oaxaca,20,Magdalena Yodocono de Porfirio Díaz,20562,740,787,1527
2015,Oaxaca,20,Magdalena Zahuatlán,20054,200,228,428
2015,Oaxaca,20,Mariscala de Juárez,20055,1709,1858,3567
2015,Oaxaca,20,Matías Romero Avendaño,20057,19583,21098,40681
2015,Oaxaca,20,Mazatlán Villa de Flores,20058,6775,6819,13594
2015,Oaxaca,20,Mesones Hidalgo,20037,2056,2400,4456
2015,Oaxaca,20,Miahuatlán de Porfirio Díaz,20059,20567,22443,43010
2015,Oaxaca,20,Mixistlán de la Reforma,20060,1281,1428,2709
2015,Oaxaca,20,Monjas,20061,1231,1456,2687
2015,Oaxaca,20,Mártires de Tacubaya,20056,692,746,1438
2015,Oaxaca,20,Natividad,20062,271,308,579
2015,Oaxaca,20,Nazareno Etla,20063,1945,2148,4093
2015,Oaxaca,20,Nejapa de Madero,20064,3752,3906,7658
2015,Oaxaca,20,Nuevo Zoquiápam,20504,798,875,1673
2015,Oaxaca,20,Oaxaca de Juárez,20067,121998,137783,259781
2015,Oaxaca,20,Ocotlán de Morelos,20068,10626,11626,22252
2015,Oaxaca,20,Pinotepa de Don Luis,20070,3486,3586,7072
2015,Oaxaca,20,Pluma Hidalgo,20071,1504,1572,3076
2015,Oaxaca,20,Putla Villa de Guerrero,20073,15595,17623,33218
2015,Oaxaca,20,Reforma de Pineda,20075,1385,1459,2844
2015,Oaxaca,20,Reyes Etla,20077,1839,1973,3812
2015,Oaxaca,20,Rojas de Cuauhtémoc,20078,545,593,1138
2015,Oaxaca,20,Salina Cruz,20079,43175,46544,89719
2015,Oaxaca,20,San Agustín Amatengo,20080,688,793,1481
2015,Oaxaca,20,San Agustín Atenango,20081,858,1015,1873
2015,Oaxaca,20,San Agustín Chayuco,20082,2019,2224,4243
2015,Oaxaca,20,San Agustín Etla,20084,1934,2126,4060
2015,Oaxaca,20,San Agustín Loxicha,20085,11963,12461,24424
2015,Oaxaca,20,San Agustín Tlacotepec,20086,411,540,951
2015,Oaxaca,20,San Agustín Yatareni,20087,2018,2322,4340
2015,Oaxaca,20,San Agustín de las Juntas,20083,4484,4678,9162
2015,Oaxaca,20,San Andrés Cabecera Nueva,20088,1406,1458,2864
2015,Oaxaca,20,San Andrés Dinicuiti,20089,1076,1140,2216
2015,Oaxaca,20,San Andrés Huaxpaltepec,20090,3045,3219,6264
2015,Oaxaca,20,San Andrés Huayápam,20091,2571,2829,5400
2015,Oaxaca,20,San Andrés Ixtlahuaca,20092,742,854,1596
2015,Oaxaca,20,San Andrés Lagunas,20093,239,276,515
2015,Oaxaca,20,San Andrés Nuxiño,20094,910,984,1894
2015,Oaxaca,20,San Andrés Paxtlán,20095,2165,2184,4349
2015,Oaxaca,20,San Andrés Sinaxtla,20096,356,400,756
2015,Oaxaca,20,San Andrés Solaga,20097,856,905,1761
2015,Oaxaca,20,San Andrés Teotilálpam,20098,2205,2361,4566
2015,Oaxaca,20,San Andrés Tepetlapa,20099,238,275,513
2015,Oaxaca,20,San Andrés Yaá,20100,206,249,455
2015,Oaxaca,20,San Andrés Zabache,20101,337,420,757
2015,Oaxaca,20,San Andrés Zautla,20102,2219,2347,4566
2015,Oaxaca,20,San Antonino Castillo Velasco,20103,2867,3153,6020
2015,Oaxaca,20,San Antonino Monte Verde,20105,3356,3878,7234
2015,Oaxaca,20,San Antonino el Alto,20104,1296,1346,2642
2015,Oaxaca,20,San Antonio Acutla,20106,129,156,285
2015,Oaxaca,20,San Antonio Huitepec,20108,2088,2410,4498
2015,Oaxaca,20,San Antonio Nanahuatípam,20109,635,646,1281
2015,Oaxaca,20,San Antonio Sinicahua,20110,733,853,1586
2015,Oaxaca,20,San Antonio Tepetlapa,20111,2095,2258,4353
2015,Oaxaca,20,San Antonio de la Cal,20107,11228,12492,23720
2015,Oaxaca,20,San Baltazar Chichicápam,20112,1239,1400,2639
2015,Oaxaca,20,San Baltazar Loxicha,20113,1469,1554,3023
2015,Oaxaca,20,San Baltazar Yatzachi el Bajo,20114,323,369,692
2015,Oaxaca,20,San Bartolo Coyotepec,20115,4476,4932,9408
2015,Oaxaca,20,San Bartolo Soyaltepec,20121,303,381,684
2015,Oaxaca,20,San Bartolo Yautepec,20122,339,341,680
2015,Oaxaca,20,San Bartolomé Ayautla,20116,2175,2298,4473
2015,Oaxaca,20,San Bartolomé Loxicha,20117,1231,1261,2492
2015,Oaxaca,20,San Bartolomé Quialana,20118,1082,1492,2574
2015,Oaxaca,20,San Bartolomé Yucuañe,20119,167,238,405
2015,Oaxaca,20,San Bartolomé Zoogocho,20120,158,203,361
2015,Oaxaca,20,San Bernardo Mixtepec,20123,1310,1444,2754
2015,Oaxaca,20,San Blas Atempa,20124,9364,9335,18699
2015,Oaxaca,20,San Carlos Yautepec,20125,6037,6031,12068
2015,Oaxaca,20,San Cristóbal Amatlán,20126,2419,2725,5144
2015,Oaxaca,20,San Cristóbal Amoltepec,20127,547,635,1182
2015,Oaxaca,20,San Cristóbal Lachirioag,20128,603,665,1268
2015,Oaxaca,20,San Cristóbal Suchixtlahuaca,20129,169,183,352
2015,Oaxaca,20,San Dionisio Ocotepec,20131,5086,5779,10865
2015,Oaxaca,20,San Dionisio Ocotlán,20132,582,609,1191
2015,Oaxaca,20,San Dionisio del Mar,20130,2720,2624,5344
2015,Oaxaca,20,San Esteban Atatlahuca,20133,1878,1965,3843
2015,Oaxaca,20,San Felipe Jalapa de Díaz,20134,13760,14561,28321
2015,Oaxaca,20,San Felipe Tejalápam,20135,3703,4045,7748
2015,Oaxaca,20,San Felipe Usila,20136,5778,6239,12017
2015,Oaxaca,20,San Francisco Cahuacuá,20137,1719,1749,3468
2015,Oaxaca,20,San Francisco Cajonos,20138,207,240,447
2015,Oaxaca,20,San Francisco Chapulapa,20139,1022,1099,2121
2015,Oaxaca,20,San Francisco Chindúa,20140,401,421,822
2015,Oaxaca,20,San Francisco Huehuetlán,20142,503,629,1132
2015,Oaxaca,20,San Francisco Ixhuatán,20143,4621,4727,9348
2015,Oaxaca,20,San Francisco Jaltepetongo,20144,501,522,1023
2015,Oaxaca,20,San Francisco Lachigoló,20145,1967,2049,4016
2015,Oaxaca,20,San Francisco Logueche,20146,1325,1493,2818
2015,Oaxaca,20,San Francisco Nuxaño,20147,196,186,382
2015,Oaxaca,20,San Francisco Ozolotepec,20148,965,1010,1975
2015,Oaxaca,20,San Francisco Sola,20149,793,884,1677
2015,Oaxaca,20,San Francisco Telixtlahuaca,20150,6151,6612,12763
2015,Oaxaca,20,San Francisco Teopan,20151,190,174,364
2015,Oaxaca,20,San Francisco Tlapancingo,20152,1011,1242,2253
2015,Oaxaca,20,San Francisco del Mar,20141,3931,3802,7733
2015,Oaxaca,20,San Gabriel Mixtepec,20153,2345,2513,4858
2015,Oaxaca,20,San Ildefonso Amatlán,20154,1143,1299,2442
2015,Oaxaca,20,San Ildefonso Sola,20155,485,482,967
2015,Oaxaca,20,San Ildefonso Villa Alta,20156,1684,1796,3480
2015,Oaxaca,20,San Jacinto Amilpas,20157,7887,8717,16604
2015,Oaxaca,20,San Jacinto Tlacotepec,20158,1118,1186,2304
2015,Oaxaca,20,San Jerónimo Coatlán,20159,2665,2811,5476
2015,Oaxaca,20,San Jerónimo Silacayoapilla,20160,734,775,1509
2015,Oaxaca,20,San Jerónimo Sosola,20161,1249,1403,2652
2015,Oaxaca,20,San Jerónimo Taviche,20162,927,1016,1943
2015,Oaxaca,20,San Jerónimo Tecóatl,20163,771,876,1647
2015,Oaxaca,20,San Jerónimo Tlacochahuaya,20550,2590,2941,5531
2015,Oaxaca,20,San Jorge Nuchita,20164,1381,1611,2992
2015,Oaxaca,20,San José Ayuquila,20165,708,830,1538
2015,Oaxaca,20,San José Chiltepec,20166,5828,6185,12013
2015,Oaxaca,20,San José Estancia Grande,20168,522,532,1054
2015,Oaxaca,20,San José Independencia,20169,1878,2026,3904
2015,Oaxaca,20,San José Lachiguiri,20170,1638,1993,3631
2015,Oaxaca,20,San José Tenango,20171,9166,9796,18962
2015,Oaxaca,20,San José del Peñasco,20167,1046,1084,2130
2015,Oaxaca,20,San José del Progreso,20072,3338,3556,6894
2015,Oaxaca,20,San Juan Achiutla,20172,203,214,417
2015,Oaxaca,20,San Juan Atepec,20173,713,797,1510
2015,Oaxaca,20,San Juan Bautista Atatlahuca,20175,798,847,1645
2015,Oaxaca,20,San Juan Bautista Coixtlahuaca,20176,1359,1482,2841
2015,Oaxaca,20,San Juan Bautista Cuicatlán,20177,4901,5190,10091
2015,Oaxaca,20,San Juan Bautista Guelache,20178,3335,3715,7050
2015,Oaxaca,20,San Juan Bautista Jayacatlán,20179,743,731,1474
2015,Oaxaca,20,San Juan Bautista Lo de Soto,20180,1255,1278,2533
2015,Oaxaca,20,San Juan Bautista Suchitepec,20181,207,240,447
2015,Oaxaca,20,San Juan Bautista Tlachichilco,20183,670,781,1451
2015,Oaxaca,20,San Juan Bautista Tlacoatzintepec,20182,1088,1198,2286
2015,Oaxaca,20,San Juan Bautista Tuxtepec,20184,79580,85922,165502
2015,Oaxaca,20,San Juan Bautista Valle Nacional,20559,11108,12114,23222
2015,Oaxaca,20,San Juan Cacahuatepec,20185,4377,4619,8996
2015,Oaxaca,20,San Juan Chicomezúchil,20191,153,185,338
2015,Oaxaca,20,San Juan Chilateca,20192,713,823,1536
2015,Oaxaca,20,San Juan Cieneguilla,20186,276,303,579
2015,Oaxaca,20,San Juan Coatzóspam,20187,1149,1127,2276
2015,Oaxaca,20,San Juan Colorado,20188,4851,5143,9994
2015,Oaxaca,20,San Juan Comaltepec,20189,1362,1433,2795
2015,Oaxaca,20,San Juan Cotzocón,20190,11692,12327,24019
2015,Oaxaca,20,San Juan Diuxi,20195,587,598,1185
2015,Oaxaca,20,San Juan Evangelista Analco,20196,205,221,426
2015,Oaxaca,20,San Juan Guelavía,20197,1598,1700,3298
2015,Oaxaca,20,San Juan Guichicovi,20198,14146,15901,30047
2015,Oaxaca,20,San Juan Ihualtepec,20199,305,356,661
2015,Oaxaca,20,San Juan Juquila Mixes,20200,1840,2052,3892
2015,Oaxaca,20,San Juan Juquila Vijanos,20201,947,1031,1978
2015,Oaxaca,20,San Juan Lachao,20202,2331,2473,4804
2015,Oaxaca,20,San Juan Lachigalla,20203,1653,1746,3399
2015,Oaxaca,20,San Juan Lajarcia,20204,304,369,673
2015,Oaxaca,20,San Juan Lalana,20205,8587,8982,17569
2015,Oaxaca,20,San Juan Mazatlán,20207,9280,9410,18690
2015,Oaxaca,20,San Juan Mixtepec Distrito 08,20208,3406,3930,7336
2015,Oaxaca,20,San Juan Mixtepec Distrito 26,20209,315,438,753
2015,Oaxaca,20,San Juan Ozolotepec,20211,1452,1436,2888
2015,Oaxaca,20,San Juan Petlapa,20212,1435,1530,2965
2015,Oaxaca,20,San Juan Quiahije,20213,1969,2233,4202
2015,Oaxaca,20,San Juan Quiotepec,20214,1092,1127,2219
2015,Oaxaca,20,San Juan Sayultepec,20215,372,430,802
2015,Oaxaca,20,San Juan Tabaá,20216,630,691,1321
2015,Oaxaca,20,San Juan Tamazola,20217,1546,1623,3169
2015,Oaxaca,20,San Juan Teita,20218,292,310,602
2015,Oaxaca,20,San Juan Teitipac,20219,1291,1418,2709
2015,Oaxaca,20,San Juan Tepeuxila,20220,1452,1369,2821
2015,Oaxaca,20,San Juan Teposcolula,20221,646,687,1333
2015,Oaxaca,20,San Juan Yaeé,20222,732,831,1563
2015,Oaxaca,20,San Juan Yatzona,20223,224,276,500
2015,Oaxaca,20,San Juan Yucuita,20224,293,348,641
2015,Oaxaca,20,San Juan de los Cués,20206,1250,1266,2516
2015,Oaxaca,20,San Juan del Estado,20193,1265,1378,2643
2015,Oaxaca,20,San Juan del Río,20194,586,712,1298
2015,Oaxaca,20,San Juan Ñumí,20210,2937,3331,6268
2015,Oaxaca,20,San Lorenzo,20225,2997,3225,6222
2015,Oaxaca,20,San Lorenzo Albarradas,20226,1411,1384,2795
2015,Oaxaca,20,San Lorenzo Cacaotepec,20227,7351,7998,15349
2015,Oaxaca,20,San Lorenzo Cuaunecuiltitla,20228,427,392,819
2015,Oaxaca,20,San Lorenzo Texmelúcan,20229,3715,4283,7998
2015,Oaxaca,20,San Lorenzo Victoria,20230,486,513,999
2015,Oaxaca,20,San Lucas Camotlán,20231,1519,1593,3112
2015,Oaxaca,20,San Lucas Ojitlán,20232,10266,10924,21190
2015,Oaxaca,20,San Lucas Quiaviní,20233,758,1053,1811
2015,Oaxaca,20,San Lucas Zoquiápam,20234,3706,3909,7615
2015,Oaxaca,20,San Luis Amatlán,20235,1713,2013,3726
2015,Oaxaca,20,San Marcial Ozolotepec,20236,745,816,1561
2015,Oaxaca,20,San Marcos Arteaga,20237,753,866,1619
2015,Oaxaca,20,San Martín Huamelúlpam,20239,489,586,1075
2015,Oaxaca,20,San Martín Itunyoso,20240,1092,1362,2454
2015,Oaxaca,20,San Martín Lachilá,20241,496,614,1110
2015,Oaxaca,20,San Martín Peras,20242,5970,6352,12322
2015,Oaxaca,20,San Martín Tilcajete,20243,835,1017,1852
2015,Oaxaca,20,San Martín Toxpalan,20244,1890,1989,3879
2015,Oaxaca,20,San Martín Zacatepec,20245,631,671,1302
2015,Oaxaca,20,San Martín de los Cansecos,20238,424,438,862
2015,Oaxaca,20,San Mateo Cajonos,20246,289,347,636
2015,Oaxaca,20,San Mateo Etlatongo,20250,566,606,1172
2015,Oaxaca,20,San Mateo Nejápam,20251,558,623,1181
2015,Oaxaca,20,San Mateo Peñasco,20252,984,1145,2129
2015,Oaxaca,20,San Mateo Piñas,20253,1125,1122,2247
2015,Oaxaca,20,San Mateo Río Hondo,20254,1579,1655,3234
2015,Oaxaca,20,San Mateo Sindihui,20255,991,1094,2085
2015,Oaxaca,20,San Mateo Tlapiltepec,20256,112,122,234
2015,Oaxaca,20,San Mateo Yoloxochitlán,20249,1751,1901,3652
2015,Oaxaca,20,San Mateo Yucutindoo,20566,1557,1601,3158
2015,Oaxaca,20,San Mateo del Mar,20248,7560,7338,14898
2015,Oaxaca,20,San Melchor Betaza,20257,488,563,1051
2015,Oaxaca,20,San Miguel Achiutla,20258,364,403,767
2015,Oaxaca,20,San Miguel Ahuehuetitlán,20259,1160,1274,2434
2015,Oaxaca,20,San Miguel Aloápam,20260,1128,1274,2402
2015,Oaxaca,20,San Miguel Amatitlán,20261,3531,3905,7436
2015,Oaxaca,20,San Miguel Amatlán,20262,506,533,1039
2015,Oaxaca,20,San Miguel Chicahua,20264,984,1211,2195
2015,Oaxaca,20,San Miguel Chimalapa,20265,3563,3407,6970
2015,Oaxaca,20,San Miguel Coatlán,20263,1565,1809,3374
2015,Oaxaca,20,San Miguel Ejutla,20268,457,535,992
2015,Oaxaca,20,San Miguel Huautla,20270,572,660,1232
2015,Oaxaca,20,San Miguel Mixtepec,20271,1576,1652,3228
2015,Oaxaca,20,San Miguel Panixtlahuaca,20272,3140,3709,6849
2015,Oaxaca,20,San Miguel Peras,20273,1641,1772,3413
2015,Oaxaca,20,San Miguel Piedras,20274,653,687,1340
2015,Oaxaca,20,San Miguel Quetzaltepec,20275,3955,3923,7878
2015,Oaxaca,20,San Miguel Santa Flor,20276,384,380,764
2015,Oaxaca,20,San Miguel Soyaltepec,20278,19279,20289,39568
2015,Oaxaca,20,San Miguel Suchixtepec,20279,1353,1477,2830
2015,Oaxaca,20,San Miguel Tecomatlán,20281,160,140,300
2015,Oaxaca,20,San Miguel Tenango,20282,387,375,762
2015,Oaxaca,20,San Miguel Tequixtepec,20283,515,534,1049
2015,Oaxaca,20,San Miguel Tilquiápam,20284,1480,1798,3278
2015,Oaxaca,20,San Miguel Tlacamama,20285,1782,1851,3633
2015,Oaxaca,20,San Miguel Tlacotepec,20286,1546,1790,3336
2015,Oaxaca,20,San Miguel Tulancingo,20287,129,198,327
2015,Oaxaca,20,San Miguel Yotao,20288,305,325,630
2015,Oaxaca,20,San Miguel del Puerto,20266,4236,4313,8549
2015,Oaxaca,20,San Miguel del Río,20267,137,138,275
2015,Oaxaca,20,San Miguel el Grande,20269,1938,2206,4144
2015,Oaxaca,20,San Nicolás,20289,526,639,1165
2015,Oaxaca,20,San Nicolás Hidalgo,20290,468,547,1015
2015,Oaxaca,20,San Pablo Coatlán,20291,2095,2205,4300
2015,Oaxaca,20,San Pablo Cuatro Venados,20292,661,759,1420
2015,Oaxaca,20,San Pablo Etla,20293,8295,9121,17416
2015,Oaxaca,20,San Pablo Huitzo,20294,3297,3699,6996
2015,Oaxaca,20,San Pablo Huixtepec,20295,4504,4986,9490
2015,Oaxaca,20,San Pablo Macuiltianguis,20296,454,488,942
2015,Oaxaca,20,San Pablo Tijaltepec,20297,1139,1351,2490
2015,Oaxaca,20,San Pablo Villa de Mitla,20298,6067,6652,12719
2015,Oaxaca,20,San Pablo Yaganiza,20299,524,588,1112
2015,Oaxaca,20,San Pedro Amuzgos,20300,3114,3538,6652
2015,Oaxaca,20,San Pedro Apóstol,20301,727,855,1582
2015,Oaxaca,20,San Pedro Atoyac,20302,2070,2315,4385
2015,Oaxaca,20,San Pedro Cajonos,20303,510,630,1140
2015,Oaxaca,20,San Pedro Comitancillo,20305,2044,2257,4301
2015,Oaxaca,20,San Pedro Coxcaltepec Cántaros,20304,392,424,816
2015,Oaxaca,20,San Pedro Huamelula,20307,5072,5079,10151
2015,Oaxaca,20,San Pedro Huilotepec,20308,1554,1580,3134
2015,Oaxaca,20,San Pedro Ixcatlán,20309,5701,5907,11608
2015,Oaxaca,20,San Pedro Ixtlahuaca,20310,3997,4260,8257
2015,Oaxaca,20,San Pedro Jaltepetongo,20311,250,289,539
2015,Oaxaca,20,San Pedro Jicayán,20312,5859,6321,12180
2015,Oaxaca,20,San Pedro Jocotipac,20313,380,449,829
2015,Oaxaca,20,San Pedro Juchatengo,20314,792,878,1670
2015,Oaxaca,20,San Pedro Mixtepec Distrito 22,20318,23130,24428,47558
2015,Oaxaca,20,San Pedro Mixtepec Distrito 26,20319,530,587,1117
2015,Oaxaca,20,San Pedro Molinos,20320,341,380,721
2015,Oaxaca,20,San Pedro Mártir,20315,786,997,1783
2015,Oaxaca,20,San Pedro Mártir Quiechapa,20316,346,392,738
2015,Oaxaca,20,San Pedro Mártir Yucuxaco,20317,624,722,1346
2015,Oaxaca,20,San Pedro Nopala,20321,370,415,785
2015,Oaxaca,20,San Pedro Ocopetatillo,20322,403,461,864
2015,Oaxaca,20,San Pedro Ocotepec,20323,1075,1110,2185
2015,Oaxaca,20,San Pedro Pochutla,20324,23252,23937,47189
2015,Oaxaca,20,San Pedro Quiatoni,20325,5333,5659,10992
2015,Oaxaca,20,San Pedro Sochiápam,20326,2540,2610,5150
2015,Oaxaca,20,San Pedro Tapanatepec,20327,7550,7694,15244
2015,Oaxaca,20,San Pedro Taviche,20328,602,620,1222
2015,Oaxaca,20,San Pedro Teozacoalco,20329,628,679,1307
2015,Oaxaca,20,San Pedro Teutila,20330,2168,2227,4395
2015,Oaxaca,20,San Pedro Tidaá,20331,409,469,878
2015,Oaxaca,20,San Pedro Topiltepec,20332,182,197,379
2015,Oaxaca,20,San Pedro Totolápam,20333,1295,1435,2730
2015,Oaxaca,20,San Pedro Yaneri,20335,476,500,976
2015,Oaxaca,20,San Pedro Yucunama,20341,106,141,247
2015,Oaxaca,20,San Pedro Yólox,20336,991,1044,2035
2015,Oaxaca,20,San Pedro el Alto,20306,1952,2031,3983
2015,Oaxaca,20,San Pedro y San Pablo Ayutla,20337,2456,2886,5342
2015,Oaxaca,20,San Pedro y San Pablo Teposcolula,20339,1974,2165,4139
2015,Oaxaca,20,San Pedro y San Pablo Tequixtepec,20340,801,996,1797
2015,Oaxaca,20,San Raymundo Jalpan,20342,1483,1787,3270
2015,Oaxaca,20,San Sebastián Abasolo,20343,926,1008,1934
2015,Oaxaca,20,San Sebastián Coatlán,20344,1323,1410,2733
2015,Oaxaca,20,San Sebastián Ixcapa,20345,1998,2067,4065
2015,Oaxaca,20,San Sebastián Nicananduta,20346,647,852,1499
2015,Oaxaca,20,San Sebastián Río Hondo,20347,1814,1862,3676
2015,Oaxaca,20,San Sebastián Tecomaxtlahuaca,20348,3966,4411,8377
2015,Oaxaca,20,San Sebastián Teitipac,20349,932,1111,2043
2015,Oaxaca,20,San Sebastián Tutla,20350,8998,10334,19332
2015,Oaxaca,20,San Simón Almolongas,20351,1262,1450,2712
2015,Oaxaca,20,San Simón Zahuatlán,20352,2017,2059,4076
2015,Oaxaca,20,San Vicente Coatlán,20534,1840,2206,4046
2015,Oaxaca,20,San Vicente Lachixío,20535,1460,1637,3097
2015,Oaxaca,20,San Vicente Nuñú,20536,212,251,463
2015,Oaxaca,20,Santa Ana,20353,1023,1128,2151
2015,Oaxaca,20,Santa Ana Ateixtlahuaca,20354,271,269,540
2015,Oaxaca,20,Santa Ana Cuauhtémoc,20355,369,398,767
2015,Oaxaca,20,Santa Ana Tavela,20357,427,450,877
2015,Oaxaca,20,Santa Ana Tlapacoyan,20358,917,1035,1952
2015,Oaxaca,20,Santa Ana Yareni,20359,431,515,946
2015,Oaxaca,20,Santa Ana Zegache,20360,1774,2014,3788
2015,Oaxaca,20,Santa Ana del Valle,20356,1023,1108,2131
2015,Oaxaca,20,Santa Catalina Quierí,20361,425,509,934
2015,Oaxaca,20,Santa Catarina Cuixtla,20362,658,821,1479
2015,Oaxaca,20,Santa Catarina Ixtepeji,20363,1303,1392,2695
2015,Oaxaca,20,Santa Catarina Juquila,20364,7753,8218,15971
2015,Oaxaca,20,Santa Catarina Lachatao,20365,574,610,1184
2015,Oaxaca,20,Santa Catarina Loxicha,20366,2012,2048,4060
2015,Oaxaca,20,Santa Catarina Mechoacán,20367,2304,2341,4645
2015,Oaxaca,20,Santa Catarina Minas,20368,953,992,1945
2015,Oaxaca,20,Santa Catarina Quiané,20369,927,1014,1941
2015,Oaxaca,20,Santa Catarina Quioquitani,20074,249,270,519
2015,Oaxaca,20,Santa Catarina Tayata,20370,312,368,680
2015,Oaxaca,20,Santa Catarina Ticuá,20371,462,578,1040
2015,Oaxaca,20,Santa Catarina Yosonotú,20372,800,969,1769
2015,Oaxaca,20,Santa Catarina Zapoquila,20373,192,214,406
2015,Oaxaca,20,Santa Cruz Acatepec,20374,742,803,1545
2015,Oaxaca,20,Santa Cruz Amilpas,20375,5731,6641,12372
2015,Oaxaca,20,Santa Cruz Itundujia,20377,5596,6035,11631
2015,Oaxaca,20,Santa Cruz Mixtepec,20378,1681,1859,3540
2015,Oaxaca,20,Santa Cruz Nundaco,20379,1373,1609,2982
2015,Oaxaca,20,Santa Cruz Papalutla,20380,1045,1109,2154
2015,Oaxaca,20,Santa Cruz Tacache de Mina,20381,1289,1435,2724
2015,Oaxaca,20,Santa Cruz Tacahua,20382,549,622,1171
2015,Oaxaca,20,Santa Cruz Tayata,20383,299,310,609
2015,Oaxaca,20,Santa Cruz Xitla,20384,2249,2506,4755
2015,Oaxaca,20,Santa Cruz Xoxocotlán,20385,42654,47854,90508
2015,Oaxaca,20,Santa Cruz Zenzontepec,20386,9097,9492,18589
2015,Oaxaca,20,Santa Cruz de Bravo,20376,180,193,373
2015,Oaxaca,20,Santa Gertrudis,20387,1416,1549,2965
2015,Oaxaca,20,Santa Inés Yatzeche,20389,415,561,976
2015,Oaxaca,20,Santa Inés de Zaragoza,20569,803,899,1702
2015,Oaxaca,20,Santa Inés del Monte,20388,1205,1259,2464
2015,Oaxaca,20,Santa Lucía Miahuatlán,20391,1681,1745,3426
2015,Oaxaca,20,Santa Lucía Monteverde,20392,3187,3478,6665
2015,Oaxaca,20,Santa Lucía Ocotlán,20393,1806,2111,3917
2015,Oaxaca,20,Santa Lucía del Camino,20390,24813,26567,51380
2015,Oaxaca,20,Santa Magdalena Jicotlán,20047,42,55,97
2015,Oaxaca,20,Santa María Alotepec,20394,1407,1447,2854
2015,Oaxaca,20,Santa María Apazco,20395,822,980,1802
2015,Oaxaca,20,Santa María Atzompa,20399,15979,17267,33246
2015,Oaxaca,20,Santa María Camotlán,20400,750,870,1620
2015,Oaxaca,20,Santa María Chachoápam,20404,361,417,778
2015,Oaxaca,20,Santa María Chilchotla,20406,10420,10736,21156
2015,Oaxaca,20,Santa María Chimalapa,20407,4646,4519,9165
2015,Oaxaca,20,Santa María Colotepec,20401,11891,12031,23922
2015,Oaxaca,20,Santa María Cortijo,20402,526,570,1096
2015,Oaxaca,20,Santa María Coyotepec,20403,1427,1578,3005
2015,Oaxaca,20,Santa María Ecatepec,20410,1754,1789,3543
2015,Oaxaca,20,Santa María Guelacé,20411,375,461,836
2015,Oaxaca,20,Santa María Guienagati,20412,1638,1638,3276
2015,Oaxaca,20,Santa María Huatulco,20413,21488,22490,43978
2015,Oaxaca,20,Santa María Huazolotitlán,20414,5645,5875,11520
2015,Oaxaca,20,Santa María Ipalapa,20415,2353,2637,4990
2015,Oaxaca,20,Santa María Ixcatlán,20416,250,282,532
2015,Oaxaca,20,Santa María Jacatepec,20417,4596,5077,9673
2015,Oaxaca,20,Santa María Jalapa del Marqués,20418,6294,6747,13041
2015,Oaxaca,20,Santa María Jaltianguis,20419,252,301,553
2015,Oaxaca,20,Santa María Lachixío,20420,848,986,1834
2015,Oaxaca,20,Santa María Mixtequilla,20421,2296,2419,4715
2015,Oaxaca,20,Santa María Nativitas,20422,289,345,634
2015,Oaxaca,20,Santa María Nduayaco,20423,264,264,528
2015,Oaxaca,20,Santa María Ozolotepec,20424,1967,2082,4049
2015,Oaxaca,20,Santa María Petapa,20427,7988,8543,16531
2015,Oaxaca,20,Santa María Peñoles,20426,4136,4347,8483
2015,Oaxaca,20,Santa María Pápalo,20425,1110,1103,2213
2015,Oaxaca,20,Santa María Quiegolani,20428,946,936,1882
2015,Oaxaca,20,Santa María Sola,20429,741,795,1536
2015,Oaxaca,20,Santa María Tataltepec,20430,166,179,345
2015,Oaxaca,20,Santa María Tecomavaca,20431,855,918,1773
2015,Oaxaca,20,Santa María Temaxcalapa,20432,466,501,967
2015,Oaxaca,20,Santa María Temaxcaltepec,20433,1276,1401,2677
2015,Oaxaca,20,Santa María Teopoxco,20434,2138,2372,4510
2015,Oaxaca,20,Santa María Tepantlali,20435,1793,1866,3659
2015,Oaxaca,20,Santa María Texcatitlán,20436,502,545,1047
2015,Oaxaca,20,Santa María Tlahuitoltepec,20437,4637,4898,9535
2015,Oaxaca,20,Santa María Tlalixtac,20438,844,891,1735
2015,Oaxaca,20,Santa María Tonameca,20439,12479,12790,25269
2015,Oaxaca,20,Santa María Totolapilla,20440,422,472,894
2015,Oaxaca,20,Santa María Xadani,20441,4318,4272,8590
2015,Oaxaca,20,Santa María Yalina,20442,142,164,306
2015,Oaxaca,20,Santa María Yavesía,20443,217,261,478
2015,Oaxaca,20,Santa María Yolotepec,20444,210,230,440
2015,Oaxaca,20,Santa María Yosoyúa,20445,817,822,1639
2015,Oaxaca,20,Santa María Yucuhiti,20446,3127,3381,6508
2015,Oaxaca,20,Santa María Zacatepec,20447,7530,8524,16054
2015,Oaxaca,20,Santa María Zaniza,20448,1062,1127,2189
2015,Oaxaca,20,Santa María Zoquitlán,20449,1556,1628,3184
2015,Oaxaca,20,Santa María del Rosario,20408,254,241,495
2015,Oaxaca,20,Santa María del Tule,20409,4244,4875,9119
2015,Oaxaca,20,Santa María la Asunción,20396,1495,1861,3356
2015,Oaxaca,20,Santiago Amoltepec,20450,6139,6510,12649
2015,Oaxaca,20,Santiago Apoala,20451,444,505,949
2015,Oaxaca,20,Santiago Apóstol,20452,1869,2308,4177
2015,Oaxaca,20,Santiago Astata,20453,1967,1996,3963
2015,Oaxaca,20,Santiago Atitlán,20454,1606,1545,3151
2015,Oaxaca,20,Santiago Ayuquililla,20455,1281,1432,2713
2015,Oaxaca,20,Santiago Cacaloxtepec,20456,785,854,1639
2015,Oaxaca,20,Santiago Camotlán,20457,1629,1652,3281
2015,Oaxaca,20,Santiago Chazumba,20459,2050,2519,4569
2015,Oaxaca,20,Santiago Choápam,20460,2553,2742,5295
2015,Oaxaca,20,Santiago Comaltepec,20458,517,584,1101
2015,Oaxaca,20,Santiago Huajolotitlán,20462,1946,2345,4291
2015,Oaxaca,20,Santiago Huauclilla,20463,285,311,596
2015,Oaxaca,20,Santiago Ihuitlán Plumas,20464,187,224,411
2015,Oaxaca,20,Santiago Ixcuintepec,20465,800,820,1620
2015,Oaxaca,20,Santiago Ixtayutla,20466,6272,6605,12877
2015,Oaxaca,20,Santiago Jamiltepec,20467,9331,10044,19375
2015,Oaxaca,20,Santiago Jocotepec,20468,6930,7188,14118
2015,Oaxaca,20,Santiago Juxtlahuaca,20469,17076,18926,36002
2015,Oaxaca,20,Santiago Lachiguiri,20470,2483,2531,5014
2015,Oaxaca,20,Santiago Lalopa,20471,240,263,503
2015,Oaxaca,20,Santiago Laollaga,20472,1664,1691,3355
2015,Oaxaca,20,Santiago Laxopa,20473,643,719,1362
2015,Oaxaca,20,Santiago Llano Grande,20474,1656,1698,3354
2015,Oaxaca,20,Santiago Matatlán,20475,4707,5325,10032
2015,Oaxaca,20,Santiago Miltepec,20476,198,208,406
2015,Oaxaca,20,Santiago Minas,20477,736,752,1488
2015,Oaxaca,20,Santiago Nacaltepec,20478,908,997,1905
2015,Oaxaca,20,Santiago Nejapilla,20479,110,103,213
2015,Oaxaca,20,Santiago Niltepec,20066,2742,2772,5514
2015,Oaxaca,20,Santiago Nundiche,20480,451,487,938
2015,Oaxaca,20,Santiago Nuyoó,20481,943,1036,1979
2015,Oaxaca,20,Santiago Pinotepa Nacional,20482,25929,27198,53127
2015,Oaxaca,20,Santiago Suchilquitongo,20483,5002,5389,10391
2015,Oaxaca,20,Santiago Tamazola,20484,2083,2429,4512
2015,Oaxaca,20,Santiago Tapextla,20485,1602,1560,3162
2015,Oaxaca,20,Santiago Tenango,20487,1021,1012,2033
2015,Oaxaca,20,Santiago Tepetlapa,20488,61,64,125
2015,Oaxaca,20,Santiago Tetepec,20489,2510,2577,5087
2015,Oaxaca,20,Santiago Texcalcingo,20490,1515,1622,3137
2015,Oaxaca,20,Santiago Textitlán,20491,2180,2209,4389
2015,Oaxaca,20,Santiago Tilantongo,20492,1469,1701,3170
2015,Oaxaca,20,Santiago Tillo,20493,259,291,550
2015,Oaxaca,20,Santiago Tlazoyaltepec,20494,2184,2630,4814
2015,Oaxaca,20,Santiago Xanica,20495,1532,1545,3077
2015,Oaxaca,20,Santiago Xiacuí,20496,997,1103,2100
2015,Oaxaca,20,Santiago Yaitepec,20497,1998,2307,4305
2015,Oaxaca,20,Santiago Yaveo,20498,3423,3411,6834
2015,Oaxaca,20,Santiago Yolomécatl,20499,976,1165,2141
2015,Oaxaca,20,Santiago Yosondúa,20500,3931,4396,8327
2015,Oaxaca,20,Santiago Yucuyachi,20501,438,497,935
2015,Oaxaca,20,Santiago Zacatepec,20502,2670,2723,5393
2015,Oaxaca,20,Santiago Zoochila,20503,194,224,418
2015,Oaxaca,20,Santiago del Río,20461,272,291,563
2015,Oaxaca,20,Santo Domingo Albarradas,20506,370,422,792
2015,Oaxaca,20,Santo Domingo Armenta,20507,1711,1724,3435
2015,Oaxaca,20,Santo Domingo Chihuitán,20508,776,787,1563
2015,Oaxaca,20,Santo Domingo Ingenio,20505,4066,4063,8129
2015,Oaxaca,20,Santo Domingo Ixcatlán,20510,385,448,833
2015,Oaxaca,20,Santo Domingo Nuxaá,20511,1646,1749,3395
2015,Oaxaca,20,Santo Domingo Ozolotepec,20512,438,483,921
2015,Oaxaca,20,Santo Domingo Petapa,20513,4525,4497,9022
2015,Oaxaca,20,Santo Domingo Roayaga,20514,490,536,1026
2015,Oaxaca,20,Santo Domingo Tehuantepec,20515,32019,33708,65727
2015,Oaxaca,20,Santo Domingo Teojomulco,20516,2379,2562,4941
2015,Oaxaca,20,Santo Domingo Tepuxtepec,20517,2569,2888,5457
2015,Oaxaca,20,Santo Domingo Tlatayápam,20518,67,79,146
2015,Oaxaca,20,Santo Domingo Tomaltepec,20519,1464,1514,2978
2015,Oaxaca,20,Santo Domingo Tonaltepec,20521,113,150,263
2015,Oaxaca,20,Santo Domingo Tonalá,20520,3418,3779,7197
2015,Oaxaca,20,Santo Domingo Xagacía,20522,546,629,1175
2015,Oaxaca,20,Santo Domingo Yanhuitlán,20523,752,848,1600
2015,Oaxaca,20,Santo Domingo Yodohino,20524,170,192,362
2015,Oaxaca,20,Santo Domingo Zanatepec,20525,6099,6120,12219
2015,Oaxaca,20,Santo Domingo de Morelos,20509,5265,5824,11089
2015,Oaxaca,20,Santo Tomás Jalieza,20530,1703,1876,3579
2015,Oaxaca,20,Santo Tomás Mazaltepec,20531,1210,1335,2545
2015,Oaxaca,20,Santo Tomás Ocotepec,20532,1842,2100,3942
2015,Oaxaca,20,Santo Tomás Tamazulapan,20533,1073,1148,2221
2015,Oaxaca,20,Santos Reyes Nopala,20526,8449,8904,17353
2015,Oaxaca,20,Santos Reyes Pápalo,20527,1332,1418,2750
2015,Oaxaca,20,Santos Reyes Tepejillo,20528,468,637,1105
2015,Oaxaca,20,Santos Reyes Yucuná,20529,683,698,1381
2015,Oaxaca,20,Silacayoápam,20537,3135,3620,6755
2015,Oaxaca,20,Sitio de Xitlapehua,20538,335,372,707
2015,Oaxaca,20,Soledad Etla,20539,2686,2822,5508
2015,Oaxaca,20,Tamazulápam del Espíritu Santo,20031,3426,4030,7456
2015,Oaxaca,20,Tanetze de Zaragoza,20541,827,892,1719
2015,Oaxaca,20,Taniche,20542,364,456,820
2015,Oaxaca,20,Tataltepec de Valdés,20543,2884,3000,5884
2015,Oaxaca,20,Teococuilco de Marcos Pérez,20544,521,590,1111
2015,Oaxaca,20,Teotitlán de Flores Magón,20545,4707,5163,9870
2015,Oaxaca,20,Teotitlán del Valle,20546,2865,3162,6027
2015,Oaxaca,20,Teotongo,20547,443,530,973
2015,Oaxaca,20,Tepelmeme Villa de Morelos,20548,763,909,1672
2015,Oaxaca,20,Tlacolula de Matamoros,20551,10279,11662,21941
2015,Oaxaca,20,Tlacotepec Plumas,20552,226,251,477
2015,Oaxaca,20,Tlalixtac de Cabrera,20553,4864,5378,10242
2015,Oaxaca,20,Totontepec Villa de Morelos,20554,2644,2875,5519
2015,Oaxaca,20,Trinidad Zaachila,20555,1435,1598,3033
2015,Oaxaca,20,Unión Hidalgo,20557,7412,7913,15325
2015,Oaxaca,20,Valerio Trujano,20558,675,815,1490
2015,Oaxaca,20,Villa Díaz Ordaz,20560,3063,3633,6696
2015,Oaxaca,20,Villa Hidalgo,20038,975,1080,2055
2015,Oaxaca,20,Villa Sola de Vega,20277,6276,6470,12746
2015,Oaxaca,20,Villa Talea de Castro,20280,1141,1253,2394
2015,Oaxaca,20,Villa Tejúpam de la Unión,20486,1205,1291,2496
2015,Oaxaca,20,Villa Tezoatlán de Segura y Luna,20549,5261,6248,11509
2015,Oaxaca,20,Villa de Chilapa de Díaz,20405,904,1173,2077
2015,Oaxaca,20,Villa de Etla,20338,5084,5523,10607
2015,Oaxaca,20,Villa de Tamazulápam del Progreso,20540,3606,4092,7698
2015,Oaxaca,20,Villa de Tututepec de Melchor Ocampo,20334,22702,23750,46452
2015,Oaxaca,20,Villa de Zaachila,20565,19888,21885,41773
2015,Oaxaca,20,Yaxe,20561,1353,1464,2817
2015,Oaxaca,20,Yogana,20563,591,706,1297
2015,Oaxaca,20,Yutanduchi de Guerrero,20564,579,644,1223
2015,Oaxaca,20,Zapotitlán Lagunas,20567,1522,1731,3253
2015,Oaxaca,20,Zapotitlán Palmas,20568,676,822,1498
2015,Oaxaca,20,Zimatlán de Álvarez,20570,9511,10814,20325
2015,Oaxaca,20,Ánimas Trujano,20174,1889,2087,3976
2015,Puebla,21,Acajete,21001,31364,33511,64875
2015,Puebla,21,Acateno,21002,4725,4686,9411
2015,Puebla,21,Acatlán,21003,16882,19773,36655
2015,Puebla,21,Acatzingo,21004,28361,29525,57886
2015,Puebla,21,Acteopan,21005,1452,1652,3104
2015,Puebla,21,Ahuacatlán,21006,7586,8271,15857
2015,Puebla,21,Ahuatlán,21007,1666,1787,3453
2015,Puebla,21,Ahuazotepec,21008,5585,5789,11374
2015,Puebla,21,Ahuehuetitla,21009,918,1069,1987
2015,Puebla,21,Ajalpan,21010,31972,33819,65791
2015,Puebla,21,Albino Zertuche,21011,863,1016,1879
2015,Puebla,21,Aljojuca,21012,3176,3555,6731
2015,Puebla,21,Altepexi,21013,10255,10816,21071
2015,Puebla,21,Amixtlán,21014,2456,2697,5153
2015,Puebla,21,Amozoc,21015,55433,57972,113405
2015,Puebla,21,Aquixtla,21016,4354,4369,8723
2015,Puebla,21,Atempan,21017,13343,14669,28012
2015,Puebla,21,Atexcal,21018,1877,2021,3898
2015,Puebla,21,Atlequizayan,21080,1354,1504,2858
2015,Puebla,21,Atlixco,21019,64807,72904,137711
2015,Puebla,21,Atoyatempan,21020,3414,3672,7086
2015,Puebla,21,Atzala,21021,644,706,1350
2015,Puebla,21,Atzitzihuacán,21022,5785,6696,12481
2015,Puebla,21,Atzitzintla,21023,4568,4724,9292
2015,Puebla,21,Axutla,21024,450,523,973
2015,Puebla,21,Ayotoxco de Guerrero,21025,4326,4459,8785
2015,Puebla,21,Calpan,21026,7036,7792,14828
2015,Puebla,21,Caltepec,21027,1991,2278,4269
2015,Puebla,21,Camocuautla,21028,1308,1331,2639
2015,Puebla,21,Caxhuacan,21029,1893,2023,3916
2015,Puebla,21,Cañada Morelos,21099,9595,10242,19837
2015,Puebla,21,Chalchicomula de Sesma,21045,22798,24708,47506
2015,Puebla,21,Chapulco,21046,3696,3976,7672
2015,Puebla,21,Chiautla,21047,9960,10678,20638
2015,Puebla,21,Chiautzingo,21048,9732,10725,20457
2015,Puebla,21,Chichiquila,21050,12747,13338,26085
2015,Puebla,21,Chiconcuautla,21049,8128,8433,16561
2015,Puebla,21,Chietla,21051,17222,18622,35844
2015,Puebla,21,Chigmecatitlán,21052,570,675,1245
2015,Puebla,21,Chignahuapan,21053,30616,31785,62401
2015,Puebla,21,Chignautla,21054,16294,17177,33471
2015,Puebla,21,Chila,21055,2244,2562,4806
2015,Puebla,21,Chila de la Sal,21056,698,755,1453
2015,Puebla,21,Chilchotla,21058,10214,10117,20331
2015,Puebla,21,Chinantla,21059,1131,1294,2425
2015,Puebla,21,Coatepec,21030,375,414,789
2015,Puebla,21,Coatzingo,21031,1490,1647,3137
2015,Puebla,21,Cohetzala,21032,709,709,1418
2015,Puebla,21,Cohuecan,21033,2403,2631,5034
2015,Puebla,21,Coronango,21034,19363,20264,39627
2015,Puebla,21,Coxcatlán,21035,10153,11039,21192
2015,Puebla,21,Coyomeapan,21036,6931,7497,14428
2015,Puebla,21,Coyotepec,21037,1113,1291,2404
2015,Puebla,21,Cuapiaxtla de Madero,21038,4828,4928,9756
2015,Puebla,21,Cuautempan,21039,4646,4972,9618
2015,Puebla,21,Cuautinchán,21040,5019,5115,10134
2015,Puebla,21,Cuautlancingo,21041,52800,56267,109067
2015,Puebla,21,Cuayuca de Andrade,21042,1582,1722,3304
2015,Puebla,21,Cuetzalan del Progreso,21043,24530,25480,50010
2015,Puebla,21,Cuyoaco,21044,7802,8367,16169
2015,Puebla,21,Domingo Arenas,21060,3500,3868,7368
2015,Puebla,21,Eloxochitlán,21061,6370,6569,12939
2015,Puebla,21,Epatlán,21062,2393,2545,4938
2015,Puebla,21,Esperanza,21063,7318,7839,15157
2015,Puebla,21,Francisco Z. Mena,21064,8704,8638,17342
2015,Puebla,21,General Felipe Ángeles,21065,9858,10729,20587
2015,Puebla,21,Guadalupe,21066,2899,3381,6280
2015,Puebla,21,Guadalupe Victoria,21067,8417,8905,17322
2015,Puebla,21,Hermenegildo Galeana,21068,3995,4009,8004
2015,Puebla,21,Honey,21057,3770,4163,7933
2015,Puebla,21,Huaquechula,21069,12234,14046,26280
2015,Puebla,21,Huatlatlauca,21070,3060,3693,6753
2015,Puebla,21,Huauchinango,21071,50184,55248,105432
2015,Puebla,21,Huehuetla,21072,9136,9318,18454
2015,Puebla,21,Huehuetlán el Chico,21073,4322,4614,8936
2015,Puebla,21,Huehuetlán el Grande,21150,3561,3799,7360
2015,Puebla,21,Huejotzingo,21074,35347,37250,72597
2015,Puebla,21,Hueyapan,21075,6313,6632,12945
2015,Puebla,21,Hueytamalco,21076,13671,13874,27545
2015,Puebla,21,Hueytlalpan,21077,2750,2866,5616
2015,Puebla,21,Huitzilan de Serdán,21078,7577,7414,14991
2015,Puebla,21,Huitziltepec,21079,2673,2891,5564
2015,Puebla,21,Ixcamilpa de Guerrero,21081,1802,2010,3812
2015,Puebla,21,Ixcaquixtla,21082,4223,4617,8840
2015,Puebla,21,Ixtacamaxtitlán,21083,12797,13082,25879
2015,Puebla,21,Ixtepec,21084,3548,3742,7290
2015,Puebla,21,Izúcar de Matamoros,21085,37367,41748,79115
2015,Puebla,21,Jalpan,21086,6197,6592,12789
2015,Puebla,21,Jolalpan,21087,6397,7037,13434
2015,Puebla,21,Jonotla,21088,2360,2443,4803
2015,Puebla,21,Jopala,21089,6596,6900,13496
2015,Puebla,21,Juan C. Bonilla,21090,9842,10761,20603
2015,Puebla,21,Juan Galindo,21091,5158,5873,11031
2015,Puebla,21,Juan N. Méndez,21092,2674,2757,5431
2015,Puebla,21,La Magdalena Tlatlauquitepec,21095,289,288,577
2015,Puebla,21,Lafragua,21093,3993,4079,8072
2015,Puebla,21,Libres,21094,16530,17426,33956
2015,Puebla,21,Los Reyes de Juárez,21118,13555,14148,27703
2015,Puebla,21,Mazapiltepec de Juárez,21096,1410,1447,2857
2015,Puebla,21,Mixtla,21097,1135,1268,2403
2015,Puebla,21,Molcaxac,21098,3061,3486,6547
2015,Puebla,21,Naupan,21100,4922,5377,10299
2015,Puebla,21,Nauzontla,21101,1693,1893,3586
2015,Puebla,21,Nealtican,21102,6035,6559,12594
2015,Puebla,21,Nicolás Bravo,21103,3092,3284,6376
2015,Puebla,21,Nopalucan,21104,14951,15417,30368
2015,Puebla,21,Ocotepec,21105,2378,2587,4965
2015,Puebla,21,Ocoyucan,21106,13171,15029,28200
2015,Puebla,21,Olintla,21107,5992,6253,12245
2015,Puebla,21,Oriental,21108,8780,9284,18064
2015,Puebla,21,Pahuatlán,21109,10453,11577,22030
2015,Puebla,21,Palmar de Bravo,21110,22804,23508,46312
2015,Puebla,21,Pantepec,21111,9332,9886,19218
2015,Puebla,21,Petlalcingo,21112,4618,5329,9947
2015,Puebla,21,Piaxtla,21113,2210,2397,4607
2015,Puebla,21,Puebla,21114,783508,850730,1634238
2015,Puebla,21,Quecholac,21115,24936,26030,50966
2015,Puebla,21,Quimixtlán,21116,11115,11306,22421
2015,Puebla,21,Rafael Lara Grajales,21117,7028,7605,14633
2015,Puebla,21,San Andrés Cholula,21119,65597,67616,133213
2015,Puebla,21,San Antonio Cañada,21120,2613,2943,5556
2015,Puebla,21,San Diego la Mesa Tochimiltzingo,21121,614,632,1246
2015,Puebla,21,San Felipe Teotlalcingo,21122,5021,5363,10384
2015,Puebla,21,San Felipe Tepatlán,21123,2054,2115,4169
2015,Puebla,21,San Gabriel Chilac,21124,7576,8326,15902
2015,Puebla,21,San Gregorio Atzompa,21125,4321,4626,8947
2015,Puebla,21,San Jerónimo Tecuanipan,21126,2985,3298,6283
2015,Puebla,21,San Jerónimo Xayacatlán,21127,1763,2032,3795
2015,Puebla,21,San José Chiapa,21128,4329,4442,8771
2015,Puebla,21,San José Miahuatlán,21129,6447,7096,13543
2015,Puebla,21,San Juan Atenco,21130,1646,1896,3542
2015,Puebla,21,San Juan Atzompa,21131,462,442,904
2015,Puebla,21,San Martín Texmelucan,21132,74322,79715,154037
2015,Puebla,21,San Martín Totoltepec,21133,349,379,728
2015,Puebla,21,San Matías Tlalancaleca,21134,10063,10461,20524
2015,Puebla,21,San Miguel Ixitlán,21135,259,296,555
2015,Puebla,21,San Miguel Xoxtla,21136,6109,6436,12545
2015,Puebla,21,San Nicolás Buenos Aires,21137,4883,5089,9972
2015,Puebla,21,San Nicolás de los Ranchos,21138,5698,6029,11727
2015,Puebla,21,San Pablo Anicano,21139,1751,1939,3690
2015,Puebla,21,San Pedro Cholula,21140,63311,68532,131843
2015,Puebla,21,San Pedro Yeloixtlahuaca,21141,1673,1828,3501
2015,Puebla,21,San Salvador Huixcolotla,21144,7328,7522,14850
2015,Puebla,21,San Salvador el Seco,21142,14784,15530,30314
2015,Puebla,21,San Salvador el Verde,21143,15185,15798,30983
2015,Puebla,21,San Sebastián Tlacotepec,21145,7118,7234,14352
2015,Puebla,21,Santa Catarina Tlaltempan,21146,427,424,851
2015,Puebla,21,Santa Inés Ahuatempan,21147,3083,3358,6441
2015,Puebla,21,Santa Isabel Cholula,21148,4458,4865,9323
2015,Puebla,21,Santiago Miahuatlán,21149,11948,12648,24596
2015,Puebla,21,Santo Tomás Hueyotlipan,21151,4150,4513,8663
2015,Puebla,21,Soltepec,21152,6086,6408,12494
2015,Puebla,21,Tecali de Herrera,21153,10722,11343,22065
2015,Puebla,21,Tecamachalco,21154,37479,39942,77421
2015,Puebla,21,Tecomatlán,21155,2957,3065,6022
2015,Puebla,21,Tehuacán,21156,149822,166226,316048
2015,Puebla,21,Tehuitzingo,21157,5506,6138,11644
2015,Puebla,21,Tenampulco,21158,3574,3685,7259
2015,Puebla,21,Teopantlán,21159,1808,2255,4063
2015,Puebla,21,Teotlalco,21160,1604,1681,3285
2015,Puebla,21,Tepanco de López,21161,9769,10852,20621
2015,Puebla,21,Tepango de Rodríguez,21162,2034,2243,4277
2015,Puebla,21,Tepatlaxco de Hidalgo,21163,8503,9052,17555
2015,Puebla,21,Tepeaca,21164,38744,42023,80767
2015,Puebla,21,Tepemaxalco,21165,573,613,1186
2015,Puebla,21,Tepeojuma,21166,3959,4672,8631
2015,Puebla,21,Tepetzintla,21167,5488,5906,11394
2015,Puebla,21,Tepexco,21168,3375,3626,7001
2015,Puebla,21,Tepexi de Rodríguez,21169,10749,10716,21465
2015,Puebla,21,Tepeyahualco,21170,8627,8782,17409
2015,Puebla,21,Tepeyahualco de Cuauhtémoc,21171,1707,1885,3592
2015,Puebla,21,Tetela de Ocampo,21172,13650,14654,28304
2015,Puebla,21,Teteles de Ávila Castillo,21173,2828,3323,6151
2015,Puebla,21,Teziutlán,21174,47561,52782,100343
2015,Puebla,21,Tianguismanalco,21175,5902,6467,12369
2015,Puebla,21,Tilapa,21176,4274,4617,8891
2015,Puebla,21,Tlachichuca,21179,14607,15183,29790
2015,Puebla,21,Tlacotepec de Benito Juárez,21177,25123,27330,52453
2015,Puebla,21,Tlacuilotepec,21178,8646,8875,17521
2015,Puebla,21,Tlahuapan,21180,19981,20250,40231
2015,Puebla,21,Tlaltenango,21181,3468,3539,7007
2015,Puebla,21,Tlanepantla,21182,2460,2659,5119
2015,Puebla,21,Tlaola,21183,10093,10605,20698
2015,Puebla,21,Tlapacoya,21184,3273,3413,6686
2015,Puebla,21,Tlapanalá,21185,4120,4659,8779
2015,Puebla,21,Tlatlauquitepec,21186,26129,28497,54626
2015,Puebla,21,Tlaxco,21187,2801,2829,5630
2015,Puebla,21,Tochimilco,21188,8509,9571,18080
2015,Puebla,21,Tochtepec,21189,10278,11124,21402
2015,Puebla,21,Totoltepec de Guerrero,21190,561,668,1229
2015,Puebla,21,Tulcingo,21191,4629,5312,9941
2015,Puebla,21,Tuzamapan de Galeana,21192,3173,3333,6506
2015,Puebla,21,Tzicatlacoyan,21193,3457,3557,7014
2015,Puebla,21,Venustiano Carranza,21194,14325,15482,29807
2015,Puebla,21,Vicente Guerrero,21195,11968,12940,24908
2015,Puebla,21,Xayacatlán de Bravo,21196,734,885,1619
2015,Puebla,21,Xicotepec,21197,39778,42585,82363
2015,Puebla,21,Xicotlán,21198,599,665,1264
2015,Puebla,21,Xiutetelco,21199,19579,20840,40419
2015,Puebla,21,Xochiapulco,21200,1800,1953,3753
2015,Puebla,21,Xochiltepec,21201,1540,1844,3384
2015,Puebla,21,Xochitlán Todos Santos,21203,3033,3393,6426
2015,Puebla,21,Xochitlán de Vicente Suárez,21202,6350,6676,13026
2015,Puebla,21,Yaonáhuac,21204,3903,4202,8105
2015,Puebla,21,Yehualtepec,21205,12140,12856,24996
2015,Puebla,21,Zacapala,21206,2109,2383,4492
2015,Puebla,21,Zacapoaxtla,21207,27148,29533,56681
2015,Puebla,21,Zacatlán,21208,39574,43447,83021
2015,Puebla,21,Zapotitlán,21209,3992,4734,8726
2015,Puebla,21,Zapotitlán de Méndez,21210,2853,2909,5762
2015,Puebla,21,Zaragoza,21211,7715,8863,16578
2015,Puebla,21,Zautla,21212,9408,10529,19937
2015,Puebla,21,Zihuateutla,21213,6655,6974,13629
2015,Puebla,21,Zinacatepec,21214,8123,8977,17100
2015,Puebla,21,Zongozotla,21215,2477,2548,5025
2015,Puebla,21,Zoquiapan,21216,1245,1395,2640
2015,Puebla,21,Zoquitlán,21217,9605,10175,19780
2015,Querétaro,22,Amealco de Bonfil,22001,31576,33374,64950
2015,Querétaro,22,Arroyo Seco,22003,6701,7286,13987
2015,Querétaro,22,Cadereyta de Montes,22004,33867,36924,70791
2015,Querétaro,22,Colón,22005,32226,31727,63953
2015,Querétaro,22,Corregidora,22006,85213,90789,176002
2015,Querétaro,22,El Marqués,22011,75958,75426,151384
2015,Querétaro,22,Ezequiel Montes,22007,20263,21762,42025
2015,Querétaro,22,Huimilpan,22008,18953,20261,39214
2015,Querétaro,22,Jalpan de Serra,22009,13215,14376,27591
2015,Querétaro,22,Landa de Matamoros,22010,9586,10355,19941
2015,Querétaro,22,Pedro Escobedo,22012,34883,35384,70267
2015,Querétaro,22,Peñamiller,22013,10077,10392,20469
2015,Querétaro,22,Pinal de Amoles,22002,13334,14197,27531
2015,Querétaro,22,Querétaro,22014,444825,453494,898319
2015,Querétaro,22,San Joaquín,22015,4495,5125,9620
2015,Querétaro,22,San Juan del Río,22016,134004,138873,272877
2015,Querétaro,22,Tequisquiapan,22017,35129,36453,71582
2015,Querétaro,22,Tolimán,22018,14220,14833,29053
2015,Quintana Roo,23,Bacalar,23010,19533,19674,39207
2015,Quintana Roo,23,Benito Juárez,23005,374278,369817,744095
2015,Quintana Roo,23,Cozumel,23001,44895,44500,89395
2015,Quintana Roo,23,Felipe Carrillo Puerto,23002,41817,41330,83147
2015,Quintana Roo,23,Isla Mujeres,23003,9943,9272,19215
2015,Quintana Roo,23,José María Morelos,23006,19977,19089,39066
2015,Quintana Roo,23,Lázaro Cárdenas,23007,14317,13725,28042
2015,Quintana Roo,23,Othón P. Blanco,23004,121814,125792,247606
2015,Quintana Roo,23,Solidaridad,23008,105622,97201,202823
2015,Quintana Roo,23,Tulum,23009,16833,15444,32277
2015,San Luis Potosí,24,Ahualulco,24001,8932,10013,18945
2015,San Luis Potosí,24,Alaquines,24002,4209,4317,8526
2015,San Luis Potosí,24,Aquismón,24003,25114,24465,49579
2015,San Luis Potosí,24,Armadillo de los Infante,24004,2162,2233,4395
2015,San Luis Potosí,24,Axtla de Terrazas,24053,18503,18728,37231
2015,San Luis Potosí,24,Catorce,24006,5075,4898,9973
2015,San Luis Potosí,24,Cedral,24007,9524,9861,19385
2015,San Luis Potosí,24,Cerritos,24008,10705,11437,22142
2015,San Luis Potosí,24,Cerro de San Pedro,24009,2249,2230,4479
2015,San Luis Potosí,24,Charcas,24015,10678,11045,21723
2015,San Luis Potosí,24,Ciudad Fernández,24011,22476,23697,46173
2015,San Luis Potosí,24,Ciudad Valles,24013,87330,92901,180231
2015,San Luis Potosí,24,Ciudad del Maíz,24010,16487,16672,33159
2015,San Luis Potosí,24,Coxcatlán,24014,8397,8266,16663
2015,San Luis Potosí,24,Cárdenas,24005,9276,10105,19381
2015,San Luis Potosí,24,Ebano,24016,21666,22470,44136
2015,San Luis Potosí,24,El Naranjo,24058,11073,10938,22011
2015,San Luis Potosí,24,Guadalcázar,24017,13670,13408,27078
2015,San Luis Potosí,24,Huehuetlán,24018,8027,8215,16242
2015,San Luis Potosí,24,Lagunillas,24019,2836,2964,5800
2015,San Luis Potosí,24,Matehuala,24020,48030,50860,98890
2015,San Luis Potosí,24,Matlapa,24057,15932,15842,31774
2015,San Luis Potosí,24,Mexquitic de Carmona,24021,27255,29757,57012
2015,San Luis Potosí,24,Moctezuma,24022,9627,10427,20054
2015,San Luis Potosí,24,Rayón,24023,7741,8176,15917
2015,San Luis Potosí,24,Rioverde,24024,46666,49768,96434
2015,San Luis Potosí,24,Salinas,24025,15311,16544,31855
2015,San Luis Potosí,24,San Antonio,24026,4986,4750,9736
2015,San Luis Potosí,24,San Ciro de Acosta,24027,5101,5513,10614
2015,San Luis Potosí,24,San Luis Potosí,24028,405161,433528,838689
2015,San Luis Potosí,24,San Martín Chalchicuautla,24029,11088,11091,22179
2015,San Luis Potosí,24,San Nicolás Tolentino,24030,2614,2911,5525
2015,San Luis Potosí,24,San Vicente Tancuayalab,24034,7633,7602,15235
2015,San Luis Potosí,24,Santa Catarina,24031,5882,6158,12040
2015,San Luis Potosí,24,Santa María del Río,24032,19647,21524,41171
2015,San Luis Potosí,24,Santo Domingo,24033,6230,6299,12529
2015,San Luis Potosí,24,Soledad de Graciano Sánchez,24035,146099,153875,299974
2015,San Luis Potosí,24,Tamasopo,24036,15423,15170,30593
2015,San Luis Potosí,24,Tamazunchale,24037,48440,49018,97458
2015,San Luis Potosí,24,Tampacán,24038,8209,8008,16217
2015,San Luis Potosí,24,Tampamolón Corona,24039,7768,7821,15589
2015,San Luis Potosí,24,Tamuín,24040,19598,20047,39645
2015,San Luis Potosí,24,Tancanhuitz,24012,10661,10846,21507
2015,San Luis Potosí,24,Tanlajás,24041,10302,9994,20296
2015,San Luis Potosí,24,Tanquián de Escobedo,24042,7539,7802,15341
2015,San Luis Potosí,24,Tierra Nueva,24043,4476,5094,9570
2015,San Luis Potosí,24,Vanegas,24044,3991,3904,7895
2015,San Luis Potosí,24,Venado,24045,7403,7625,15028
2015,San Luis Potosí,24,Villa Hidalgo,24051,7619,7739,15358
2015,San Luis Potosí,24,Villa Juárez,24052,5140,5332,10472
2015,San Luis Potosí,24,Villa de Arista,24056,7846,7881,15727
2015,San Luis Potosí,24,Villa de Arriaga,24046,8789,8896,17685
2015,San Luis Potosí,24,Villa de Guadalupe,24047,5030,4983,10013
2015,San Luis Potosí,24,Villa de Ramos,24049,18691,19719,38410
2015,San Luis Potosí,24,Villa de Reyes,24050,24554,24908,49462
2015,San Luis Potosí,24,Villa de la Paz,24048,2737,2718,5455
2015,San Luis Potosí,24,Xilitla,24054,26527,26976,53503
2015,San Luis Potosí,24,Zaragoza,24055,12878,13257,26135
2015,Sinaloa,25,Ahome,25001,224535,231048,455583
2015,Sinaloa,25,Angostura,25002,24262,24107,48369
2015,Sinaloa,25,Badiraguato,25003,16902,15693,32595
2015,Sinaloa,25,Choix,25007,17623,16643,34266
2015,Sinaloa,25,Concordia,25004,14755,14229,28984
2015,Sinaloa,25,Cosalá,25005,8884,8453,17337
2015,Sinaloa,25,Culiacán,25006,452214,466905,919119
2015,Sinaloa,25,El Fuerte,25010,52642,51283,103925
2015,Sinaloa,25,Elota,25008,29669,27588,57257
2015,Sinaloa,25,Escuinapa,25009,30121,29357,59478
2015,Sinaloa,25,Guasave,25011,151519,153421,304940
2015,Sinaloa,25,Mazatlán,25012,246103,252120,498223
2015,Sinaloa,25,Mocorito,25013,24592,23133,47725
2015,Sinaloa,25,Navolato,25018,78420,75572,153992
2015,Sinaloa,25,Rosario,25014,27725,26685,54410
2015,Sinaloa,25,Salvador Alvarado,25015,41169,43035,84204
2015,Sinaloa,25,San Ignacio,25016,12016,11092,23108
2015,Sinaloa,25,Sinaloa,25017,46803,45472,92275
2015,Sonora,26,Aconchi,26001,1493,1352,2845
2015,Sonora,26,Agua Prieta,26002,42461,41729,84190
2015,Sonora,26,Alamos,26003,13973,12996,26969
2015,Sonora,26,Altar,26004,4879,4829,9708
2015,Sonora,26,Arivechi,26005,652,625,1277
2015,Sonora,26,Arizpe,26006,1526,1452,2978
2015,Sonora,26,Atil,26007,336,318,654
2015,Sonora,26,Bacadéhuachi,26008,647,581,1228
2015,Sonora,26,Bacanora,26009,432,398,830
2015,Sonora,26,Bacerac,26010,755,706,1461
2015,Sonora,26,Bacoachi,26011,836,825,1661
2015,Sonora,26,Banámichi,26013,852,837,1689
2015,Sonora,26,Bavispe,26015,793,713,1506
2015,Sonora,26,Baviácora,26014,1854,1747,3601
2015,Sonora,26,Benito Juárez,26071,11482,11465,22947
2015,Sonora,26,Benjamín Hill,26016,2735,2793,5528
2015,Sonora,26,Bácum,26012,12044,11885,23929
2015,Sonora,26,Caborca,26017,43601,42953,86554
2015,Sonora,26,Cajeme,26018,216801,225853,442654
2015,Sonora,26,Cananea,26019,18101,18422,36523
2015,Sonora,26,Carbó,26020,2714,2495,5209
2015,Sonora,26,Cucurpe,26022,550,445,995
2015,Sonora,26,Cumpas,26023,3280,3204,6484
2015,Sonora,26,Divisaderos,26024,400,388,788
2015,Sonora,26,Empalme,26025,28739,29129,57868
2015,Sonora,26,Etchojoa,26026,32351,31331,63682
2015,Sonora,26,Fronteras,26027,4575,4371,8946
2015,Sonora,26,General Plutarco Elías Calles,26070,8549,8280,16829
2015,Sonora,26,Granados,26028,577,558,1135
2015,Sonora,26,Guaymas,26029,79594,80796,160390
2015,Sonora,26,Hermosillo,26030,432938,442004,874942
2015,Sonora,26,Huachinera,26031,679,650,1329
2015,Sonora,26,Huatabampo,26033,42105,41767,83872
2015,Sonora,26,Huásabas,26032,507,451,958
2015,Sonora,26,Huépac,26034,553,521,1074
2015,Sonora,26,Imuris,26035,6544,6486,13030
2015,Sonora,26,La Colorada,26021,1123,908,2031
2015,Sonora,26,Magdalena,26036,15701,15954,31655
2015,Sonora,26,Mazatán,26037,720,640,1360
2015,Sonora,26,Moctezuma,26038,2528,2556,5084
2015,Sonora,26,Naco,26039,3295,3235,6530
2015,Sonora,26,Nacozari de García,26041,7013,6902,13915
2015,Sonora,26,Navojoa,26042,82631,85747,168378
2015,Sonora,26,Nogales,26043,118197,117966,236163
2015,Sonora,26,Nácori Chico,26040,1094,997,2091
2015,Sonora,26,Onavas,26044,256,212,468
2015,Sonora,26,Opodepe,26045,1512,1343,2855
2015,Sonora,26,Oquitoa,26046,201,221,422
2015,Sonora,26,Pitiquito,26047,5156,4808,9964
2015,Sonora,26,Puerto Peñasco,26048,32711,31555,64266
2015,Sonora,26,Quiriego,26049,1698,1473,3171
2015,Sonora,26,Rayón,26050,847,759,1606
2015,Sonora,26,Rosario,26051,2808,2571,5379
2015,Sonora,26,Sahuaripa,26052,3116,2954,6070
2015,Sonora,26,San Felipe de Jesús,26053,210,203,413
2015,Sonora,26,San Ignacio Río Muerto,26072,7707,7309,15016
2015,Sonora,26,San Javier,26054,322,254,576
2015,Sonora,26,San Luis Río Colorado,26055,97351,96346,193697
2015,Sonora,26,San Miguel de Horcasitas,26056,4967,4299,9266
2015,Sonora,26,San Pedro de la Cueva,26057,854,749,1603
2015,Sonora,26,Santa Ana,26058,8322,8524,16846
2015,Sonora,26,Santa Cruz,26059,978,985,1963
2015,Sonora,26,Soyopa,26061,777,644,1421
2015,Sonora,26,Suaqui Grande,26062,639,551,1190
2015,Sonora,26,Sáric,26060,984,919,1903
2015,Sonora,26,Tepache,26063,700,651,1351
2015,Sonora,26,Trincheras,26064,930,787,1717
2015,Sonora,26,Tubutama,26065,743,704,1447
2015,Sonora,26,Ures,26066,4774,4559,9333
2015,Sonora,26,Villa Hidalgo,26067,869,809,1678
2015,Sonora,26,Villa Pesqueira,26068,709,596,1305
2015,Sonora,26,Yécora,26069,3227,3131,6358
2015,Tabasco,27,Balancán,27001,30772,30833,61605
2015,Tabasco,27,Centla,27003,55738,55574,111312
2015,Tabasco,27,Centro,27004,339488,354419,693907
2015,Tabasco,27,Comalcalco,27005,101763,104310,206073
2015,Tabasco,27,Cunduacán,27006,68371,70211,138582
2015,Tabasco,27,Cárdenas,27002,129588,133846,263434
2015,Tabasco,27,Emiliano Zapata,27007,15214,16362,31576
2015,Tabasco,27,Huimanguillo,27008,94779,96786,191565
2015,Tabasco,27,Jalapa,27009,19726,19594,39320
2015,Tabasco,27,Jalpa de Méndez,27010,44289,44486,88775
2015,Tabasco,27,Jonuta,27011,16027,15726,31753
2015,Tabasco,27,Macuspana,27012,82809,85357,168166
2015,Tabasco,27,Nacajuca,27013,65713,68072,133785
2015,Tabasco,27,Paraíso,27014,47460,47884,95344
2015,Tabasco,27,Tacotalpa,27015,24957,24838,49795
2015,Tabasco,27,Teapa,27016,29106,29957,59063
2015,Tabasco,27,Tenosique,27017,30423,31791,62214
2015,Tamaulipas,28,Abasolo,28001,6311,6278,12589
2015,Tamaulipas,28,Aldama,28002,15367,15051,30418
2015,Tamaulipas,28,Altamira,28003,115732,116764,232496
2015,Tamaulipas,28,Antiguo Morelos,28004,4929,4967,9896
2015,Tamaulipas,28,Burgos,28005,2460,2288,4748
2015,Tamaulipas,28,Bustamante,28006,4261,3913,8174
2015,Tamaulipas,28,Camargo,28007,8441,8171,16612
2015,Tamaulipas,28,Casas,28008,2333,2080,4413
2015,Tamaulipas,28,Ciudad Madero,28009,103047,112223,215270
2015,Tamaulipas,28,Cruillas,28010,1080,1037,2117
2015,Tamaulipas,28,El Mante,28021,59603,62726,122329
2015,Tamaulipas,28,González,28012,22472,22690,45162
2015,Tamaulipas,28,Guerrero,28014,2381,2200,4581
2015,Tamaulipas,28,Gustavo Díaz Ordaz,28015,8223,8017,16240
2015,Tamaulipas,28,Gómez Farías,28011,4835,4580,9415
2015,Tamaulipas,28,Güémez,28013,8370,7730,16100
2015,Tamaulipas,28,Hidalgo,28016,12497,11816,24313
2015,Tamaulipas,28,Jaumave,28017,8019,7755,15774
2015,Tamaulipas,28,Jiménez,28018,4341,4281,8622
2015,Tamaulipas,28,Llera,28019,9053,8738,17791
2015,Tamaulipas,28,Mainero,28020,1344,1299,2643
2015,Tamaulipas,28,Matamoros,28022,260389,266501,526890
2015,Tamaulipas,28,Mier,28024,2488,2537,5025
2015,Tamaulipas,28,Miguel Alemán,28025,14089,14075,28164
2015,Tamaulipas,28,Miquihuana,28026,1939,1750,3689
2015,Tamaulipas,28,Méndez,28023,2365,2182,4547
2015,Tamaulipas,28,Nuevo Laredo,28027,203638,202954,406592
2015,Tamaulipas,28,Nuevo Morelos,28028,1875,1713,3588
2015,Tamaulipas,28,Ocampo,28029,7165,6902,14067
2015,Tamaulipas,28,Padilla,28030,7290,7119,14409
2015,Tamaulipas,28,Palmillas,28031,911,886,1797
2015,Tamaulipas,28,Reynosa,28032,321320,320612,641932
2015,Tamaulipas,28,Río Bravo,28033,63764,63248,127012
2015,Tamaulipas,28,San Carlos,28034,4946,4493,9439
2015,Tamaulipas,28,San Fernando,28035,29854,29354,59208
2015,Tamaulipas,28,San Nicolás,28036,568,516,1084
2015,Tamaulipas,28,Soto la Marina,28037,13375,12603,25978
2015,Tamaulipas,28,Tampico,28038,156525,169322,325847
2015,Tamaulipas,28,Tula,28039,14854,14843,29697
2015,Tamaulipas,28,Valle Hermoso,28040,32906,33786,66692
2015,Tamaulipas,28,Victoria,28041,170652,177710,348362
2015,Tamaulipas,28,Villagrán,28042,3411,3160,6571
2015,Tamaulipas,28,Xicoténcatl,28043,12245,12181,24426
2015,Tlaxcala,29,Acuamanala de Miguel Hidalgo,29022,3100,3095,6195
2015,Tlaxcala,29,Altzayanca,29004,8730,8710,17440
2015,Tlaxcala,29,Amaxac de Guerrero,29001,5425,5592,11017
2015,Tlaxcala,29,Apetatitlán de Antonio Carvajal,29002,7435,7894,15329
2015,Tlaxcala,29,Apizaco,29005,39540,43204,82744
2015,Tlaxcala,29,Atlangatepec,29003,3272,3403,6675
2015,Tlaxcala,29,Benito Juárez,29045,3040,3128,6168
2015,Tlaxcala,29,Calpulalpan,29006,24013,25277,49290
2015,Tlaxcala,29,Chiautempan,29010,35068,37536,72604
2015,Tlaxcala,29,Contla de Juan Cuamatzi,29018,19249,19765,39014
2015,Tlaxcala,29,Cuapiaxtla,29008,7695,7670,15365
2015,Tlaxcala,29,Cuaxomulco,29009,2703,2716,5419
2015,Tlaxcala,29,El Carmen Tequexquitla,29007,8483,8711,17194
2015,Tlaxcala,29,Emiliano Zapata,29046,2246,2349,4595
2015,Tlaxcala,29,Españita,29012,4496,4538,9034
2015,Tlaxcala,29,Huamantla,29013,46076,47923,93999
2015,Tlaxcala,29,Hueyotlipan,29014,7425,7554,14979
2015,Tlaxcala,29,Ixtacuixtla de Mariano Matamoros,29015,18948,20085,39033
2015,Tlaxcala,29,Ixtenco,29016,3545,3825,7370
2015,Tlaxcala,29,La Magdalena Tlaltelulco,29048,9090,9725,18815
2015,Tlaxcala,29,Lázaro Cárdenas,29047,1540,1569,3109
2015,Tlaxcala,29,Mazatecochco de José María Morelos,29017,5403,5509,10912
2015,Tlaxcala,29,Muñoz de Domingo Arenas,29011,2396,2356,4752
2015,Tlaxcala,29,Nanacamilpa de Mariano Arista,29021,9033,9438,18471
2015,Tlaxcala,29,Natívitas,29023,12407,13327,25734
2015,Tlaxcala,29,Panotla,29024,13455,14244,27699
2015,Tlaxcala,29,Papalotla de Xicohténcatl,29041,14753,15787,30540
2015,Tlaxcala,29,San Damián Texóloc,29049,2804,2843,5647
2015,Tlaxcala,29,San Francisco Tetlanohcan,29050,5441,5730,11171
2015,Tlaxcala,29,San Jerónimo Zacualpan,29051,1823,2042,3865
2015,Tlaxcala,29,San José Teacalco,29052,2970,3127,6097
2015,Tlaxcala,29,San Juan Huactzinco,29053,3645,4001,7646
2015,Tlaxcala,29,San Lorenzo Axocomanitla,29054,2745,2966,5711
2015,Tlaxcala,29,San Lucas Tecopilco,29055,1531,1640,3171
2015,Tlaxcala,29,San Pablo del Monte,29025,38652,39024,77676
2015,Tlaxcala,29,Sanctórum de Lázaro Cárdenas,29020,4695,4775,9470
2015,Tlaxcala,29,Santa Ana Nopalucan,29056,3828,3956,7784
2015,Tlaxcala,29,Santa Apolonia Teacalco,29057,2209,2470,4679
2015,Tlaxcala,29,Santa Catarina Ayometla,29058,4280,4642,8922
2015,Tlaxcala,29,Santa Cruz Quilehtla,29059,3514,3557,7071
2015,Tlaxcala,29,Santa Cruz Tlaxcala,29026,9901,10246,20147
2015,Tlaxcala,29,Santa Isabel Xiloxoxtla,29060,2435,2569,5004
2015,Tlaxcala,29,Tenancingo,29027,6375,6657,13032
2015,Tlaxcala,29,Teolocholco,29028,11800,12533,24333
2015,Tlaxcala,29,Tepetitla de Lardizábal,29019,10140,10891,21031
2015,Tlaxcala,29,Tepeyanco,29029,5915,6485,12400
2015,Tlaxcala,29,Terrenate,29030,7526,7464,14990
2015,Tlaxcala,29,Tetla de la Solidaridad,29031,15943,16414,32357
2015,Tlaxcala,29,Tetlatlahuca,29032,6661,7043,13704
2015,Tlaxcala,29,Tlaxcala,29033,47027,51406,98433
2015,Tlaxcala,29,Tlaxco,29034,21386,22123,43509
2015,Tlaxcala,29,Tocatlán,29035,2968,3047,6015
2015,Tlaxcala,29,Totolac,29036,10899,11793,22692
2015,Tlaxcala,29,Tzompantepec,29038,7983,8499,16482
2015,Tlaxcala,29,Xaloztoc,29039,12094,12027,24121
2015,Tlaxcala,29,Xaltocan,29040,5112,5445,10557
2015,Tlaxcala,29,Xicohtzinco,29042,6551,7196,13747
2015,Tlaxcala,29,Yauhquemehcan,29043,18375,19535,37910
2015,Tlaxcala,29,Zacatelco,29044,20711,22470,43181
2015,Tlaxcala,29,Ziltlaltépec de Trinidad Sánchez Santos,29037,4383,4760,9143
2015,Veracruz,30,Acajete,30001,4562,4292,8854
2015,Veracruz,30,Acatlán,30002,1587,1646,3233
2015,Veracruz,30,Acayucan,30003,43078,46205,89283
2015,Veracruz,30,Actopan,30004,21759,22465,44224
2015,Veracruz,30,Acula,30005,2754,2741,5495
2015,Veracruz,30,Acultzingo,30006,11196,11582,22778
2015,Veracruz,30,Agua Dulce,30204,23920,25300,49220
2015,Veracruz,30,Alpatláhuac,30008,5089,5130,10219
2015,Veracruz,30,Alto Lucero de Gutiérrez Barrios,30009,14941,14868,29809
2015,Veracruz,30,Altotonga,30010,31733,33797,65530
2015,Veracruz,30,Alvarado,30011,27359,27603,54962
2015,Veracruz,30,Amatitlán,30012,4014,4169,8183
2015,Veracruz,30,Amatlán de los Reyes,30014,22156,23655,45811
2015,Veracruz,30,Angel R. Cabada,30015,17203,18108,35311
2015,Veracruz,30,Apazapan,30017,2069,2086,4155
2015,Veracruz,30,Aquila,30018,921,997,1918
2015,Veracruz,30,Astacinga,30019,3000,3403,6403
2015,Veracruz,30,Atlahuilco,30020,5260,5533,10793
2015,Veracruz,30,Atoyac,30021,11867,12614,24481
2015,Veracruz,30,Atzacan,30022,10618,10841,21459
2015,Veracruz,30,Atzalan,30023,25608,25595,51203
2015,Veracruz,30,Ayahualulco,30025,13404,13430,26834
2015,Veracruz,30,Banderilla,30026,11315,12508,23823
2015,Veracruz,30,Benito Juárez,30027,8812,9183,17995
2015,Veracruz,30,Boca del Río,30028,70476,79091,149567
2015,Veracruz,30,Calcahualco,30029,6716,6593,13309
2015,Veracruz,30,Camarón de Tejeda,30007,3307,3291,6598
2015,Veracruz,30,Camerino Z. Mendoza,30030,20788,23166,43954
2015,Veracruz,30,Carlos A. Carrillo,30208,12082,13073,25155
2015,Veracruz,30,Carrillo Puerto,30031,8429,8788,17217
2015,Veracruz,30,Castillo de Teayo,30157,10276,10090,20366
2015,Veracruz,30,Catemaco,30032,24868,26354,51222
2015,Veracruz,30,Cazones de Herrera,30033,11997,12615,24612
2015,Veracruz,30,Cerro Azul,30034,13119,14500,27619
2015,Veracruz,30,Chacaltianguis,30054,6221,6548,12769
2015,Veracruz,30,Chalma,30055,6834,7000,13834
2015,Veracruz,30,Chiconamel,30056,3437,3577,7014
2015,Veracruz,30,Chiconquiaco,30057,7164,7178,14342
2015,Veracruz,30,Chicontepec,30058,28512,29796,58308
2015,Veracruz,30,Chinameca,30059,8030,8407,16437
2015,Veracruz,30,Chinampa de Gorostiza,30060,8229,8464,16693
2015,Veracruz,30,Chocamán,30062,10291,10414,20705
2015,Veracruz,30,Chontla,30063,7630,7625,15255
2015,Veracruz,30,Chumatlán,30064,1943,2038,3981
2015,Veracruz,30,Citlaltépetl,30035,5984,6204,12188
2015,Veracruz,30,Coacoatzintla,30036,5045,5279,10324
2015,Veracruz,30,Coahuitlán,30037,4213,4296,8509
2015,Veracruz,30,Coatepec,30038,45451,48471,93922
2015,Veracruz,30,Coatzacoalcos,30039,158764,168252,327016
2015,Veracruz,30,Coatzintla,30040,27034,28439,55473
2015,Veracruz,30,Coetzala,30041,1119,1154,2273
2015,Veracruz,30,Colipa,30042,2950,3046,5996
2015,Veracruz,30,Comapa,30043,10309,9901,20210
2015,Veracruz,30,Cosamaloapan de Carpio,30045,28264,30591,58855
2015,Veracruz,30,Cosautlán de Carvajal,30046,8315,8393,16708
2015,Veracruz,30,Coscomatepec,30047,28310,29140,57450
2015,Veracruz,30,Cosoleacaque,30048,67229,71980,139209
2015,Veracruz,30,Cotaxtla,30049,10671,10736,21407
2015,Veracruz,30,Coxquihui,30050,8297,8580,16877
2015,Veracruz,30,Coyutla,30051,11184,11918,23102
2015,Veracruz,30,Cuichapa,30052,5920,6534,12454
2015,Veracruz,30,Cuitláhuac,30053,13405,14752,28157
2015,Veracruz,30,Córdoba,30044,103170,116118,219288
2015,Veracruz,30,El Higo,30205,10045,10064,20109
2015,Veracruz,30,Emiliano Zapata,30065,36544,39067,75611
2015,Veracruz,30,Espinal,30066,13564,14080,27644
2015,Veracruz,30,Filomeno Mata,30067,9027,8973,18000
2015,Veracruz,30,Fortín,30068,31364,34724,66088
2015,Veracruz,30,Gutiérrez Zamora,30069,12182,13653,25835
2015,Veracruz,30,Hidalgotitlán,30070,9788,9533,19321
2015,Veracruz,30,Huatusco,30071,29112,31052,60164
2015,Veracruz,30,Huayacocotla,30072,10589,11210,21799
2015,Veracruz,30,Hueyapan de Ocampo,30073,21492,22549,44041
2015,Veracruz,30,Huiloapan de Cuauhtémoc,30074,3549,3776,7325
2015,Veracruz,30,Ignacio de la Llave,30075,8711,9327,18038
2015,Veracruz,30,Ilamatlán,30076,6729,7315,14044
2015,Veracruz,30,Isla,30077,21763,22675,44438
2015,Veracruz,30,Ixcatepec,30078,6928,6919,13847
2015,Veracruz,30,Ixhuacán de los Reyes,30079,5831,5699,11530
2015,Veracruz,30,Ixhuatlancillo,30081,11756,12727,24483
2015,Veracruz,30,Ixhuatlán de Madero,30083,26829,27836,54665
2015,Veracruz,30,Ixhuatlán del Café,30080,11505,11551,23056
2015,Veracruz,30,Ixhuatlán del Sureste,30082,8027,7995,16022
2015,Veracruz,30,Ixmatlahuacan,30084,3015,3038,6053
2015,Veracruz,30,Ixtaczoquitlán,30085,34167,36120,70287
2015,Veracruz,30,Jalacingo,30086,21814,22515,44329
2015,Veracruz,30,Jalcomulco,30088,2652,2582,5234
2015,Veracruz,30,Jamapa,30090,5656,5820,11476
2015,Veracruz,30,Jesús Carranza,30091,14451,14575,29026
2015,Veracruz,30,Jilotepec,30093,8116,8559,16675
2015,Veracruz,30,José Azueta,30169,11928,12359,24287
2015,Veracruz,30,Juan Rodríguez Clara,30094,19565,20017,39582
2015,Veracruz,30,Juchique de Ferrer,30095,8377,8500,16877
2015,Veracruz,30,Jáltipan,30089,20350,22128,42478
2015,Veracruz,30,La Antigua,30016,13445,14330,27775
2015,Veracruz,30,La Perla,30127,13225,13604,26829
2015,Veracruz,30,Landero y Coss,30096,788,840,1628
2015,Veracruz,30,Las Choapas,30061,40193,41698,81891
2015,Veracruz,30,Las Minas,30107,1548,1471,3019
2015,Veracruz,30,Las Vigas de Ramírez,30132,9673,9734,19407
2015,Veracruz,30,Lerdo de Tejada,30097,9721,11009,20730
2015,Veracruz,30,Los Reyes,30137,2914,2945,5859
2015,Veracruz,30,Magdalena,30098,1544,1543,3087
2015,Veracruz,30,Maltrata,30099,8698,9328,18026
2015,Veracruz,30,Manlio Fabio Altamirano,30100,11854,12122,23976
2015,Veracruz,30,Mariano Escobedo,30101,17867,19163,37030
2015,Veracruz,30,Martínez de la Torre,30102,53579,57695,111274
2015,Veracruz,30,Mecatlán,30103,6210,6341,12551
2015,Veracruz,30,Mecayapan,30104,8380,8710,17090
2015,Veracruz,30,Medellín,30105,34959,37792,72751
2015,Veracruz,30,Miahuatlán,30106,2328,2405,4733
2015,Veracruz,30,Minatitlán,30108,78740,83787,162527
2015,Veracruz,30,Misantla,30109,32511,33882,66393
2015,Veracruz,30,Mixtla de Altamirano,30110,5802,5669,11471
2015,Veracruz,30,Moloacán,30111,8598,9029,17627
2015,Veracruz,30,Nanchital de Lázaro Cárdenas del Rio,30206,14722,15552,30274
2015,Veracruz,30,Naolinco,30112,10818,11248,22066
2015,Veracruz,30,Naranjal,30113,2309,2424,4733
2015,Veracruz,30,Naranjos Amatlán,30013,13918,15369,29287
2015,Veracruz,30,Nautla,30114,5444,5645,11089
2015,Veracruz,30,Nogales,30115,18233,19832,38065
2015,Veracruz,30,Oluta,30116,7956,8552,16508
2015,Veracruz,30,Omealca,30117,11784,12607,24391
2015,Veracruz,30,Orizaba,30118,60643,70323,130966
2015,Veracruz,30,Otatitlán,30119,2803,3045,5848
2015,Veracruz,30,Oteapan,30120,7902,8210,16112
2015,Veracruz,30,Ozuluama de Mascareñas,30121,12526,11874,24400
2015,Veracruz,30,Pajapan,30122,8741,8654,17395
2015,Veracruz,30,Papantla,30124,82233,84593,166826
2015,Veracruz,30,Paso de Ovejas,30126,17215,17268,34483
2015,Veracruz,30,Paso del Macho,30125,15868,16161,32029
2015,Veracruz,30,Perote,30128,36559,36791,73350
2015,Veracruz,30,Platón Sánchez,30129,9295,9554,18849
2015,Veracruz,30,Playa Vicente,30130,19680,21286,40966
2015,Veracruz,30,Poza Rica de Hidalgo,30131,98208,108994,207202
2015,Veracruz,30,Pueblo Viejo,30133,29747,29487,59234
2015,Veracruz,30,Puente Nacional,30134,11378,11692,23070
2015,Veracruz,30,Pánuco,30123,51476,51681,103157
2015,Veracruz,30,Rafael Delgado,30135,11154,11469,22623
2015,Veracruz,30,Rafael Lucio,30136,3830,4033,7863
2015,Veracruz,30,Río Blanco,30138,20612,23084,43696
2015,Veracruz,30,Saltabarranca,30139,3081,3268,6349
2015,Veracruz,30,San Andrés Tenejapan,30140,1434,1496,2930
2015,Veracruz,30,San Andrés Tuxtla,30141,81190,87005,168195
2015,Veracruz,30,San Juan Evangelista,30142,17145,17664,34809
2015,Veracruz,30,San Rafael,30211,15192,15759,30951
2015,Veracruz,30,Santiago Sochiapan,30212,6794,7232,14026
2015,Veracruz,30,Santiago Tuxtla,30143,28835,30793,59628
2015,Veracruz,30,Sayula de Alemán,30144,16416,16927,33343
2015,Veracruz,30,Sochiapa,30146,1863,1841,3704
2015,Veracruz,30,Soconusco,30145,7803,8186,15989
2015,Veracruz,30,Soledad Atzompa,30147,11466,11535,23001
2015,Veracruz,30,Soledad de Doblado,30148,14305,14520,28825
2015,Veracruz,30,Soteapan,30149,17021,17515,34536
2015,Veracruz,30,Tamalín,30150,6070,6012,12082
2015,Veracruz,30,Tamiahua,30151,12362,12168,24530
2015,Veracruz,30,Tampico Alto,30152,6684,6206,12890
2015,Veracruz,30,Tancoco,30153,2978,3109,6087
2015,Veracruz,30,Tantima,30154,6929,6688,13617
2015,Veracruz,30,Tantoyuca,30155,53212,53711,106923
2015,Veracruz,30,Tatahuicapan de Juárez,30209,7593,7934,15527
2015,Veracruz,30,Tatatila,30156,3083,2814,5897
2015,Veracruz,30,Tecolutla,30158,12591,12878,25469
2015,Veracruz,30,Tehuipango,30159,12466,13154,25620
2015,Veracruz,30,Tempoal,30161,18274,18595,36869
2015,Veracruz,30,Tenampa,30162,3325,3472,6797
2015,Veracruz,30,Tenochtitlán,30163,2590,2789,5379
2015,Veracruz,30,Teocelo,30164,8348,8769,17117
2015,Veracruz,30,Tepatlaxco,30165,4448,4207,8655
2015,Veracruz,30,Tepetlán,30166,5020,4813,9833
2015,Veracruz,30,Tepetzintla,30167,7466,7608,15074
2015,Veracruz,30,Tequila,30168,7516,7716,15232
2015,Veracruz,30,Texcatepec,30170,5468,5648,11116
2015,Veracruz,30,Texhuacán,30171,2601,2860,5461
2015,Veracruz,30,Texistepec,30172,10598,10591,21189
2015,Veracruz,30,Tezonapa,30173,28106,28702,56808
2015,Veracruz,30,Tierra Blanca,30174,50707,54629,105336
2015,Veracruz,30,Tihuatlán,30175,47469,49224,96693
2015,Veracruz,30,Tlachichilco,30180,5866,6035,11901
2015,Veracruz,30,Tlacojalpan,30176,2500,2536,5036
2015,Veracruz,30,Tlacolulan,30177,5721,5544,11265
2015,Veracruz,30,Tlacotalpan,30178,6866,7330,14196
2015,Veracruz,30,Tlacotepec de Mejía,30179,2001,2039,4040
2015,Veracruz,30,Tlalixcoyan,30181,19358,19950,39308
2015,Veracruz,30,Tlalnelhuayocan,30182,9009,9331,18340
2015,Veracruz,30,Tlaltetela,30024,8042,7831,15873
2015,Veracruz,30,Tlapacoyan,30183,30518,32203,62721
2015,Veracruz,30,Tlaquilpa,30184,3621,4096,7717
2015,Veracruz,30,Tlilapan,30185,2599,2700,5299
2015,Veracruz,30,Tomatlán,30186,3504,3606,7110
2015,Veracruz,30,Tonayán,30187,2881,2985,5866
2015,Veracruz,30,Totutla,30188,8782,8835,17617
2015,Veracruz,30,Tres Valles,30207,23331,24522,47853
2015,Veracruz,30,Tuxpan,30189,78604,82460,161064
2015,Veracruz,30,Tuxtilla,30190,1146,1170,2316
2015,Veracruz,30,Ursulo Galván,30191,15226,16120,31346
2015,Veracruz,30,Uxpanapa,30210,14820,14533,29353
2015,Veracruz,30,Vega de Alatorre,30192,10099,10737,20836
2015,Veracruz,30,Veracruz,30193,287146,310521,597667
2015,Veracruz,30,Villa Aldama,30194,5795,5870,11665
2015,Veracruz,30,Xalapa,30087,232111,261225,493336
2015,Veracruz,30,Xico,30092,18986,19401,38387
2015,Veracruz,30,Xoxocotla,30195,2801,2658,5459
2015,Veracruz,30,Yanga,30196,8588,9739,18327
2015,Veracruz,30,Yecuatla,30197,6068,6277,12345
2015,Veracruz,30,Zacualpan,30198,3554,3765,7319
2015,Veracruz,30,Zaragoza,30199,5603,5851,11454
2015,Veracruz,30,Zentla,30200,6875,6719,13594
2015,Veracruz,30,Zongolica,30201,22182,22401,44583
2015,Veracruz,30,Zontecomatlán de López y Fuentes,30202,7340,7437,14777
2015,Veracruz,30,Zozocolco de Hidalgo,30203,7330,7560,14890
2015,Veracruz,30,Álamo Temapache,30160,54170,54860,109030
2015,Yucatán,31,Abalá,31001,3442,3257,6699
2015,Yucatán,31,Acanceh,31002,8251,8221,16472
2015,Yucatán,31,Akil,31003,5572,5747,11319
2015,Yucatán,31,Baca,31004,3003,3042,6045
2015,Yucatán,31,Bokobá,31005,1143,1092,2235
2015,Yucatán,31,Buctzotz,31006,4625,4576,9201
2015,Yucatán,31,Cacalchén,31007,3769,3591,7360
2015,Yucatán,31,Calotmul,31008,2125,2074,4199
2015,Yucatán,31,Cansahcab,31009,2435,2451,4886
2015,Yucatán,31,Cantamayec,31010,1337,1222,2559
2015,Yucatán,31,Celestún,31011,3959,3768,7727
2015,Yucatán,31,Cenotillo,31012,1916,2068,3984
2015,Yucatán,31,Chacsinkín,31016,1536,1491,3027
2015,Yucatán,31,Chankom,31017,2402,2309,4711
2015,Yucatán,31,Chapab,31018,1635,1604,3239
2015,Yucatán,31,Chemax,31019,18382,18042,36424
2015,Yucatán,31,Chichimilá,31021,4267,4217,8484
2015,Yucatán,31,Chicxulub Pueblo,31020,2330,2182,4512
2015,Yucatán,31,Chikindzonot,31022,2203,2122,4325
2015,Yucatán,31,Chocholá,31023,2472,2373,4845
2015,Yucatán,31,Chumayel,31024,1657,1704,3361
2015,Yucatán,31,Conkal,31013,5438,5386,10824
2015,Yucatán,31,Cuncunul,31014,843,806,1649
2015,Yucatán,31,Cuzamá,31015,2707,2618,5325
2015,Yucatán,31,Dzemul,31026,1907,1852,3759
2015,Yucatán,31,Dzidzantún,31027,4390,4245,8635
2015,Yucatán,31,Dzilam González,31029,3278,3081,6359
2015,Yucatán,31,Dzilam de Bravo,31028,1409,1326,2735
2015,Yucatán,31,Dzitás,31030,1970,1869,3839
2015,Yucatán,31,Dzoncauich,31031,1411,1409,2820
2015,Yucatán,31,Dzán,31025,2633,2747,5380
2015,Yucatán,31,Espita,31032,8324,8071,16395
2015,Yucatán,31,Halachó,31033,10401,10127,20528
2015,Yucatán,31,Hocabá,31034,3191,3145,6336
2015,Yucatán,31,Hoctún,31035,3032,3100,6132
2015,Yucatán,31,Homún,31036,3989,3836,7825
2015,Yucatán,31,Huhí,31037,2688,2574,5262
2015,Yucatán,31,Hunucmá,31038,16496,16448,32944
2015,Yucatán,31,Ixil,31039,2120,2020,4140
2015,Yucatán,31,Izamal,31040,13673,13842,27515
2015,Yucatán,31,Kanasín,31041,46711,47286,93997
2015,Yucatán,31,Kantunil,31042,2826,2874,5700
2015,Yucatán,31,Kaua,31043,1584,1501,3085
2015,Yucatán,31,Kinchil,31044,3629,3548,7177
2015,Yucatán,31,Kopomá,31045,1341,1251,2592
2015,Yucatán,31,Mama,31046,1521,1667,3188
2015,Yucatán,31,Maní,31047,2778,2907,5685
2015,Yucatán,31,Maxcanú,31048,11700,11469,23169
2015,Yucatán,31,Mayapán,31049,1857,1756,3613
2015,Yucatán,31,Mocochá,31051,1673,1642,3315
2015,Yucatán,31,Motul,31052,18262,18461,36723
2015,Yucatán,31,Muna,31053,6462,6646,13108
2015,Yucatán,31,Muxupip,31054,1444,1492,2936
2015,Yucatán,31,Mérida,31050,438932,468698,907630
2015,Yucatán,31,Opichén,31055,3471,3329,6800
2015,Yucatán,31,Oxkutzcab,31056,15058,16402,31460
2015,Yucatán,31,Panabá,31057,4051,4011,8062
2015,Yucatán,31,Peto,31058,12742,12872,25614
2015,Yucatán,31,Progreso,31059,29744,29768,59512
2015,Yucatán,31,Quintana Roo,31060,505,498,1003
2015,Yucatán,31,Río Lagartos,31061,1878,1767,3645
2015,Yucatán,31,Sacalum,31062,2541,2366,4907
2015,Yucatán,31,Samahil,31063,2662,2630,5292
2015,Yucatán,31,San Felipe,31065,1048,966,2014
2015,Yucatán,31,Sanahcat,31064,860,867,1727
2015,Yucatán,31,Santa Elena,31066,2015,2100,4115
2015,Yucatán,31,Seyé,31067,5134,4855,9989
2015,Yucatán,31,Sinanché,31068,1701,1552,3253
2015,Yucatán,31,Sotuta,31069,4613,4424,9037
2015,Yucatán,31,Sucilá,31070,2093,2006,4099
2015,Yucatán,31,Sudzal,31071,924,839,1763
2015,Yucatán,31,Suma,31072,972,926,1898
2015,Yucatán,31,Tahdziú,31073,2534,2392,4926
2015,Yucatán,31,Tahmek,31074,1944,1860,3804
2015,Yucatán,31,Teabo,31075,3274,3334,6608
2015,Yucatán,31,Tecoh,31076,8961,8814,17775
2015,Yucatán,31,Tekal de Venegas,31077,1381,1341,2722
2015,Yucatán,31,Tekantó,31078,1967,1984,3951
2015,Yucatán,31,Tekax,31079,21389,21795,43184
2015,Yucatán,31,Tekit,31080,5329,5144,10473
2015,Yucatán,31,Tekom,31081,1652,1634,3286
2015,Yucatán,31,Telchac Pueblo,31082,1940,1896,3836
2015,Yucatán,31,Telchac Puerto,31083,967,879,1846
2015,Yucatán,31,Temax,31084,3717,3665,7382
2015,Yucatán,31,Temozón,31085,8036,7769,15805
2015,Yucatán,31,Tepakán,31086,1161,1104,2265
2015,Yucatán,31,Tetiz,31087,2554,2598,5152
2015,Yucatán,31,Teya,31088,1006,1029,2035
2015,Yucatán,31,Ticul,31089,20240,20600,40840
2015,Yucatán,31,Timucuy,31090,3823,3611,7434
2015,Yucatán,31,Tinum,31091,6170,5908,12078
2015,Yucatán,31,Tixcacalcupul,31092,3632,3542,7174
2015,Yucatán,31,Tixkokob,31093,9137,9239,18376
2015,Yucatán,31,Tixmehuac,31094,2500,2438,4938
2015,Yucatán,31,Tixpéhual,31095,2811,2845,5656
2015,Yucatán,31,Tizimín,31096,39198,39587,78785
2015,Yucatán,31,Tunkás,31097,1859,1799,3658
2015,Yucatán,31,Tzucacab,31098,7624,7403,15027
2015,Yucatán,31,Uayma,31099,2071,1958,4029
2015,Yucatán,31,Ucú,31100,1881,1839,3720
2015,Yucatán,31,Umán,31101,28394,28196,56590
2015,Yucatán,31,Valladolid,31102,40118,40696,80814
2015,Yucatán,31,Xocchel,31103,1789,1706,3495
2015,Yucatán,31,Yaxcabá,31104,8034,7538,15572
2015,Yucatán,31,Yaxkukul,31105,1572,1572,3144
2015,Yucatán,31,Yobaín,31106,1181,1117,2298
2015,Zacatecas,32,Apozol,32001,3097,3293,6390
2015,Zacatecas,32,Apulco,32002,2389,2654,5043
2015,Zacatecas,32,Atolinga,32003,1282,1378,2660
2015,Zacatecas,32,Benito Juárez,32004,2163,2116,4279
2015,Zacatecas,32,Calera,32005,22471,22323,44794
2015,Zacatecas,32,Cañitas de Felipe Pescador,32006,4289,4397,8686
2015,Zacatecas,32,Chalchihuites,32009,5593,5934,11527
2015,Zacatecas,32,Concepción del Oro,32007,6815,6601,13416
2015,Zacatecas,32,Cuauhtémoc,32008,6298,6527,12825
2015,Zacatecas,32,El Plateado de Joaquín Amaro,32015,685,708,1393
2015,Zacatecas,32,El Salvador,32041,1374,1314,2688
2015,Zacatecas,32,Fresnillo,32010,114806,116927,231733
2015,Zacatecas,32,Genaro Codina,32012,4095,4275,8370
2015,Zacatecas,32,General Enrique Estrada,32013,3193,3237,6430
2015,Zacatecas,32,General Francisco R. Murguía,32014,10949,11705,22654
2015,Zacatecas,32,General Pánfilo Natera,32016,11649,12108,23757
2015,Zacatecas,32,Guadalupe,32017,89224,93013,182237
2015,Zacatecas,32,Huanusco,32018,2100,2235,4335
2015,Zacatecas,32,Jalpa,32019,12156,12764,24920
2015,Zacatecas,32,Jerez,32020,29483,31254,60737
2015,Zacatecas,32,Jiménez del Teul,32021,2299,2340,4639
2015,Zacatecas,32,Juan Aldama,32022,10700,11279,21979
2015,Zacatecas,32,Juchipila,32023,6192,6825,13017
2015,Zacatecas,32,Loreto,32024,26438,26754,53192
2015,Zacatecas,32,Luis Moya,32025,6594,6687,13281
2015,Zacatecas,32,Mazapil,32026,9479,8505,17984
2015,Zacatecas,32,Melchor Ocampo,32027,1562,1369,2931
2015,Zacatecas,32,Mezquital del Oro,32028,1252,1363,2615
2015,Zacatecas,32,Miguel Auza,32029,11809,12216,24025
2015,Zacatecas,32,Momax,32030,1251,1344,2595
2015,Zacatecas,32,Monte Escobedo,32031,4677,4821,9498
2015,Zacatecas,32,Morelos,32032,6284,6248,12532
2015,Zacatecas,32,Moyahua de Estrada,32033,2073,2329,4402
2015,Zacatecas,32,Nochistlán de Mejía,32034,13652,15215,28867
2015,Zacatecas,32,Noria de Ángeles,32035,8263,8479,16742
2015,Zacatecas,32,Ojocaliente,32036,21455,22389,43844
2015,Zacatecas,32,Pinos,32038,36686,37920,74606
2015,Zacatecas,32,Pánuco,32037,8978,8918,17896
2015,Zacatecas,32,Río Grande,32039,31841,33896,65737
2015,Zacatecas,32,Sain Alto,32040,10996,11585,22581
2015,Zacatecas,32,Santa María de la Paz,32058,1403,1432,2835
2015,Zacatecas,32,Sombrerete,32042,31799,32517,64316
2015,Zacatecas,32,Susticacán,32043,666,716,1382
2015,Zacatecas,32,Tabasco,32044,7889,8276,16165
2015,Zacatecas,32,Tepechitlán,32045,4285,4669,8954
2015,Zacatecas,32,Tepetongo,32046,3571,3834,7405
2015,Zacatecas,32,Teúl de González Ortega,32047,2732,2854,5586
2015,Zacatecas,32,Tlaltenango de Sánchez Román,32048,13236,13614,26850
2015,Zacatecas,32,Trancoso,32057,9543,9668,19211
2015,Zacatecas,32,Trinidad García de la Cadena,32011,1503,1565,3068
2015,Zacatecas,32,Valparaíso,32049,16857,17404,34261
2015,Zacatecas,32,Vetagrande,32050,4935,5033,9968
2015,Zacatecas,32,Villa García,32052,9553,9682,19235
2015,Zacatecas,32,Villa González Ortega,32053,6497,6955,13452
2015,Zacatecas,32,Villa Hidalgo,32054,9719,9828,19547
2015,Zacatecas,32,Villa de Cos,32051,18152,17855,36007
2015,Zacatecas,32,Villanueva,32055,15247,15994,31241
2015,Zacatecas,32,Zacatecas,32056,73304,77077,150381
2016,Aguascalientes,01,Aguascalientes,01001,446543,463493,910036
2016,Aguascalientes,01,Asientos,01002,24302,24552,48854
2016,Aguascalientes,01,Calvillo,01003,28715,30035,58750
2016,Aguascalientes,01,Cosío,01004,8006,8316,16322
2016,Aguascalientes,01,El Llano,01010,10640,10345,20985
2016,Aguascalientes,01,Jesús María,01005,60015,59771,119786
2016,Aguascalientes,01,Pabellón de Arteaga,01006,23356,24400,47756
2016,Aguascalientes,01,Rincón de Romos,01007,27494,27971,55465
2016,Aguascalientes,01,San Francisco de los Romo,01011,23057,23417,46474
2016,Aguascalientes,01,San José de Gracia,01008,4473,4770,9243
2016,Aguascalientes,01,Tepezalá,01009,10642,11008,21650
2016,Baja California,02,Ensenada,02001,250485,250671,501156
2016,Baja California,02,Mexicali,02002,507877,508335,1016212
2016,Baja California,02,Playas de Rosarito,02005,50012,49748,99760
2016,Baja California,02,Tecate,02003,55176,51632,106808
2016,Baja California,02,Tijuana,02004,838625,840774,1679399
2016,Baja California Sur,03,Comondú,03001,39515,38456,77971
2016,Baja California Sur,03,La Paz,03003,141002,140905,281907
2016,Baja California Sur,03,Loreto,03009,10194,9351,19545
2016,Baja California Sur,03,Los Cabos,03008,150963,142122,293085
2016,Baja California Sur,03,Mulegé,03002,33464,31023,64487
2016,Campeche,04,Calakmul,04010,15094,14691,29785
2016,Campeche,04,Calkiní,04001,29270,30207,59477
2016,Campeche,04,Campeche,04002,142644,153006,295650
2016,Campeche,04,Candelaria,04011,23038,22625,45663
2016,Campeche,04,Carmen,04003,127006,128327,255333
2016,Campeche,04,Champotón,04004,46658,46437,93095
2016,Campeche,04,Escárcega,04009,29648,30489,60137
2016,Campeche,04,Hecelchakán,04005,16182,16305,32487
2016,Campeche,04,Hopelchén,04006,21049,20218,41267
2016,Campeche,04,Palizada,04007,4762,4643,9405
2016,Campeche,04,Tenabo,04008,5705,5432,11137
2016,Chiapas,07,Acacoyagua,07001,9380,9310,18690
2016,Chiapas,07,Acala,07002,16189,16370,32559
2016,Chiapas,07,Acapetahua,07003,14829,14805,29634
2016,Chiapas,07,Aldama,07113,3194,3452,6646
2016,Chiapas,07,Altamirano,07004,16831,16628,33459
2016,Chiapas,07,Amatenango de la Frontera,07006,15587,16448,32035
2016,Chiapas,07,Amatenango del Valle,07007,4889,5257,10146
2016,Chiapas,07,Amatán,07005,10828,10523,21351
2016,Chiapas,07,Angel Albino Corzo,07008,14903,14895,29798
2016,Chiapas,07,Arriaga,07009,20842,22070,42912
2016,Chiapas,07,Bejucal de Ocampo,07010,3999,3955,7954
2016,Chiapas,07,Bella Vista,07011,10411,10592,21003
2016,Chiapas,07,Benemérito de las Américas,07114,10184,10013,20197
2016,Chiapas,07,Berriozábal,07012,25854,25845,51699
2016,Chiapas,07,Bochil,07013,17575,17866,35441
2016,Chiapas,07,Cacahoatán,07015,23474,24594,48068
2016,Chiapas,07,Catazajá,07016,9270,9019,18289
2016,Chiapas,07,Chalchihuitán,07022,8403,8531,16934
2016,Chiapas,07,Chamula,07023,41141,47329,88470
2016,Chiapas,07,Chanal,07024,6113,6177,12290
2016,Chiapas,07,Chapultenango,07025,3999,4005,8004
2016,Chiapas,07,Chenalhó,07026,19961,20382,40343
2016,Chiapas,07,Chiapa de Corzo,07027,50453,51987,102440
2016,Chiapas,07,Chiapilla,07028,3119,2980,6099
2016,Chiapas,07,Chicoasén,07029,2727,2706,5433
2016,Chiapas,07,Chicomuselo,07030,17695,17903,35598
2016,Chiapas,07,Chilón,07031,63846,65098,128944
2016,Chiapas,07,Cintalapa,07017,44118,44077,88195
2016,Chiapas,07,Coapilla,07018,4709,4792,9501
2016,Chiapas,07,Comitán de Domínguez,07019,76106,83064,159170
2016,Chiapas,07,Copainalá,07021,11331,11754,23085
2016,Chiapas,07,El Bosque,07014,10798,11554,22352
2016,Chiapas,07,El Porvenir,07070,7362,7374,14736
2016,Chiapas,07,Escuintla,07032,16249,16805,33054
2016,Chiapas,07,Francisco León,07033,3939,3844,7783
2016,Chiapas,07,Frontera Comalapa,07034,36518,38885,75403
2016,Chiapas,07,Frontera Hidalgo,07035,7174,7480,14654
2016,Chiapas,07,Huehuetán,07037,17796,18748,36544
2016,Chiapas,07,Huitiupán,07039,12159,12005,24164
2016,Chiapas,07,Huixtla,07040,27411,29285,56696
2016,Chiapas,07,Huixtán,07038,11852,12236,24088
2016,Chiapas,07,Ixhuatán,07042,5701,5851,11552
2016,Chiapas,07,Ixtacomitán,07043,5602,5687,11289
2016,Chiapas,07,Ixtapa,07044,13870,14036,27906
2016,Chiapas,07,Ixtapangajoya,07045,2903,2837,5740
2016,Chiapas,07,Jiquipilas,07046,20441,20925,41366
2016,Chiapas,07,Jitotol,07047,10624,10320,20944
2016,Chiapas,07,Juárez,07048,11211,11406,22617
2016,Chiapas,07,La Concordia,07020,24349,23987,48336
2016,Chiapas,07,La Grandeza,07036,3761,3818,7579
2016,Chiapas,07,La Independencia,07041,22746,23743,46489
2016,Chiapas,07,La Libertad,07050,2643,2713,5356
2016,Chiapas,07,La Trinitaria,07099,38819,40850,79669
2016,Chiapas,07,Larráinzar,07049,11702,12082,23784
2016,Chiapas,07,Las Margaritas,07052,62130,63370,125500
2016,Chiapas,07,Las Rosas,07075,14513,14794,29307
2016,Chiapas,07,Mapastepec,07051,24120,24851,48971
2016,Chiapas,07,Maravilla Tenejapa,07115,6657,6412,13069
2016,Chiapas,07,Marqués de Comillas,07116,5796,5632,11428
2016,Chiapas,07,Mazapa de Madero,07053,4032,4147,8179
2016,Chiapas,07,Mazatán,07054,14892,15212,30104
2016,Chiapas,07,Metapa,07055,2841,3032,5873
2016,Chiapas,07,Mitontic,07056,6128,6244,12372
2016,Chiapas,07,Montecristo de Guerrero,07117,4027,3897,7924
2016,Chiapas,07,Motozintla,07057,37104,38278,75382
2016,Chiapas,07,Nicolás Ruíz,07058,2333,2213,4546
2016,Chiapas,07,Ocosingo,07059,111195,111906,223101
2016,Chiapas,07,Ocotepec,07060,6418,6626,13044
2016,Chiapas,07,Ocozocoautla de Espinosa,07061,46574,47535,94109
2016,Chiapas,07,Ostuacán,07062,9577,9442,19019
2016,Chiapas,07,Osumacinta,07063,1989,1974,3963
2016,Chiapas,07,Oxchuc,07064,24675,24452,49127
2016,Chiapas,07,Palenque,07065,61058,62795,123853
2016,Chiapas,07,Pantelhó,07066,11347,11505,22852
2016,Chiapas,07,Pantepec,07067,6200,6260,12460
2016,Chiapas,07,Pichucalco,07068,16372,16645,33017
2016,Chiapas,07,Pijijiapan,07069,27457,28104,55561
2016,Chiapas,07,Pueblo Nuevo Solistahuacán,07072,16167,17347,33514
2016,Chiapas,07,Rayón,07073,4950,4996,9946
2016,Chiapas,07,Reforma,07074,22919,23319,46238
2016,Chiapas,07,Sabanilla,07076,14048,13899,27947
2016,Chiapas,07,Salto de Agua,07077,32385,32677,65062
2016,Chiapas,07,San Andrés Duraznal,07118,2624,2764,5388
2016,Chiapas,07,San Cristóbal de las Casas,07078,102823,112746,215569
2016,Chiapas,07,San Fernando,07079,19999,19626,39625
2016,Chiapas,07,San Juan Cancuc,07112,16922,17639,34561
2016,Chiapas,07,San Lucas,07110,3744,3727,7471
2016,Chiapas,07,Santiago el Pinar,07119,1881,1859,3740
2016,Chiapas,07,Siltepec,07080,19552,18955,38507
2016,Chiapas,07,Simojovel,07081,22189,22539,44728
2016,Chiapas,07,Sitalá,07082,7050,7116,14166
2016,Chiapas,07,Socoltenango,07083,9575,9670,19245
2016,Chiapas,07,Solosuchiapa,07084,4311,4299,8610
2016,Chiapas,07,Soyaló,07085,5562,5486,11048
2016,Chiapas,07,Suchiapa,07086,12318,12248,24566
2016,Chiapas,07,Suchiate,07087,19577,20393,39970
2016,Chiapas,07,Sunuapa,07088,1249,1203,2452
2016,Chiapas,07,Tapachula,07089,173391,187983,361374
2016,Chiapas,07,Tapalapa,07090,2047,2172,4219
2016,Chiapas,07,Tapilula,07091,6519,6799,13318
2016,Chiapas,07,Tecpatán,07092,21688,22009,43697
2016,Chiapas,07,Tenejapa,07093,22038,23138,45176
2016,Chiapas,07,Teopisca,07094,21287,22476,43763
2016,Chiapas,07,Tila,07096,40131,39965,80096
2016,Chiapas,07,Tonalá,07097,46220,47351,93571
2016,Chiapas,07,Totolapa,07098,3723,3701,7424
2016,Chiapas,07,Tumbalá,07100,17346,18073,35419
2016,Chiapas,07,Tuxtla Chico,07102,20960,22057,43017
2016,Chiapas,07,Tuxtla Gutiérrez,07101,298732,327035,625767
2016,Chiapas,07,Tuzantán,07103,15914,16387,32301
2016,Chiapas,07,Tzimol,07104,7783,8116,15899
2016,Chiapas,07,Unión Juárez,07105,7767,8168,15935
2016,Chiapas,07,Venustiano Carranza,07106,33891,33956,67847
2016,Chiapas,07,Villa Comaltitlán,07071,15030,15335,30365
2016,Chiapas,07,Villa Corzo,07107,40518,41689,82207
2016,Chiapas,07,Villaflores,07108,54043,56025,110068
2016,Chiapas,07,Yajalón,07109,19106,19880,38986
2016,Chiapas,07,Zinacantán,07111,19671,22222,41893
2016,Chihuahua,08,Ahumada,08001,6388,6186,12574
2016,Chihuahua,08,Aldama,08002,12283,12389,24672
2016,Chihuahua,08,Allende,08003,4573,4464,9037
2016,Chihuahua,08,Aquiles Serdán,08004,8650,8076,16726
2016,Chihuahua,08,Ascensión,08005,12945,12552,25497
2016,Chihuahua,08,Bachíniva,08006,3263,3124,6387
2016,Chihuahua,08,Balleza,08007,8912,8600,17512
2016,Chihuahua,08,Batopilas,08008,6581,6527,13108
2016,Chihuahua,08,Bocoyna,08009,14522,15037,29559
2016,Chihuahua,08,Buenaventura,08010,12046,11817,23863
2016,Chihuahua,08,Camargo,08011,25906,26793,52699
2016,Chihuahua,08,Carichí,08012,4753,4688,9441
2016,Chihuahua,08,Casas Grandes,08013,5804,5547,11351
2016,Chihuahua,08,Chihuahua,08019,437406,459753,897159
2016,Chihuahua,08,Chínipas,08020,4334,3919,8253
2016,Chihuahua,08,Coronado,08014,1168,1074,2242
2016,Chihuahua,08,Coyame del Sotol,08015,936,785,1721
2016,Chihuahua,08,Cuauhtémoc,08017,82345,87055,169400
2016,Chihuahua,08,Cusihuiriachi,08018,2600,2438,5038
2016,Chihuahua,08,Delicias,08021,73901,76980,150881
2016,Chihuahua,08,Dr. Belisario Domínguez,08022,1374,1338,2712
2016,Chihuahua,08,El Tule,08064,927,886,1813
2016,Chihuahua,08,Galeana,08023,3255,3256,6511
2016,Chihuahua,08,Gran Morelos,08026,1437,1378,2815
2016,Chihuahua,08,Guachochi,08027,23947,24767,48714
2016,Chihuahua,08,Guadalupe,08028,2946,2940,5886
2016,Chihuahua,08,Guadalupe y Calvo,08029,28768,28147,56915
2016,Chihuahua,08,Guazapares,08030,4298,4111,8409
2016,Chihuahua,08,Guerrero,08031,20532,20266,40798
2016,Chihuahua,08,Gómez Farías,08025,4532,4551,9083
2016,Chihuahua,08,Hidalgo del Parral,08032,55026,58393,113419
2016,Chihuahua,08,Huejotitán,08033,516,512,1028
2016,Chihuahua,08,Ignacio Zaragoza,08034,3637,3560,7197
2016,Chihuahua,08,Janos,08035,5799,5302,11101
2016,Chihuahua,08,Jiménez,08036,21897,22092,43989
2016,Chihuahua,08,Julimes,08038,2450,2342,4792
2016,Chihuahua,08,Juárez,08037,713499,711419,1424918
2016,Chihuahua,08,La Cruz,08016,2062,1963,4025
2016,Chihuahua,08,López,08039,2168,2009,4177
2016,Chihuahua,08,Madera,08040,15500,15217,30717
2016,Chihuahua,08,Maguarichi,08041,923,864,1787
2016,Chihuahua,08,Manuel Benavides,08042,824,696,1520
2016,Chihuahua,08,Matachí,08043,1600,1578,3178
2016,Chihuahua,08,Matamoros,08044,2354,2263,4617
2016,Chihuahua,08,Meoqui,08045,22982,23323,46305
2016,Chihuahua,08,Morelos,08046,4236,4142,8378
2016,Chihuahua,08,Moris,08047,2799,2592,5391
2016,Chihuahua,08,Namiquipa,08048,12248,11736,23984
2016,Chihuahua,08,Nonoava,08049,1427,1347,2774
2016,Chihuahua,08,Nuevo Casas Grandes,08050,31382,32703,64085
2016,Chihuahua,08,Ocampo,08051,4012,3650,7662
2016,Chihuahua,08,Ojinaga,08052,14133,13932,28065
2016,Chihuahua,08,Praxedis G. Guerrero,08053,2903,2825,5728
2016,Chihuahua,08,Riva Palacio,08054,4180,4030,8210
2016,Chihuahua,08,Rosales,08055,8897,8713,17610
2016,Chihuahua,08,Rosario,08056,1091,1061,2152
2016,Chihuahua,08,San Francisco de Borja,08057,1187,1129,2316
2016,Chihuahua,08,San Francisco de Conchos,08058,1434,1329,2763
2016,Chihuahua,08,San Francisco del Oro,08059,2598,2568,5166
2016,Chihuahua,08,Santa Bárbara,08060,5483,5538,11021
2016,Chihuahua,08,Santa Isabel,08024,2080,2097,4177
2016,Chihuahua,08,Satevó,08061,1796,1658,3454
2016,Chihuahua,08,Saucillo,08062,16349,16222,32571
2016,Chihuahua,08,Temósachic,08063,3426,3236,6662
2016,Chihuahua,08,Urique,08065,10887,10559,21446
2016,Chihuahua,08,Uruachi,08066,3552,3393,6945
2016,Chihuahua,08,Valle de Zaragoza,08067,2714,2596,5310
2016,Ciudad de México,09,Azcapotzalco,09002,196019,219370,415389
2016,Ciudad de México,09,Benito Juárez,09014,192168,226700,418868
2016,Ciudad de México,09,Coyoacán,09003,296282,333767,630049
2016,Ciudad de México,09,Cuajimalpa de Morelos,09004,94001,102328,196329
2016,Ciudad de México,09,Cuauhtémoc,09015,258136,286469,544605
2016,Ciudad de México,09,Gustavo A. Madero,09005,573884,619763,1193647
2016,Ciudad de México,09,Iztacalco,09006,188320,208474,396794
2016,Ciudad de México,09,Iztapalapa,09007,895968,947347,1843315
2016,Ciudad de México,09,La Magdalena Contreras,09008,117806,127297,245103
2016,Ciudad de México,09,Miguel Hidalgo,09016,173527,202198,375725
2016,Ciudad de México,09,Milpa Alta,09009,66775,69747,136522
2016,Ciudad de México,09,Tlalpan,09012,324463,352134,676597
2016,Ciudad de México,09,Tláhuac,09011,177178,190194,367372
2016,Ciudad de México,09,Venustiano Carranza,09017,207072,231598,438670
2016,Ciudad de México,09,Xochimilco,09013,207077,214468,421545
2016,Ciudad de México,09,Álvaro Obregón,09010,359325,394135,753460
2016,Coahuila,05,Abasolo,05001,549,542,1091
2016,Coahuila,05,Acuña,05002,78798,77349,156147
2016,Coahuila,05,Allende,05003,11777,12018,23795
2016,Coahuila,05,Arteaga,05004,12397,11774,24171
2016,Coahuila,05,Candela,05005,977,883,1860
2016,Coahuila,05,Castaños,05006,14459,14396,28855
2016,Coahuila,05,Cuatro Ciénegas,05007,7119,6918,14037
2016,Coahuila,05,Escobedo,05008,1622,1572,3194
2016,Coahuila,05,Francisco I. Madero,05009,30343,30334,60677
2016,Coahuila,05,Frontera,05010,41980,41472,83452
2016,Coahuila,05,General Cepeda,05011,6733,6156,12889
2016,Coahuila,05,Guerrero,05012,1042,904,1946
2016,Coahuila,05,Hidalgo,05013,943,890,1833
2016,Coahuila,05,Jiménez,05014,5464,5257,10721
2016,Coahuila,05,Juárez,05015,858,798,1656
2016,Coahuila,05,Lamadrid,05016,980,926,1906
2016,Coahuila,05,Matamoros,05017,57234,57024,114258
2016,Coahuila,05,Monclova,05018,119092,119793,238885
2016,Coahuila,05,Morelos,05019,4526,4383,8909
2016,Coahuila,05,Múzquiz,05020,36493,35682,72175
2016,Coahuila,05,Nadadores,05021,3473,3390,6863
2016,Coahuila,05,Nava,05022,16121,15273,31394
2016,Coahuila,05,Ocampo,05023,6106,5621,11727
2016,Coahuila,05,Parras,05024,24384,23290,47674
2016,Coahuila,05,Piedras Negras,05025,84982,84172,169154
2016,Coahuila,05,Progreso,05026,1841,1719,3560
2016,Coahuila,05,Ramos Arizpe,05027,47118,45330,92448
2016,Coahuila,05,Sabinas,05028,32997,32833,65830
2016,Coahuila,05,Sacramento,05029,1260,1216,2476
2016,Coahuila,05,Saltillo,05030,407445,408415,815860
2016,Coahuila,05,San Buenaventura,05031,12186,12143,24329
2016,Coahuila,05,San Juan de Sabinas,05032,22359,23010,45369
2016,Coahuila,05,San Pedro,05033,55388,55254,110642
2016,Coahuila,05,Sierra Mojada,05034,3657,3363,7020
2016,Coahuila,05,Torreón,05035,344538,358682,703220
2016,Coahuila,05,Viesca,05036,11464,11087,22551
2016,Coahuila,05,Villa Unión,05037,3437,3242,6679
2016,Coahuila,05,Zaragoza,05038,6960,6849,13809
2016,Colima,06,Armería,06001,15445,15349,30794
2016,Colima,06,Colima,06002,77823,82101,159924
2016,Colima,06,Comala,06003,11434,11353,22787
2016,Colima,06,Coquimatlán,06004,10619,10507,21126
2016,Colima,06,Cuauhtémoc,06005,15525,15521,31046
2016,Colima,06,Ixtlahuacán,06006,2902,2875,5777
2016,Colima,06,Manzanillo,06007,94664,93248,187912
2016,Colima,06,Minatitlán,06008,4754,4422,9176
2016,Colima,06,Tecomán,06009,63663,62844,126507
2016,Colima,06,Villa de Álvarez,06010,67995,71619,139614
2016,Durango,10,Canatlán,10001,16762,17042,33804
2016,Durango,10,Canelas,10002,2452,2237,4689
2016,Durango,10,Coneto de Comonfort,10003,2271,2325,4596
2016,Durango,10,Cuencamé,10004,18357,18085,36442
2016,Durango,10,Durango,10005,321887,341538,663425
2016,Durango,10,El Oro,10018,5941,6009,11950
2016,Durango,10,General Simón Bolívar,10006,5284,5372,10656
2016,Durango,10,Guadalupe Victoria,10008,18182,18563,36745
2016,Durango,10,Guanaceví,10009,5413,5076,10489
2016,Durango,10,Gómez Palacio,10007,177297,180022,357319
2016,Durango,10,Hidalgo,10010,2124,2063,4187
2016,Durango,10,Indé,10011,2632,2632,5264
2016,Durango,10,Lerdo,10012,78464,79086,157550
2016,Durango,10,Mapimí,10013,13610,13594,27204
2016,Durango,10,Mezquital,10014,19073,19661,38734
2016,Durango,10,Nazas,10015,6717,6756,13473
2016,Durango,10,Nombre de Dios,10016,10041,10150,20191
2016,Durango,10,Nuevo Ideal,10039,13930,14064,27994
2016,Durango,10,Ocampo,10017,5148,4917,10065
2016,Durango,10,Otáez,10019,2820,2639,5459
2016,Durango,10,Peñón Blanco,10021,5662,5614,11276
2016,Durango,10,Poanas,10022,12982,13354,26336
2016,Durango,10,Pueblo Nuevo,10023,26090,26222,52312
2016,Durango,10,Pánuco de Coronado,10020,6282,6469,12751
2016,Durango,10,Rodeo,10024,6904,6908,13812
2016,Durango,10,San Bernardo,10025,1844,1639,3483
2016,Durango,10,San Dimas,10026,10441,9792,20233
2016,Durango,10,San Juan de Guadalupe,10027,2932,3006,5938
2016,Durango,10,San Juan del Río,10028,6357,6511,12868
2016,Durango,10,San Luis del Cordero,10029,1116,1089,2205
2016,Durango,10,San Pedro del Gallo,10030,830,784,1614
2016,Durango,10,Santa Clara,10031,3647,3697,7344
2016,Durango,10,Santiago Papasquiaro,10032,24778,24717,49495
2016,Durango,10,Súchil,10033,3289,3552,6841
2016,Durango,10,Tamazula,10034,14455,13219,27674
2016,Durango,10,Tepehuanes,10035,5750,5816,11566
2016,Durango,10,Tlahualilo,10036,11948,11761,23709
2016,Durango,10,Topia,10037,4864,4596,9460
2016,Durango,10,Vicente Guerrero,10038,11086,11724,22810
2016,Estado de México,15,Acambay de Ruíz Castañeda,15001,32388,34473,66861
2016,Estado de México,15,Acolman,15002,83480,83154,166634
2016,Estado de México,15,Aculco,15003,24430,25176,49606
2016,Estado de México,15,Almoloya de Alquisiras,15004,7387,8084,15471
2016,Estado de México,15,Almoloya de Juárez,15005,86094,88140,174234
2016,Estado de México,15,Almoloya del Río,15006,5542,5981,11523
2016,Estado de México,15,Amanalco,15007,12178,12660,24838
2016,Estado de México,15,Amatepec,15008,13609,14488,28097
2016,Estado de México,15,Amecameca,15009,25568,27394,52962
2016,Estado de México,15,Apaxco,15010,14903,15295,30198
2016,Estado de México,15,Atenco,15011,31888,32462,64350
2016,Estado de México,15,Atizapán,15012,5715,6047,11762
2016,Estado de México,15,Atizapán de Zaragoza,15013,263614,278659,542273
2016,Estado de México,15,Atlacomulco,15014,48744,52806,101550
2016,Estado de México,15,Atlautla,15015,15145,15926,31071
2016,Estado de México,15,Axapusco,15016,14023,14201,28224
2016,Estado de México,15,Ayapango,15017,4973,5168,10141
2016,Estado de México,15,Calimaya,15018,27127,28600,55727
2016,Estado de México,15,Capulhuac,15019,17837,18811,36648
2016,Estado de México,15,Chalco,15025,175093,183519,358612
2016,Estado de México,15,Chapa de Mota,15026,14135,14665,28800
2016,Estado de México,15,Chapultepec,15027,5722,5978,11700
2016,Estado de México,15,Chiautla,15028,14508,15103,29611
2016,Estado de México,15,Chicoloapan,15029,100718,106390,207108
2016,Estado de México,15,Chiconcuac,15030,12652,13093,25745
2016,Estado de México,15,Chimalhuacán,15031,337517,349678,687195
2016,Estado de México,15,Coacalco de Berriozábal,15020,147058,157470,304528
2016,Estado de México,15,Coatepec Harinas,15021,19139,20739,39878
2016,Estado de México,15,Cocotitlán,15022,7085,7401,14486
2016,Estado de México,15,Coyotepec,15023,21286,21711,42997
2016,Estado de México,15,Cuautitlán,15024,79400,81466,160866
2016,Estado de México,15,Cuautitlán Izcalli,15121,272612,286689,559301
2016,Estado de México,15,Donato Guerra,15032,17150,17654,34804
2016,Estado de México,15,Ecatepec de Morelos,15033,830198,849915,1680113
2016,Estado de México,15,Ecatzingo,15034,4793,4935,9728
2016,Estado de México,15,El Oro,15064,18365,19444,37809
2016,Estado de México,15,Huehuetoca,15035,63775,65808,129583
2016,Estado de México,15,Hueypoxtla,15036,22293,22082,44375
2016,Estado de México,15,Huixquilucan,15037,131944,142404,274348
2016,Estado de México,15,Isidro Fabela,15038,5804,5935,11739
2016,Estado de México,15,Ixtapaluca,15039,253925,264090,518015
2016,Estado de México,15,Ixtapan de la Sal,15040,17501,18968,36469
2016,Estado de México,15,Ixtapan del Oro,15041,3555,3481,7036
2016,Estado de México,15,Ixtlahuaca,15042,74881,80174,155055
2016,Estado de México,15,Jaltenco,15044,14153,14957,29110
2016,Estado de México,15,Jilotepec,15045,44263,45730,89993
2016,Estado de México,15,Jilotzingo,15046,9568,10081,19649
2016,Estado de México,15,Jiquipilco,15047,36360,38727,75087
2016,Estado de México,15,Jocotitlán,15048,32410,34612,67022
2016,Estado de México,15,Joquicingo,15049,6806,7202,14008
2016,Estado de México,15,Juchitepec,15050,12724,13127,25851
2016,Estado de México,15,La Paz,15070,144441,148616,293057
2016,Estado de México,15,Lerma,15051,73418,75460,148878
2016,Estado de México,15,Luvianos,15123,14382,14768,29150
2016,Estado de México,15,Malinalco,15052,13780,14283,28063
2016,Estado de México,15,Melchor Ocampo,15053,27677,28908,56585
2016,Estado de México,15,Metepec,15054,114971,122427,237398
2016,Estado de México,15,Mexicaltzingo,15055,6265,6680,12945
2016,Estado de México,15,Morelos,15056,14691,15998,30689
2016,Estado de México,15,Naucalpan de Juárez,15057,431906,457927,889833
2016,Estado de México,15,Nextlalpan,15059,19478,19998,39476
2016,Estado de México,15,Nezahualcóyotl,15058,546570,585278,1131848
2016,Estado de México,15,Nicolás Romero,15060,201968,209771,411739
2016,Estado de México,15,Nopaltepec,15061,4699,4711,9410
2016,Estado de México,15,Ocoyoacac,15062,33343,34466,67809
2016,Estado de México,15,Ocuilan,15063,16938,17647,34585
2016,Estado de México,15,Otumba,15065,18331,18154,36485
2016,Estado de México,15,Otzoloapan,15066,2224,2193,4417
2016,Estado de México,15,Otzolotepec,15067,42108,43372,85480
2016,Estado de México,15,Ozumba,15068,14262,15432,29694
2016,Estado de México,15,Papalotla,15069,2068,2182,4250
2016,Estado de México,15,Polotitlán,15071,7013,7312,14325
2016,Estado de México,15,Rayón,15072,6749,6976,13725
2016,Estado de México,15,San Antonio la Isla,15073,13766,14211,27977
2016,Estado de México,15,San Felipe del Progreso,15074,66080,73489,139569
2016,Estado de México,15,San José del Rincón,15124,47396,48109,95505
2016,Estado de México,15,San Martín de las Pirámides,15075,13578,13922,27500
2016,Estado de México,15,San Mateo Atenco,15076,38247,39609,77856
2016,Estado de México,15,San Simón de Guerrero,15077,3079,3275,6354
2016,Estado de México,15,Santo Tomás,15078,4891,5046,9937
2016,Estado de México,15,Soyaniquilpan de Juárez,15079,6654,6800,13454
2016,Estado de México,15,Sultepec,15080,13078,14521,27599
2016,Estado de México,15,Tecámac,15081,218277,229420,447697
2016,Estado de México,15,Tejupilco,15082,38099,41276,79375
2016,Estado de México,15,Temamatla,15083,6283,6636,12919
2016,Estado de México,15,Temascalapa,15084,19827,19896,39723
2016,Estado de México,15,Temascalcingo,15085,31612,34152,65764
2016,Estado de México,15,Temascaltepec,15086,16410,17033,33443
2016,Estado de México,15,Temoaya,15087,49820,52683,102503
2016,Estado de México,15,Tenancingo,15088,48430,51234,99664
2016,Estado de México,15,Tenango del Aire,15089,6119,6303,12422
2016,Estado de México,15,Tenango del Valle,15090,42580,44466,87046
2016,Estado de México,15,Teoloyucan,15091,34711,35319,70030
2016,Estado de México,15,Teotihuacán,15092,28651,29513,58164
2016,Estado de México,15,Tepetlaoxtoc,15093,15479,15842,31321
2016,Estado de México,15,Tepetlixpa,15094,9980,10292,20272
2016,Estado de México,15,Tepotzotlán,15095,47799,49503,97302
2016,Estado de México,15,Tequixquiac,15096,18682,18981,37663
2016,Estado de México,15,Texcaltitlán,15097,9297,9976,19273
2016,Estado de México,15,Texcalyacac,15098,2684,2767,5451
2016,Estado de México,15,Texcoco,15099,122875,128783,251658
2016,Estado de México,15,Tezoyuca,15100,20842,21186,42028
2016,Estado de México,15,Tianguistenco,15101,38103,40252,78355
2016,Estado de México,15,Timilpan,15102,7866,8461,16327
2016,Estado de México,15,Tlalmanalco,15103,24026,25709,49735
2016,Estado de México,15,Tlalnepantla de Baz,15104,356160,379846,736006
2016,Estado de México,15,Tlatlaya,15105,17736,18637,36373
2016,Estado de México,15,Toluca,15106,435154,466120,901274
2016,Estado de México,15,Tonanitla,15125,5228,5371,10599
2016,Estado de México,15,Tonatico,15107,6265,6713,12978
2016,Estado de México,15,Tultepec,15108,73715,76745,150460
2016,Estado de México,15,Tultitlán,15109,265028,275103,540131
2016,Estado de México,15,Valle de Bravo,15110,33148,34501,67649
2016,Estado de México,15,Valle de Chalco Solidaridad,15122,196798,203134,399932
2016,Estado de México,15,Villa Guerrero,15113,33070,34352,67422
2016,Estado de México,15,Villa Victoria,15114,51349,52050,103399
2016,Estado de México,15,Villa de Allende,15111,25696,26602,52298
2016,Estado de México,15,Villa del Carbón,15112,24224,24026,48250
2016,Estado de México,15,Xalatlaco,15043,14481,15304,29785
2016,Estado de México,15,Xonacatlán,15115,26157,26234,52391
2016,Estado de México,15,Zacazonapan,15116,2151,2131,4282
2016,Estado de México,15,Zacualpan,15117,7461,8208,15669
2016,Estado de México,15,Zinacantepec,15118,92564,95375,187939
2016,Estado de México,15,Zumpahuacán,15119,8389,9139,17528
2016,Estado de México,15,Zumpango,15120,95382,102238,197620
2016,Guanajuato,11,Abasolo,11001,44738,47855,92593
2016,Guanajuato,11,Acámbaro,11002,55818,60543,116361
2016,Guanajuato,11,Apaseo el Alto,11004,34158,35801,69959
2016,Guanajuato,11,Apaseo el Grande,11005,45714,48427,94141
2016,Guanajuato,11,Atarjea,11006,2699,2802,5501
2016,Guanajuato,11,Celaya,11007,248586,262264,510850
2016,Guanajuato,11,Comonfort,11009,40035,44323,84358
2016,Guanajuato,11,Coroneo,11010,5984,6602,12586
2016,Guanajuato,11,Cortazar,11011,47765,50387,98152
2016,Guanajuato,11,Cuerámaro,11012,13969,15117,29086
2016,Guanajuato,11,Doctor Mora,11013,12030,12869,24899
2016,Guanajuato,11,Dolores Hidalgo Cuna de la Independencia Nacional,11014,74671,82347,157018
2016,Guanajuato,11,Guanajuato,11015,93154,96536,189690
2016,Guanajuato,11,Huanímaro,11016,10407,11574,21981
2016,Guanajuato,11,Irapuato,11017,285560,299567,585127
2016,Guanajuato,11,Jaral del Progreso,11018,19290,20204,39494
2016,Guanajuato,11,Jerécuaro,11019,24105,27219,51324
2016,Guanajuato,11,León,11020,798690,808636,1607326
2016,Guanajuato,11,Manuel Doblado,11008,18869,20877,39746
2016,Guanajuato,11,Moroleón,11021,25268,27645,52913
2016,Guanajuato,11,Ocampo,11022,11653,12430,24083
2016,Guanajuato,11,Pueblo Nuevo,11024,5714,6399,12113
2016,Guanajuato,11,Purísima del Rincón,11025,39920,39982,79902
2016,Guanajuato,11,Pénjamo,11023,74953,82067,157020
2016,Guanajuato,11,Romita,11026,29511,31440,60951
2016,Guanajuato,11,Salamanca,11027,138122,144861,282983
2016,Guanajuato,11,Salvatierra,11028,49740,54591,104331
2016,Guanajuato,11,San Diego de la Unión,11029,18869,21431,40300
2016,Guanajuato,11,San Felipe,11030,55715,59092,114807
2016,Guanajuato,11,San Francisco del Rincón,11031,59952,62683,122635
2016,Guanajuato,11,San José Iturbide,11032,38452,40852,79304
2016,Guanajuato,11,San Luis de la Paz,11033,59052,64513,123565
2016,Guanajuato,11,San Miguel de Allende,11003,84346,90905,175251
2016,Guanajuato,11,Santa Catarina,11034,2595,2824,5419
2016,Guanajuato,11,Santa Cruz de Juventino Rosas,11035,41286,44156,85442
2016,Guanajuato,11,Santiago Maravatío,11036,3345,3742,7087
2016,Guanajuato,11,Silao de la Victoria,11037,94492,96695,191187
2016,Guanajuato,11,Tarandacuao,11038,5955,6553,12508
2016,Guanajuato,11,Tarimoro,11039,17484,18777,36261
2016,Guanajuato,11,Tierra Blanca,11040,9441,9993,19434
2016,Guanajuato,11,Uriangato,11041,31362,33386,64748
2016,Guanajuato,11,Valle de Santiago,11042,70946,77824,148770
2016,Guanajuato,11,Victoria,11043,10006,10970,20976
2016,Guanajuato,11,Villagrán,11044,29634,30936,60570
2016,Guanajuato,11,Xichú,11045,5781,6227,12008
2016,Guanajuato,11,Yuriria,11046,34526,38201,72727
2016,Guerrero,12,Acapulco de Juárez,12001,399578,428611,828189
2016,Guerrero,12,Acatepec,12076,18469,19354,37823
2016,Guerrero,12,Ahuacuotzingo,12002,12490,14211,26701
2016,Guerrero,12,Ajuchitlán del Progreso,12003,18934,20362,39296
2016,Guerrero,12,Alcozauca de Guerrero,12004,9159,10389,19548
2016,Guerrero,12,Alpoyeca,12005,3197,3624,6821
2016,Guerrero,12,Apaxtla,12006,5730,6214,11944
2016,Guerrero,12,Arcelia,12007,15919,16902,32821
2016,Guerrero,12,Atenango del Río,12008,4195,4618,8813
2016,Guerrero,12,Atlamajalcingo del Monte,12009,2616,2866,5482
2016,Guerrero,12,Atlixtac,12010,13246,14202,27448
2016,Guerrero,12,Atoyac de Álvarez,12011,30771,31956,62727
2016,Guerrero,12,Ayutla de los Libres,12012,33550,34907,68457
2016,Guerrero,12,Azoyú,12013,7164,7597,14761
2016,Guerrero,12,Benito Juárez,12014,7728,8118,15846
2016,Guerrero,12,Buenavista de Cuéllar,12015,6620,6994,13614
2016,Guerrero,12,Chilapa de Álvarez,12028,61531,67841,129372
2016,Guerrero,12,Chilpancingo de los Bravo,12029,130583,142090,272673
2016,Guerrero,12,Coahuayutla de José María Izazaga,12016,6671,6461,13132
2016,Guerrero,12,Cochoapa el Grande,12078,9103,10046,19149
2016,Guerrero,12,Cocula,12017,6856,7434,14290
2016,Guerrero,12,Copala,12018,7048,7321,14369
2016,Guerrero,12,Copalillo,12019,7138,7881,15019
2016,Guerrero,12,Copanatoyac,12020,9657,10507,20164
2016,Guerrero,12,Coyuca de Benítez,12021,38212,39729,77941
2016,Guerrero,12,Coyuca de Catalán,12022,20872,20643,41515
2016,Guerrero,12,Cuajinicuilapa,12023,13679,13751,27430
2016,Guerrero,12,Cualác,12024,3676,3973,7649
2016,Guerrero,12,Cuautepec,12025,8191,8225,16416
2016,Guerrero,12,Cuetzala del Progreso,12026,4396,4668,9064
2016,Guerrero,12,Cutzamala de Pinzón,12027,10171,10685,20856
2016,Guerrero,12,Eduardo Neri,12075,24934,26071,51005
2016,Guerrero,12,Florencio Villarreal,12030,10479,10749,21228
2016,Guerrero,12,General Canuto A. Neri,12031,2919,3184,6103
2016,Guerrero,12,General Heliodoro Castillo,12032,18884,18855,37739
2016,Guerrero,12,Huamuxtitlán,12033,7281,8243,15524
2016,Guerrero,12,Huitzuco de los Figueroa,12034,18370,20067,38437
2016,Guerrero,12,Iguala de la Independencia,12035,74175,79724,153899
2016,Guerrero,12,Igualapa,12036,5647,5860,11507
2016,Guerrero,12,Iliatenco,12081,5332,5837,11169
2016,Guerrero,12,Ixcateopan de Cuauhtémoc,12037,3069,3421,6490
2016,Guerrero,12,José Joaquín de Herrera,12079,8616,8800,17416
2016,Guerrero,12,Juan R. Escudero,12039,12375,13118,25493
2016,Guerrero,12,Juchitán,12080,3857,3844,7701
2016,Guerrero,12,La Unión de Isidoro Montes de Oca,12068,13784,13290,27074
2016,Guerrero,12,Leonardo Bravo,12040,13040,13368,26408
2016,Guerrero,12,Malinaltepec,12041,13736,15191,28927
2016,Guerrero,12,Marquelia,12077,6929,7021,13950
2016,Guerrero,12,Metlatónoc,12043,9481,10827,20308
2016,Guerrero,12,Mochitlán,12044,6234,6497,12731
2016,Guerrero,12,Mártir de Cuilapan,12042,8874,9726,18600
2016,Guerrero,12,Olinalá,12045,12436,13442,25878
2016,Guerrero,12,Ometepec,12046,32911,34536,67447
2016,Guerrero,12,Pedro Ascencio Alquisiras,12047,3284,3847,7131
2016,Guerrero,12,Petatlán,12048,22803,23152,45955
2016,Guerrero,12,Pilcaya,12049,6245,6666,12911
2016,Guerrero,12,Pungarabato,12050,18910,20082,38992
2016,Guerrero,12,Quechultenango,12051,17819,18727,36546
2016,Guerrero,12,San Luis Acatlán,12052,22076,22630,44706
2016,Guerrero,12,San Marcos,12053,24724,25716,50440
2016,Guerrero,12,San Miguel Totolapan,12054,14045,14507,28552
2016,Guerrero,12,Taxco de Alarcón,12055,53534,57713,111247
2016,Guerrero,12,Tecoanapa,12056,23288,23909,47197
2016,Guerrero,12,Teloloapan,12058,27306,30696,58002
2016,Guerrero,12,Tepecoacuilco de Trujano,12059,15456,16844,32300
2016,Guerrero,12,Tetipac,12060,7069,7499,14568
2016,Guerrero,12,Tixtla de Guerrero,12061,20842,22501,43343
2016,Guerrero,12,Tlacoachistlahuaca,12062,10891,12172,23063
2016,Guerrero,12,Tlacoapa,12063,4804,5307,10111
2016,Guerrero,12,Tlalchapa,12064,6207,6292,12499
2016,Guerrero,12,Tlalixtaquilla de Maldonado,12065,3569,3900,7469
2016,Guerrero,12,Tlapa de Comonfort,12066,42214,46646,88860
2016,Guerrero,12,Tlapehuala,12067,10962,11800,22762
2016,Guerrero,12,Técpan de Galeana,12057,32700,33239,65939
2016,Guerrero,12,Xalpatláhuac,12069,5727,6610,12337
2016,Guerrero,12,Xochihuehuetlán,12070,3446,3978,7424
2016,Guerrero,12,Xochistlahuaca,12071,14325,15153,29478
2016,Guerrero,12,Zapotitlán Tablas,12072,5444,6009,11453
2016,Guerrero,12,Zihuatanejo de Azueta,12038,62965,64444,127409
2016,Guerrero,12,Zirándaro,12073,9676,9376,19052
2016,Guerrero,12,Zitlala,12074,10963,12238,23201
2016,Hidalgo,13,Acatlán,13001,10377,11120,21497
2016,Hidalgo,13,Acaxochitlán,13002,21279,22930,44209
2016,Hidalgo,13,Actopan,13003,27817,30922,58739
2016,Hidalgo,13,Agua Blanca de Iturbide,13004,4525,4961,9486
2016,Hidalgo,13,Ajacuba,13005,9280,9740,19020
2016,Hidalgo,13,Alfajayucan,13006,10166,10779,20945
2016,Hidalgo,13,Almoloya,13007,6288,6363,12651
2016,Hidalgo,13,Apan,13008,22240,24110,46350
2016,Hidalgo,13,Atitalaquia,13010,15122,15422,30544
2016,Hidalgo,13,Atlapexco,13011,10137,10856,20993
2016,Hidalgo,13,Atotonilco de Tula,13013,18525,19585,38110
2016,Hidalgo,13,Atotonilco el Grande,13012,13399,15072,28471
2016,Hidalgo,13,Calnali,13014,8748,9355,18103
2016,Hidalgo,13,Cardonal,13015,9180,9964,19144
2016,Hidalgo,13,Chapantongo,13017,6826,7152,13978
2016,Hidalgo,13,Chapulhuacán,13018,12347,12183,24530
2016,Hidalgo,13,Chilcuautla,13019,9191,9592,18783
2016,Hidalgo,13,Cuautepec de Hinojosa,13016,28347,31002,59349
2016,Hidalgo,13,El Arenal,13009,9168,9992,19160
2016,Hidalgo,13,Eloxochitlán,13020,1343,1526,2869
2016,Hidalgo,13,Emiliano Zapata,13021,7194,7894,15088
2016,Hidalgo,13,Epazoyucan,13022,7362,7786,15148
2016,Hidalgo,13,Francisco I. Madero,13023,17668,19336,37004
2016,Hidalgo,13,Huasca de Ocampo,13024,8766,9584,18350
2016,Hidalgo,13,Huautla,13025,11131,11991,23122
2016,Hidalgo,13,Huazalingo,13026,7002,7299,14301
2016,Hidalgo,13,Huehuetla,13027,12866,13599,26465
2016,Hidalgo,13,Huejutla de Reyes,13028,66400,68408,134808
2016,Hidalgo,13,Huichapan,13029,22875,24945,47820
2016,Hidalgo,13,Ixmiquilpan,13030,44819,50184,95003
2016,Hidalgo,13,Jacala de Ledezma,13031,6610,7352,13962
2016,Hidalgo,13,Jaltocán,13032,6043,6204,12247
2016,Hidalgo,13,Juárez Hidalgo,13033,1596,1713,3309
2016,Hidalgo,13,La Misión,13040,5317,5469,10786
2016,Hidalgo,13,Lolotla,13034,4968,5186,10154
2016,Hidalgo,13,Metepec,13035,5668,6391,12059
2016,Hidalgo,13,Metztitlán,13037,10329,11501,21830
2016,Hidalgo,13,Mineral de la Reforma,13051,78317,85652,163969
2016,Hidalgo,13,Mineral del Chico,13038,4388,4655,9043
2016,Hidalgo,13,Mineral del Monte,13039,7141,7892,15033
2016,Hidalgo,13,Mixquiahuala de Juárez,13041,22731,24676,47407
2016,Hidalgo,13,Molango de Escamilla,13042,5940,6162,12102
2016,Hidalgo,13,Nicolás Flores,13043,3390,3795,7185
2016,Hidalgo,13,Nopala de Villagrán,13044,8610,8888,17498
2016,Hidalgo,13,Omitlán de Juárez,13045,4755,5212,9967
2016,Hidalgo,13,Pachuca de Soto,13048,131739,143877,275616
2016,Hidalgo,13,Pacula,13047,2455,2834,5289
2016,Hidalgo,13,Pisaflores,13049,9296,9256,18552
2016,Hidalgo,13,Progreso de Obregón,13050,11485,12771,24256
2016,Hidalgo,13,San Agustín Metzquititlán,13036,4761,5228,9989
2016,Hidalgo,13,San Agustín Tlaxiaca,13052,17874,18683,36557
2016,Hidalgo,13,San Bartolo Tutotepec,13053,9762,9896,19658
2016,Hidalgo,13,San Felipe Orizatlán,13046,20356,20849,41205
2016,Hidalgo,13,San Salvador,13054,17511,18739,36250
2016,Hidalgo,13,Santiago Tulantepec de Lugo Guerrero,13056,18127,19813,37940
2016,Hidalgo,13,Santiago de Anaya,13055,8526,8987,17513
2016,Hidalgo,13,Singuilucan,13057,8141,8393,16534
2016,Hidalgo,13,Tasquillo,13058,7991,9384,17375
2016,Hidalgo,13,Tecozautla,13059,18481,20200,38681
2016,Hidalgo,13,Tenango de Doria,13060,9078,9926,19004
2016,Hidalgo,13,Tepeapulco,13061,27512,29380,56892
2016,Hidalgo,13,Tepehuacán de Guerrero,13062,16138,15547,31685
2016,Hidalgo,13,Tepeji del Río de Ocampo,13063,43990,45312,89302
2016,Hidalgo,13,Tepetitlán,13064,5452,5754,11206
2016,Hidalgo,13,Tetepango,13065,5974,6048,12022
2016,Hidalgo,13,Tezontepec de Aldama,13067,26632,27266,53898
2016,Hidalgo,13,Tianguistengo,13068,7576,7937,15513
2016,Hidalgo,13,Tizayuca,13069,60198,61747,121945
2016,Hidalgo,13,Tlahuelilpan,13070,9644,9972,19616
2016,Hidalgo,13,Tlahuiltepa,13071,5278,5381,10659
2016,Hidalgo,13,Tlanalapa,13072,5229,5563,10792
2016,Hidalgo,13,Tlanchinol,13073,20042,20407,40449
2016,Hidalgo,13,Tlaxcoapan,13074,14542,14977,29519
2016,Hidalgo,13,Tolcayuca,13075,8031,8502,16533
2016,Hidalgo,13,Tula de Allende,13076,55312,58341,113653
2016,Hidalgo,13,Tulancingo de Bravo,13077,76312,84883,161195
2016,Hidalgo,13,Villa de Tezontepec,13066,6316,6518,12834
2016,Hidalgo,13,Xochiatipan,13078,10042,10533,20575
2016,Hidalgo,13,Xochicoatlán,13079,3945,4062,8007
2016,Hidalgo,13,Yahualica,13080,12393,12887,25280
2016,Hidalgo,13,Zacualtipán de Ángeles,13081,16887,18538,35425
2016,Hidalgo,13,Zapotlán de Juárez,13082,9449,10181,19630
2016,Hidalgo,13,Zempoala,13083,22286,23524,45810
2016,Hidalgo,13,Zimapán,13084,19145,22161,41306
2016,Jalisco,14,Acatic,14001,10887,11343,22230
2016,Jalisco,14,Acatlán de Juárez,14002,12423,11436,23859
2016,Jalisco,14,Ahualulco de Mercado,14003,11841,12189,24030
2016,Jalisco,14,Amacueca,14004,2773,2930,5703
2016,Jalisco,14,Amatitán,14005,7879,7936,15815
2016,Jalisco,14,Ameca,14006,30717,31930,62647
2016,Jalisco,14,Arandas,14008,38682,41483,80165
2016,Jalisco,14,Atemajac de Brizuela,14010,3466,3508,6974
2016,Jalisco,14,Atengo,14011,2956,2748,5704
2016,Jalisco,14,Atenguillo,14012,2069,2141,4210
2016,Jalisco,14,Atotonilco el Alto,14013,30484,31661,62145
2016,Jalisco,14,Atoyac,14014,4142,4486,8628
2016,Jalisco,14,Autlán de Navarro,14015,30912,31772,62684
2016,Jalisco,14,Ayotlán,14016,19388,20314,39702
2016,Jalisco,14,Ayutla,14017,6553,6572,13125
2016,Jalisco,14,Bolaños,14019,3769,3786,7555
2016,Jalisco,14,Cabo Corrientes,14020,5568,5110,10678
2016,Jalisco,14,Casimiro Castillo,14021,11186,11233,22419
2016,Jalisco,14,Cañadas de Obregón,14117,2097,2224,4321
2016,Jalisco,14,Chapala,14030,25769,26780,52549
2016,Jalisco,14,Chimaltitán,14031,1790,1834,3624
2016,Jalisco,14,Chiquilistlán,14032,3122,3099,6221
2016,Jalisco,14,Cihuatlán,14022,21146,20591,41737
2016,Jalisco,14,Cocula,14024,13570,14306,27876
2016,Jalisco,14,Colotlán,14025,9070,9698,18768
2016,Jalisco,14,Concepción de Buenos Aires,14026,3208,3098,6306
2016,Jalisco,14,Cuautitlán de García Barragán,14027,9481,9158,18639
2016,Jalisco,14,Cuautla,14028,1077,1160,2237
2016,Jalisco,14,Cuquío,14029,8948,9766,18714
2016,Jalisco,14,Degollado,14033,10701,11479,22180
2016,Jalisco,14,Ejutla,14034,1042,990,2032
2016,Jalisco,14,El Arenal,14009,9815,10009,19824
2016,Jalisco,14,El Grullo,14037,12428,12965,25393
2016,Jalisco,14,El Limón,14054,2880,2879,5759
2016,Jalisco,14,El Salto,14070,90919,91811,182730
2016,Jalisco,14,Encarnación de Díaz,14035,26556,28605,55161
2016,Jalisco,14,Etzatlán,14036,9997,10374,20371
2016,Jalisco,14,Guachinango,14038,2261,2184,4445
2016,Jalisco,14,Guadalajara,14039,732907,770560,1503467
2016,Jalisco,14,Gómez Farías,14079,7170,7645,14815
2016,Jalisco,14,Hostotipaquillo,14040,5632,4904,10536
2016,Jalisco,14,Huejuquilla el Alto,14042,4370,4751,9121
2016,Jalisco,14,Huejúcar,14041,2857,3157,6014
2016,Jalisco,14,Ixtlahuacán de los Membrillos,14044,26285,26926,53211
2016,Jalisco,14,Ixtlahuacán del Río,14045,9647,10274,19921
2016,Jalisco,14,Jalostotitlán,14046,16960,17559,34519
2016,Jalisco,14,Jamay,14047,12640,12662,25302
2016,Jalisco,14,Jesús María,14048,9152,10765,19917
2016,Jalisco,14,Jilotlán de los Dolores,14049,5137,4917,10054
2016,Jalisco,14,Jocotepec,14050,23332,23611,46943
2016,Jalisco,14,Juanacatlán,14051,8887,8907,17794
2016,Jalisco,14,Juchitlán,14052,2830,3029,5859
2016,Jalisco,14,La Barca,14018,32862,35049,67911
2016,Jalisco,14,La Huerta,14043,12712,12333,25045
2016,Jalisco,14,La Manzanilla de la Paz,14057,1888,2051,3939
2016,Jalisco,14,Lagos de Moreno,14053,82161,85965,168126
2016,Jalisco,14,Magdalena,14055,11505,11576,23081
2016,Jalisco,14,Mascota,14058,7425,7663,15088
2016,Jalisco,14,Mazamitla,14059,6820,7399,14219
2016,Jalisco,14,Mexticacán,14060,2611,3073,5684
2016,Jalisco,14,Mezquitic,14061,9538,10053,19591
2016,Jalisco,14,Mixtlán,14062,1852,1841,3693
2016,Jalisco,14,Ocotlán,14063,50432,51964,102396
2016,Jalisco,14,Ojuelos de Jalisco,14064,16051,16777,32828
2016,Jalisco,14,Pihuamo,14065,6031,5962,11993
2016,Jalisco,14,Poncitlán,14066,26107,26759,52866
2016,Jalisco,14,Puerto Vallarta,14067,143134,139631,282765
2016,Jalisco,14,Quitupan,14069,4157,4665,8822
2016,Jalisco,14,San Cristóbal de la Barranca,14071,1597,1630,3227
2016,Jalisco,14,San Diego de Alejandría,14072,3542,3841,7383
2016,Jalisco,14,San Gabriel,14113,8071,8425,16496
2016,Jalisco,14,San Ignacio Cerro Gordo,14125,9409,9960,19369
2016,Jalisco,14,San Juan de los Lagos,14073,35089,35755,70844
2016,Jalisco,14,San Juanito de Escobedo,14007,4852,4790,9642
2016,Jalisco,14,San Julián,14074,7715,8591,16306
2016,Jalisco,14,San Marcos,14075,2009,1943,3952
2016,Jalisco,14,San Martín Hidalgo,14077,13872,14608,28480
2016,Jalisco,14,San Martín de Bolaños,14076,1676,1649,3325
2016,Jalisco,14,San Miguel el Alto,14078,16310,17265,33575
2016,Jalisco,14,San Pedro Tlaquepaque,14098,337188,339516,676704
2016,Jalisco,14,San Sebastián del Oeste,14080,3097,2830,5927
2016,Jalisco,14,Santa María de los Ángeles,14081,1632,1824,3456
2016,Jalisco,14,Santa María del Oro,14056,1167,1157,2324
2016,Jalisco,14,Sayula,14082,18426,19715,38141
2016,Jalisco,14,Tala,14083,39464,40062,79526
2016,Jalisco,14,Talpa de Allende,14084,7830,7719,15549
2016,Jalisco,14,Tamazula de Gordiano,14085,19618,20494,40112
2016,Jalisco,14,Tapalpa,14086,9697,10061,19758
2016,Jalisco,14,Tecalitlán,14087,8533,8896,17429
2016,Jalisco,14,Techaluta de Montenegro,14089,1861,1930,3791
2016,Jalisco,14,Tecolotlán,14088,8904,8870,17774
2016,Jalisco,14,Tenamaxtlán,14090,3718,3695,7413
2016,Jalisco,14,Teocaltiche,14091,20308,22360,42668
2016,Jalisco,14,Teocuitatlán de Corona,14092,5384,5612,10996
2016,Jalisco,14,Tepatitlán de Morelos,14093,71766,74523,146289
2016,Jalisco,14,Tequila,14094,21678,21837,43515
2016,Jalisco,14,Teuchitlán,14095,4798,5021,9819
2016,Jalisco,14,Tizapán el Alto,14096,10640,11177,21817
2016,Jalisco,14,Tlajomulco de Zúñiga,14097,278324,283059,561383
2016,Jalisco,14,Tolimán,14099,5181,5295,10476
2016,Jalisco,14,Tomatlán,14100,18948,17983,36931
2016,Jalisco,14,Tonalá,14101,273596,271453,545049
2016,Jalisco,14,Tonaya,14102,3050,3173,6223
2016,Jalisco,14,Tonila,14103,4030,4081,8111
2016,Jalisco,14,Totatiche,14104,2277,2307,4584
2016,Jalisco,14,Tototlán,14105,11662,11994,23656
2016,Jalisco,14,Tuxcacuesco,14106,2258,2174,4432
2016,Jalisco,14,Tuxcueca,14107,3147,3357,6504
2016,Jalisco,14,Tuxpan,14108,17502,18572,36074
2016,Jalisco,14,Unión de San Antonio,14109,8871,9560,18431
2016,Jalisco,14,Unión de Tula,14110,6859,7340,14199
2016,Jalisco,14,Valle de Guadalupe,14111,3553,3616,7169
2016,Jalisco,14,Valle de Juárez,14112,2815,2983,5798
2016,Jalisco,14,Villa Corona,14114,9009,9291,18300
2016,Jalisco,14,Villa Guerrero,14115,2818,2920,5738
2016,Jalisco,14,Villa Hidalgo,14116,10027,10682,20709
2016,Jalisco,14,Villa Purificación,14068,5949,5598,11547
2016,Jalisco,14,Yahualica de González Gallo,14118,11350,12439,23789
2016,Jalisco,14,Zacoalco de Torres,14119,14554,14853,29407
2016,Jalisco,14,Zapopan,14120,676861,696764,1373625
2016,Jalisco,14,Zapotiltic,14121,14945,15612,30557
2016,Jalisco,14,Zapotitlán de Vadillo,14122,3617,3607,7224
2016,Jalisco,14,Zapotlanejo,14124,34149,35265,69414
2016,Jalisco,14,Zapotlán del Rey,14123,9284,9362,18646
2016,Jalisco,14,Zapotlán el Grande,14023,53517,56175,109692
2016,Michoacán,16,Acuitzio,16001,5615,6070,11685
2016,Michoacán,16,Aguililla,16002,8056,7908,15964
2016,Michoacán,16,Angamacutiro,16004,7255,8089,15344
2016,Michoacán,16,Angangueo,16005,5560,5889,11449
2016,Michoacán,16,Apatzingán,16006,65273,66384,131657
2016,Michoacán,16,Aporo,16007,1606,1713,3319
2016,Michoacán,16,Aquila,16008,12840,12378,25218
2016,Michoacán,16,Ario,16009,18158,19159,37317
2016,Michoacán,16,Arteaga,16010,11328,11393,22721
2016,Michoacán,16,Briseñas,16011,5601,5921,11522
2016,Michoacán,16,Buenavista,16012,24054,23276,47330
2016,Michoacán,16,Carácuaro,16013,4851,4844,9695
2016,Michoacán,16,Charapan,16021,5944,6732,12676
2016,Michoacán,16,Charo,16022,11805,10899,22704
2016,Michoacán,16,Chavinda,16023,5108,5455,10563
2016,Michoacán,16,Cherán,16024,9317,10019,19336
2016,Michoacán,16,Chilchota,16025,18913,20384,39297
2016,Michoacán,16,Chinicuila,16026,2718,2511,5229
2016,Michoacán,16,Chucándiro,16027,2222,2672,4894
2016,Michoacán,16,Churintzio,16028,2490,2876,5366
2016,Michoacán,16,Churumuco,16029,7761,7782,15543
2016,Michoacán,16,Coahuayana,16014,7591,7090,14681
2016,Michoacán,16,Coalcomán de Vázquez Pallares,16015,9281,9492,18773
2016,Michoacán,16,Coeneo,16016,9762,11586,21348
2016,Michoacán,16,Cojumatlán de Régules,16074,5208,5469,10677
2016,Michoacán,16,Contepec,16017,17057,18014,35071
2016,Michoacán,16,Copándaro,16018,4385,4943,9328
2016,Michoacán,16,Cotija,16019,9361,10428,19789
2016,Michoacán,16,Cuitzeo,16020,14405,15974,30379
2016,Michoacán,16,Ecuandureo,16030,6016,7199,13215
2016,Michoacán,16,Epitacio Huerta,16031,8410,8797,17207
2016,Michoacán,16,Erongarícuaro,16032,7534,8071,15605
2016,Michoacán,16,Gabriel Zamora,16033,11528,11607,23135
2016,Michoacán,16,Hidalgo,16034,61179,64731,125910
2016,Michoacán,16,Huandacareo,16036,5661,6526,12187
2016,Michoacán,16,Huaniqueo,16037,3759,4530,8289
2016,Michoacán,16,Huetamo,16038,20909,21922,42831
2016,Michoacán,16,Huiramba,16039,4348,4520,8868
2016,Michoacán,16,Indaparapeo,16040,8374,8950,17324
2016,Michoacán,16,Irimbo,16041,7308,8066,15374
2016,Michoacán,16,Ixtlán,16042,6604,6904,13508
2016,Michoacán,16,Jacona,16043,34353,36309,70662
2016,Michoacán,16,Jiménez,16044,6286,6957,13243
2016,Michoacán,16,Jiquilpan,16045,16446,18157,34603
2016,Michoacán,16,José Sixto Verduzco,16113,12699,14214,26913
2016,Michoacán,16,Jungapeo,16047,10811,11005,21816
2016,Michoacán,16,Juárez,16046,7153,7535,14688
2016,Michoacán,16,La Huacana,16035,17349,17604,34953
2016,Michoacán,16,La Piedad,16069,51052,55677,106729
2016,Michoacán,16,Lagunillas,16048,2793,2917,5710
2016,Michoacán,16,Los Reyes,16075,34066,35691,69757
2016,Michoacán,16,Lázaro Cárdenas,16052,95103,94033,189136
2016,Michoacán,16,Madero,16049,9201,9136,18337
2016,Michoacán,16,Maravatío,16050,42552,46007,88559
2016,Michoacán,16,Marcos Castellanos,16051,6708,7228,13936
2016,Michoacán,16,Morelia,16053,385437,412893,798330
2016,Michoacán,16,Morelos,16054,3651,4475,8126
2016,Michoacán,16,Múgica,16055,23209,23683,46892
2016,Michoacán,16,Nahuatzen,16056,14050,14926,28976
2016,Michoacán,16,Nocupétaro,16057,4136,4225,8361
2016,Michoacán,16,Nuevo Parangaricutiro,16058,9778,10227,20005
2016,Michoacán,16,Nuevo Urecho,16059,4203,4191,8394
2016,Michoacán,16,Numarán,16060,4823,5322,10145
2016,Michoacán,16,Ocampo,16061,12344,12356,24700
2016,Michoacán,16,Pajacuarán,16062,9689,10439,20128
2016,Michoacán,16,Panindícuaro,16063,7686,8733,16419
2016,Michoacán,16,Paracho,16065,18088,19867,37955
2016,Michoacán,16,Parácuaro,16064,13703,13484,27187
2016,Michoacán,16,Penjamillo,16067,8147,9435,17582
2016,Michoacán,16,Peribán,16068,13978,13937,27915
2016,Michoacán,16,Puruándiro,16071,32961,37062,70023
2016,Michoacán,16,Purépero,16070,7823,8233,16056
2016,Michoacán,16,Pátzcuaro,16066,45607,49423,95030
2016,Michoacán,16,Queréndaro,16072,6886,7272,14158
2016,Michoacán,16,Quiroga,16073,13445,14684,28129
2016,Michoacán,16,Sahuayo,16076,38084,39966,78050
2016,Michoacán,16,Salvador Escalante,16079,24008,25510,49518
2016,Michoacán,16,San Lucas,16077,9266,9488,18754
2016,Michoacán,16,Santa Ana Maya,16078,6031,6937,12968
2016,Michoacán,16,Senguio,16080,9372,10013,19385
2016,Michoacán,16,Susupuato,16081,4456,4555,9011
2016,Michoacán,16,Tacámbaro,16082,37666,39409,77075
2016,Michoacán,16,Tancítaro,16083,15938,15680,31618
2016,Michoacán,16,Tangamandapio,16084,14403,15586,29989
2016,Michoacán,16,Tangancícuaro,16085,16662,17838,34500
2016,Michoacán,16,Tanhuato,16086,7776,8226,16002
2016,Michoacán,16,Taretan,16087,7354,7568,14922
2016,Michoacán,16,Tarímbaro,16088,50861,55178,106039
2016,Michoacán,16,Tepalcatepec,16089,12383,12111,24494
2016,Michoacán,16,Tingambato,16090,7409,7871,15280
2016,Michoacán,16,Tingüindín,16091,7083,7700,14783
2016,Michoacán,16,Tiquicheo de Nicolás Romero,16092,7061,7205,14266
2016,Michoacán,16,Tlalpujahua,16093,13957,15478,29435
2016,Michoacán,16,Tlazazalca,16094,3199,3467,6666
2016,Michoacán,16,Tocumbo,16095,6004,6171,12175
2016,Michoacán,16,Tumbiscatío,16096,3814,3677,7491
2016,Michoacán,16,Turicato,16097,15995,16893,32888
2016,Michoacán,16,Tuxpan,16098,13484,14481,27965
2016,Michoacán,16,Tuzantla,16099,8006,8148,16154
2016,Michoacán,16,Tzintzuntzan,16100,6927,7710,14637
2016,Michoacán,16,Tzitzio,16101,4698,4590,9288
2016,Michoacán,16,Uruapan,16102,166153,175652,341805
2016,Michoacán,16,Venustiano Carranza,16103,12326,12876,25202
2016,Michoacán,16,Villamar,16104,8325,9127,17452
2016,Michoacán,16,Vista Hermosa,16105,10242,10623,20865
2016,Michoacán,16,Yurécuaro,16106,15578,16419,31997
2016,Michoacán,16,Zacapu,16107,37823,40587,78410
2016,Michoacán,16,Zamora,16108,97777,103535,201312
2016,Michoacán,16,Zinapécuaro,16110,23391,25434,48825
2016,Michoacán,16,Zináparo,16109,1515,1807,3322
2016,Michoacán,16,Ziracuaretiro,16111,8569,8786,17355
2016,Michoacán,16,Zitácuaro,16112,80215,86681,166896
2016,Michoacán,16,Álvaro Obregón,16003,10642,11512,22154
2016,Morelos,17,Amacuzac,17001,8871,9374,18245
2016,Morelos,17,Atlatlahucan,17002,10905,11409,22314
2016,Morelos,17,Axochiapan,17003,17962,18610,36572
2016,Morelos,17,Ayala,17004,41982,44868,86850
2016,Morelos,17,Coatlán del Río,17005,4940,5118,10058
2016,Morelos,17,Cuautla,17006,95184,102601,197785
2016,Morelos,17,Cuernavaca,17007,183410,204969,388379
2016,Morelos,17,Emiliano Zapata,17008,48311,50088,98399
2016,Morelos,17,Huitzilac,17009,9641,9699,19340
2016,Morelos,17,Jantetelco,17010,8488,8910,17398
2016,Morelos,17,Jiutepec,17011,106162,113096,219258
2016,Morelos,17,Jojutla,17012,28651,30748,59399
2016,Morelos,17,Jonacatepec,17013,7723,8364,16087
2016,Morelos,17,Mazatepec,17014,5030,5269,10299
2016,Morelos,17,Miacatlán,17015,13240,13997,27237
2016,Morelos,17,Ocuituco,17016,9223,9503,18726
2016,Morelos,17,Puente de Ixtla,17017,33193,34584,67777
2016,Morelos,17,Temixco,17018,57947,60765,118712
2016,Morelos,17,Temoac,17033,7747,8251,15998
2016,Morelos,17,Tepalcingo,17019,13544,14201,27745
2016,Morelos,17,Tepoztlán,17020,23413,24227,47640
2016,Morelos,17,Tetecala,17021,3970,4011,7981
2016,Morelos,17,Tetela del Volcán,17022,10153,10789,20942
2016,Morelos,17,Tlalnepantla,17023,3692,3623,7315
2016,Morelos,17,Tlaltizapán de Zapata,17024,26001,27381,53382
2016,Morelos,17,Tlaquiltenango,17025,17112,17585,34697
2016,Morelos,17,Tlayacapan,17026,8987,9177,18164
2016,Morelos,17,Totolapan,17027,5995,6162,12157
2016,Morelos,17,Xochitepec,17028,35532,34681,70213
2016,Morelos,17,Yautepec,17029,51260,54082,105342
2016,Morelos,17,Yecapixtla,17030,26051,26708,52759
2016,Morelos,17,Zacatepec,17031,18183,19660,37843
2016,Morelos,17,Zacualpan,17032,4735,4969,9704
2016,Nayarit,18,Acaponeta,18001,19663,19541,39204
2016,Nayarit,18,Ahuacatlán,18002,8306,8252,16558
2016,Nayarit,18,Amatlán de Cañas,18003,6217,6016,12233
2016,Nayarit,18,Bahía de Banderas,18020,78931,76283,155214
2016,Nayarit,18,Compostela,18004,39110,38852,77962
2016,Nayarit,18,Del Nayar,18009,21118,21002,42120
2016,Nayarit,18,Huajicori,18005,6567,6292,12859
2016,Nayarit,18,Ixtlán del Río,18006,14728,15649,30377
2016,Nayarit,18,Jala,18007,9521,9690,19211
2016,Nayarit,18,La Yesca,18019,7464,7126,14590
2016,Nayarit,18,Rosamorada,18010,18400,17645,36045
2016,Nayarit,18,Ruíz,18011,12984,12652,25636
2016,Nayarit,18,San Blas,18012,24149,21780,45929
2016,Nayarit,18,San Pedro Lagunillas,18013,4034,3935,7969
2016,Nayarit,18,Santa María del Oro,18014,12642,11974,24616
2016,Nayarit,18,Santiago Ixcuintla,18015,51533,49917,101450
2016,Nayarit,18,Tecuala,18016,21284,20571,41855
2016,Nayarit,18,Tepic,18017,205817,214933,420750
2016,Nayarit,18,Tuxpan,18018,16040,16161,32201
2016,Nayarit,18,Xalisco,18008,28372,29476,57848
2016,Nuevo León,19,Abasolo,19001,1461,1446,2907
2016,Nuevo León,19,Agualeguas,19002,1414,1350,2764
2016,Nuevo León,19,Allende,19004,18328,17956,36284
2016,Nuevo León,19,Anáhuac,19005,9788,9809,19597
2016,Nuevo León,19,Apodaca,19006,308896,304216,613112
2016,Nuevo León,19,Aramberri,19007,8645,8404,17049
2016,Nuevo León,19,Bustamante,19008,2091,2085,4176
2016,Nuevo León,19,Cadereyta Jiménez,19009,51164,48158,99322
2016,Nuevo León,19,Cerralvo,19011,4318,4065,8383
2016,Nuevo León,19,China,19013,5982,5675,11657
2016,Nuevo León,19,Ciénega de Flores,19012,22342,21565,43907
2016,Nuevo León,19,Doctor Arroyo,19014,18530,18243,36773
2016,Nuevo León,19,Doctor Coss,19015,916,872,1788
2016,Nuevo León,19,Doctor González,19016,1667,1590,3257
2016,Nuevo León,19,El Carmen,19010,20359,20024,40383
2016,Nuevo León,19,Galeana,19017,22046,21484,43530
2016,Nuevo León,19,García,19018,128246,127531,255777
2016,Nuevo León,19,General Bravo,19020,3052,2859,5911
2016,Nuevo León,19,General Escobedo,19021,217328,215952,433280
2016,Nuevo León,19,General Terán,19022,7883,7893,15776
2016,Nuevo León,19,General Treviño,19023,605,621,1226
2016,Nuevo León,19,General Zaragoza,19024,3315,3082,6397
2016,Nuevo León,19,General Zuazua,19025,39517,38927,78444
2016,Nuevo León,19,Guadalupe,19026,354379,343354,697733
2016,Nuevo León,19,Hidalgo,19047,7993,7903,15896
2016,Nuevo León,19,Higueras,19028,862,795,1657
2016,Nuevo León,19,Hualahuises,19029,3689,3776,7465
2016,Nuevo León,19,Iturbide,19030,1991,1855,3846
2016,Nuevo León,19,Juárez,19031,174814,171557,346371
2016,Nuevo León,19,Lampazos de Naranjo,19032,2820,2740,5560
2016,Nuevo León,19,Linares,19033,42318,42564,84882
2016,Nuevo León,19,Los Aldamas,19003,744,722,1466
2016,Nuevo León,19,Los Herreras,19027,992,1005,1997
2016,Nuevo León,19,Los Ramones,19042,2687,2610,5297
2016,Nuevo León,19,Marín,19034,3105,2907,6012
2016,Nuevo León,19,Melchor Ocampo,19035,523,507,1030
2016,Nuevo León,19,Mier y Noriega,19036,3781,3702,7483
2016,Nuevo León,19,Mina,19037,2952,2803,5755
2016,Nuevo León,19,Montemorelos,19038,32337,32218,64555
2016,Nuevo León,19,Monterrey,19039,537787,556547,1094334
2016,Nuevo León,19,Parás,19040,548,532,1080
2016,Nuevo León,19,Pesquería,19041,47732,47726,95458
2016,Nuevo León,19,Rayones,19043,1477,1372,2849
2016,Nuevo León,19,Sabinas Hidalgo,19044,18633,19071,37704
2016,Nuevo León,19,Salinas Victoria,19045,28151,26979,55130
2016,Nuevo León,19,San Nicolás de los Garza,19046,235142,240681,475823
2016,Nuevo León,19,San Pedro Garza García,19019,63234,70801,134035
2016,Nuevo León,19,Santa Catarina,19048,154743,152992,307735
2016,Nuevo León,19,Santiago,19049,22645,22352,44997
2016,Nuevo León,19,Vallecillo,19050,1027,872,1899
2016,Nuevo León,19,Villaldama,19051,2239,2215,4454
2016,Oaxaca,20,Abejones,20001,485,609,1094
2016,Oaxaca,20,Acatlán de Pérez Figueroa,20002,22995,24023,47018
2016,Oaxaca,20,Asunción Cacalotepec,20003,1080,1150,2230
2016,Oaxaca,20,Asunción Cuyotepeji,20004,465,536,1001
2016,Oaxaca,20,Asunción Ixtaltepec,20005,7791,7867,15658
2016,Oaxaca,20,Asunción Nochixtlán,20006,8889,9932,18821
2016,Oaxaca,20,Asunción Ocotlán,20007,1208,1489,2697
2016,Oaxaca,20,Asunción Tlacolulita,20008,393,410,803
2016,Oaxaca,20,Ayoquezco de Aldama,20398,2120,2403,4523
2016,Oaxaca,20,Ayotzintepec,20009,3592,3637,7229
2016,Oaxaca,20,Calihualá,20011,587,617,1204
2016,Oaxaca,20,Candelaria Loxicha,20012,5092,5411,10503
2016,Oaxaca,20,Capulálpam de Méndez,20247,702,867,1569
2016,Oaxaca,20,Chahuites,20025,5800,5893,11693
2016,Oaxaca,20,Chalcatongo de Hidalgo,20026,4239,4849,9088
2016,Oaxaca,20,Chiquihuitlán de Benito Juárez,20027,1112,1307,2419
2016,Oaxaca,20,Ciudad Ixtepec,20014,13960,15196,29156
2016,Oaxaca,20,Ciénega de Zimatlán,20013,1425,1580,3005
2016,Oaxaca,20,Coatecas Altas,20015,2354,2588,4942
2016,Oaxaca,20,Coicoyán de las Flores,20016,4578,5160,9738
2016,Oaxaca,20,Concepción Buenavista,20018,407,428,835
2016,Oaxaca,20,Concepción Pápalo,20019,1544,1533,3077
2016,Oaxaca,20,Constancia del Rosario,20020,1868,2160,4028
2016,Oaxaca,20,Cosolapa,20021,7727,8285,16012
2016,Oaxaca,20,Cosoltepec,20022,380,448,828
2016,Oaxaca,20,Cuilápam de Guerrero,20023,10294,10941,21235
2016,Oaxaca,20,Cuyamecalco Villa de Zaragoza,20024,1936,1900,3836
2016,Oaxaca,20,El Barrio de la Soledad,20010,7121,7610,14731
2016,Oaxaca,20,El Espinal,20030,4376,4572,8948
2016,Oaxaca,20,Eloxochitlán de Flores Magón,20029,2063,2286,4349
2016,Oaxaca,20,Fresnillo de Trujano,20032,490,537,1027
2016,Oaxaca,20,Guadalupe Etla,20033,1281,1433,2714
2016,Oaxaca,20,Guadalupe de Ramírez,20034,649,676,1325
2016,Oaxaca,20,Guelatao de Juárez,20035,291,293,584
2016,Oaxaca,20,Guevea de Humboldt,20036,2706,2805,5511
2016,Oaxaca,20,Heroica Ciudad de Ejutla de Crespo,20028,9918,11108,21026
2016,Oaxaca,20,Heroica Ciudad de Huajuapan de León,20039,36464,40723,77187
2016,Oaxaca,20,Heroica Ciudad de Juchitán de Zaragoza,20043,48964,51381,100345
2016,Oaxaca,20,Heroica Ciudad de Tlaxiaco,20397,19274,21766,41040
2016,Oaxaca,20,Huautepec,20040,3009,3408,6417
2016,Oaxaca,20,Huautla de Jiménez,20041,15187,17341,32528
2016,Oaxaca,20,Ixpantepec Nieves,20065,557,687,1244
2016,Oaxaca,20,Ixtlán de Juárez,20042,4101,4226,8327
2016,Oaxaca,20,La Compañía,20017,1629,1807,3436
2016,Oaxaca,20,La Pe,20069,1263,1367,2630
2016,Oaxaca,20,La Reforma,20076,1575,1754,3329
2016,Oaxaca,20,La Trinidad Vista Hermosa,20556,115,143,258
2016,Oaxaca,20,Loma Bonita,20044,20918,22908,43826
2016,Oaxaca,20,Magdalena Apasco,20045,4082,4529,8611
2016,Oaxaca,20,Magdalena Jaltepec,20046,1551,1802,3353
2016,Oaxaca,20,Magdalena Mixtepec,20048,672,693,1365
2016,Oaxaca,20,Magdalena Ocotlán,20049,568,622,1190
2016,Oaxaca,20,Magdalena Peñasco,20050,1697,1946,3643
2016,Oaxaca,20,Magdalena Teitipac,20051,2257,2420,4677
2016,Oaxaca,20,Magdalena Tequisistlán,20052,3081,3226,6307
2016,Oaxaca,20,Magdalena Tlacotepec,20053,609,671,1280
2016,Oaxaca,20,Magdalena Yodocono de Porfirio Díaz,20562,750,794,1544
2016,Oaxaca,20,Magdalena Zahuatlán,20054,200,229,429
2016,Oaxaca,20,Mariscala de Juárez,20055,1721,1872,3593
2016,Oaxaca,20,Matías Romero Avendaño,20057,19571,21074,40645
2016,Oaxaca,20,Mazatlán Villa de Flores,20058,6754,6812,13566
2016,Oaxaca,20,Mesones Hidalgo,20037,2059,2413,4472
2016,Oaxaca,20,Miahuatlán de Porfirio Díaz,20059,20854,22762,43616
2016,Oaxaca,20,Mixistlán de la Reforma,20060,1280,1427,2707
2016,Oaxaca,20,Monjas,20061,1247,1473,2720
2016,Oaxaca,20,Mártires de Tacubaya,20056,696,752,1448
2016,Oaxaca,20,Natividad,20062,272,311,583
2016,Oaxaca,20,Nazareno Etla,20063,1958,2164,4122
2016,Oaxaca,20,Nejapa de Madero,20064,3754,3909,7663
2016,Oaxaca,20,Nuevo Zoquiápam,20504,801,875,1676
2016,Oaxaca,20,Oaxaca de Juárez,20067,121758,137656,259414
2016,Oaxaca,20,Ocotlán de Morelos,20068,10707,11693,22400
2016,Oaxaca,20,Pinotepa de Don Luis,20070,3502,3597,7099
2016,Oaxaca,20,Pluma Hidalgo,20071,1489,1563,3052
2016,Oaxaca,20,Putla Villa de Guerrero,20073,15740,17774,33514
2016,Oaxaca,20,Reforma de Pineda,20075,1387,1463,2850
2016,Oaxaca,20,Reyes Etla,20077,1871,2004,3875
2016,Oaxaca,20,Rojas de Cuauhtémoc,20078,545,596,1141
2016,Oaxaca,20,Salina Cruz,20079,43465,46871,90336
2016,Oaxaca,20,San Agustín Amatengo,20080,687,787,1474
2016,Oaxaca,20,San Agustín Atenango,20081,852,1002,1854
2016,Oaxaca,20,San Agustín Chayuco,20082,2000,2204,4204
2016,Oaxaca,20,San Agustín Etla,20084,1958,2151,4109
2016,Oaxaca,20,San Agustín Loxicha,20085,12105,12599,24704
2016,Oaxaca,20,San Agustín Tlacotepec,20086,414,544,958
2016,Oaxaca,20,San Agustín Yatareni,20087,2050,2350,4400
2016,Oaxaca,20,San Agustín de las Juntas,20083,4600,4796,9396
2016,Oaxaca,20,San Andrés Cabecera Nueva,20088,1405,1456,2861
2016,Oaxaca,20,San Andrés Dinicuiti,20089,1072,1138,2210
2016,Oaxaca,20,San Andrés Huaxpaltepec,20090,3059,3231,6290
2016,Oaxaca,20,San Andrés Huayápam,20091,2603,2858,5461
2016,Oaxaca,20,San Andrés Ixtlahuaca,20092,750,860,1610
2016,Oaxaca,20,San Andrés Lagunas,20093,236,275,511
2016,Oaxaca,20,San Andrés Nuxiño,20094,899,975,1874
2016,Oaxaca,20,San Andrés Paxtlán,20095,2184,2204,4388
2016,Oaxaca,20,San Andrés Sinaxtla,20096,357,401,758
2016,Oaxaca,20,San Andrés Solaga,20097,857,905,1762
2016,Oaxaca,20,San Andrés Teotilálpam,20098,2205,2364,4569
2016,Oaxaca,20,San Andrés Tepetlapa,20099,239,276,515
2016,Oaxaca,20,San Andrés Yaá,20100,208,251,459
2016,Oaxaca,20,San Andrés Zabache,20101,333,416,749
2016,Oaxaca,20,San Andrés Zautla,20102,2250,2379,4629
2016,Oaxaca,20,San Antonino Castillo Velasco,20103,2902,3188,6090
2016,Oaxaca,20,San Antonino Monte Verde,20105,3376,3911,7287
2016,Oaxaca,20,San Antonino el Alto,20104,1313,1360,2673
2016,Oaxaca,20,San Antonio Acutla,20106,126,153,279
2016,Oaxaca,20,San Antonio Huitepec,20108,2092,2411,4503
2016,Oaxaca,20,San Antonio Nanahuatípam,20109,635,644,1279
2016,Oaxaca,20,San Antonio Sinicahua,20110,741,858,1599
2016,Oaxaca,20,San Antonio Tepetlapa,20111,2105,2271,4376
2016,Oaxaca,20,San Antonio de la Cal,20107,11453,12727,24180
2016,Oaxaca,20,San Baltazar Chichicápam,20112,1231,1394,2625
2016,Oaxaca,20,San Baltazar Loxicha,20113,1475,1557,3032
2016,Oaxaca,20,San Baltazar Yatzachi el Bajo,20114,322,364,686
2016,Oaxaca,20,San Bartolo Coyotepec,20115,4565,5030,9595
2016,Oaxaca,20,San Bartolo Soyaltepec,20121,301,377,678
2016,Oaxaca,20,San Bartolo Yautepec,20122,336,340,676
2016,Oaxaca,20,San Bartolomé Ayautla,20116,2195,2322,4517
2016,Oaxaca,20,San Bartolomé Loxicha,20117,1222,1252,2474
2016,Oaxaca,20,San Bartolomé Quialana,20118,1075,1488,2563
2016,Oaxaca,20,San Bartolomé Yucuañe,20119,164,236,400
2016,Oaxaca,20,San Bartolomé Zoogocho,20120,150,196,346
2016,Oaxaca,20,San Bernardo Mixtepec,20123,1315,1446,2761
2016,Oaxaca,20,San Blas Atempa,20124,9405,9355,18760
2016,Oaxaca,20,San Carlos Yautepec,20125,6098,6071,12169
2016,Oaxaca,20,San Cristóbal Amatlán,20126,2449,2762,5211
2016,Oaxaca,20,San Cristóbal Amoltepec,20127,542,633,1175
2016,Oaxaca,20,San Cristóbal Lachirioag,20128,604,666,1270
2016,Oaxaca,20,San Cristóbal Suchixtlahuaca,20129,172,187,359
2016,Oaxaca,20,San Dionisio Ocotepec,20131,5105,5811,10916
2016,Oaxaca,20,San Dionisio Ocotlán,20132,586,607,1193
2016,Oaxaca,20,San Dionisio del Mar,20130,2724,2625,5349
2016,Oaxaca,20,San Esteban Atatlahuca,20133,1883,1971,3854
2016,Oaxaca,20,San Felipe Jalapa de Díaz,20134,13842,14666,28508
2016,Oaxaca,20,San Felipe Tejalápam,20135,3747,4098,7845
2016,Oaxaca,20,San Felipe Usila,20136,5773,6239,12012
2016,Oaxaca,20,San Francisco Cahuacuá,20137,1722,1750,3472
2016,Oaxaca,20,San Francisco Cajonos,20138,205,237,442
2016,Oaxaca,20,San Francisco Chapulapa,20139,1021,1102,2123
2016,Oaxaca,20,San Francisco Chindúa,20140,403,423,826
2016,Oaxaca,20,San Francisco Huehuetlán,20142,498,626,1124
2016,Oaxaca,20,San Francisco Ixhuatán,20143,4612,4711,9323
2016,Oaxaca,20,San Francisco Jaltepetongo,20144,500,520,1020
2016,Oaxaca,20,San Francisco Lachigoló,20145,2027,2111,4138
2016,Oaxaca,20,San Francisco Logueche,20146,1346,1519,2865
2016,Oaxaca,20,San Francisco Nuxaño,20147,196,186,382
2016,Oaxaca,20,San Francisco Ozolotepec,20148,964,1012,1976
2016,Oaxaca,20,San Francisco Sola,20149,802,897,1699
2016,Oaxaca,20,San Francisco Telixtlahuaca,20150,6237,6692,12929
2016,Oaxaca,20,San Francisco Teopan,20151,186,172,358
2016,Oaxaca,20,San Francisco Tlapancingo,20152,1019,1262,2281
2016,Oaxaca,20,San Francisco del Mar,20141,3972,3850,7822
2016,Oaxaca,20,San Gabriel Mixtepec,20153,2373,2538,4911
2016,Oaxaca,20,San Ildefonso Amatlán,20154,1153,1316,2469
2016,Oaxaca,20,San Ildefonso Sola,20155,492,485,977
2016,Oaxaca,20,San Ildefonso Villa Alta,20156,1689,1799,3488
2016,Oaxaca,20,San Jacinto Amilpas,20157,8086,8930,17016
2016,Oaxaca,20,San Jacinto Tlacotepec,20158,1115,1182,2297
2016,Oaxaca,20,San Jerónimo Coatlán,20159,2669,2816,5485
2016,Oaxaca,20,San Jerónimo Silacayoapilla,20160,726,762,1488
2016,Oaxaca,20,San Jerónimo Sosola,20161,1250,1403,2653
2016,Oaxaca,20,San Jerónimo Taviche,20162,933,1023,1956
2016,Oaxaca,20,San Jerónimo Tecóatl,20163,776,877,1653
2016,Oaxaca,20,San Jerónimo Tlacochahuaya,20550,2612,2960,5572
2016,Oaxaca,20,San Jorge Nuchita,20164,1371,1602,2973
2016,Oaxaca,20,San José Ayuquila,20165,716,835,1551
2016,Oaxaca,20,San José Chiltepec,20166,5889,6251,12140
2016,Oaxaca,20,San José Estancia Grande,20168,527,534,1061
2016,Oaxaca,20,San José Independencia,20169,1869,2013,3882
2016,Oaxaca,20,San José Lachiguiri,20170,1632,1994,3626
2016,Oaxaca,20,San José Tenango,20171,9150,9796,18946
2016,Oaxaca,20,San José del Peñasco,20167,1054,1092,2146
2016,Oaxaca,20,San José del Progreso,20072,3361,3575,6936
2016,Oaxaca,20,San Juan Achiutla,20172,206,212,418
2016,Oaxaca,20,San Juan Atepec,20173,713,797,1510
2016,Oaxaca,20,San Juan Bautista Atatlahuca,20175,797,844,1641
2016,Oaxaca,20,San Juan Bautista Coixtlahuaca,20176,1343,1474,2817
2016,Oaxaca,20,San Juan Bautista Cuicatlán,20177,4925,5214,10139
2016,Oaxaca,20,San Juan Bautista Guelache,20178,3425,3816,7241
2016,Oaxaca,20,San Juan Bautista Jayacatlán,20179,752,737,1489
2016,Oaxaca,20,San Juan Bautista Lo de Soto,20180,1266,1291,2557
2016,Oaxaca,20,San Juan Bautista Suchitepec,20181,206,241,447
2016,Oaxaca,20,San Juan Bautista Tlachichilco,20183,668,778,1446
2016,Oaxaca,20,San Juan Bautista Tlacoatzintepec,20182,1082,1194,2276
2016,Oaxaca,20,San Juan Bautista Tuxtepec,20184,80131,86544,166675
2016,Oaxaca,20,San Juan Bautista Valle Nacional,20559,11108,12125,23233
2016,Oaxaca,20,San Juan Cacahuatepec,20185,4410,4641,9051
2016,Oaxaca,20,San Juan Chicomezúchil,20191,154,184,338
2016,Oaxaca,20,San Juan Chilateca,20192,715,827,1542
2016,Oaxaca,20,San Juan Cieneguilla,20186,279,306,585
2016,Oaxaca,20,San Juan Coatzóspam,20187,1137,1114,2251
2016,Oaxaca,20,San Juan Colorado,20188,4884,5183,10067
2016,Oaxaca,20,San Juan Comaltepec,20189,1377,1448,2825
2016,Oaxaca,20,San Juan Cotzocón,20190,11742,12377,24119
2016,Oaxaca,20,San Juan Diuxi,20195,577,587,1164
2016,Oaxaca,20,San Juan Evangelista Analco,20196,206,220,426
2016,Oaxaca,20,San Juan Guelavía,20197,1609,1708,3317
2016,Oaxaca,20,San Juan Guichicovi,20198,14208,15988,30196
2016,Oaxaca,20,San Juan Ihualtepec,20199,300,351,651
2016,Oaxaca,20,San Juan Juquila Mixes,20200,1845,2059,3904
2016,Oaxaca,20,San Juan Juquila Vijanos,20201,951,1032,1983
2016,Oaxaca,20,San Juan Lachao,20202,2348,2495,4843
2016,Oaxaca,20,San Juan Lachigalla,20203,1652,1752,3404
2016,Oaxaca,20,San Juan Lajarcia,20204,302,371,673
2016,Oaxaca,20,San Juan Lalana,20205,8583,8983,17566
2016,Oaxaca,20,San Juan Mazatlán,20207,9334,9470,18804
2016,Oaxaca,20,San Juan Mixtepec Distrito 08,20208,3376,3888,7264
2016,Oaxaca,20,San Juan Mixtepec Distrito 26,20209,311,431,742
2016,Oaxaca,20,San Juan Ozolotepec,20211,1440,1421,2861
2016,Oaxaca,20,San Juan Petlapa,20212,1442,1538,2980
2016,Oaxaca,20,San Juan Quiahije,20213,1965,2229,4194
2016,Oaxaca,20,San Juan Quiotepec,20214,1082,1120,2202
2016,Oaxaca,20,San Juan Sayultepec,20215,373,434,807
2016,Oaxaca,20,San Juan Tabaá,20216,639,697,1336
2016,Oaxaca,20,San Juan Tamazola,20217,1538,1610,3148
2016,Oaxaca,20,San Juan Teita,20218,296,312,608
2016,Oaxaca,20,San Juan Teitipac,20219,1291,1415,2706
2016,Oaxaca,20,San Juan Tepeuxila,20220,1444,1357,2801
2016,Oaxaca,20,San Juan Teposcolula,20221,639,678,1317
2016,Oaxaca,20,San Juan Yaeé,20222,732,829,1561
2016,Oaxaca,20,San Juan Yatzona,20223,222,274,496
2016,Oaxaca,20,San Juan Yucuita,20224,288,346,634
2016,Oaxaca,20,San Juan de los Cués,20206,1245,1263,2508
2016,Oaxaca,20,San Juan del Estado,20193,1279,1390,2669
2016,Oaxaca,20,San Juan del Río,20194,587,712,1299
2016,Oaxaca,20,San Juan Ñumí,20210,2918,3317,6235
2016,Oaxaca,20,San Lorenzo,20225,3014,3240,6254
2016,Oaxaca,20,San Lorenzo Albarradas,20226,1419,1389,2808
2016,Oaxaca,20,San Lorenzo Cacaotepec,20227,7499,8152,15651
2016,Oaxaca,20,San Lorenzo Cuaunecuiltitla,20228,431,391,822
2016,Oaxaca,20,San Lorenzo Texmelúcan,20229,3770,4356,8126
2016,Oaxaca,20,San Lorenzo Victoria,20230,487,510,997
2016,Oaxaca,20,San Lucas Camotlán,20231,1518,1598,3116
2016,Oaxaca,20,San Lucas Ojitlán,20232,10260,10906,21166
2016,Oaxaca,20,San Lucas Quiaviní,20233,752,1051,1803
2016,Oaxaca,20,San Lucas Zoquiápam,20234,3713,3919,7632
2016,Oaxaca,20,San Luis Amatlán,20235,1716,2014,3730
2016,Oaxaca,20,San Marcial Ozolotepec,20236,744,817,1561
2016,Oaxaca,20,San Marcos Arteaga,20237,728,837,1565
2016,Oaxaca,20,San Martín Huamelúlpam,20239,490,585,1075
2016,Oaxaca,20,San Martín Itunyoso,20240,1077,1346,2423
2016,Oaxaca,20,San Martín Lachilá,20241,493,614,1107
2016,Oaxaca,20,San Martín Peras,20242,5996,6393,12389
2016,Oaxaca,20,San Martín Tilcajete,20243,835,1023,1858
2016,Oaxaca,20,San Martín Toxpalan,20244,1899,2002,3901
2016,Oaxaca,20,San Martín Zacatepec,20245,632,669,1301
2016,Oaxaca,20,San Martín de los Cansecos,20238,429,436,865
2016,Oaxaca,20,San Mateo Cajonos,20246,289,348,637
2016,Oaxaca,20,San Mateo Etlatongo,20250,568,604,1172
2016,Oaxaca,20,San Mateo Nejápam,20251,560,620,1180
2016,Oaxaca,20,San Mateo Peñasco,20252,994,1153,2147
2016,Oaxaca,20,San Mateo Piñas,20253,1086,1083,2169
2016,Oaxaca,20,San Mateo Río Hondo,20254,1580,1654,3234
2016,Oaxaca,20,San Mateo Sindihui,20255,993,1096,2089
2016,Oaxaca,20,San Mateo Tlapiltepec,20256,110,123,233
2016,Oaxaca,20,San Mateo Yoloxochitlán,20249,1759,1916,3675
2016,Oaxaca,20,San Mateo Yucutindoo,20566,1558,1598,3156
2016,Oaxaca,20,San Mateo del Mar,20248,7670,7438,15108
2016,Oaxaca,20,San Melchor Betaza,20257,490,563,1053
2016,Oaxaca,20,San Miguel Achiutla,20258,364,401,765
2016,Oaxaca,20,San Miguel Ahuehuetitlán,20259,1164,1281,2445
2016,Oaxaca,20,San Miguel Aloápam,20260,1113,1260,2373
2016,Oaxaca,20,San Miguel Amatitlán,20261,3566,3946,7512
2016,Oaxaca,20,San Miguel Amatlán,20262,503,529,1032
2016,Oaxaca,20,San Miguel Chicahua,20264,985,1214,2199
2016,Oaxaca,20,San Miguel Chimalapa,20265,3587,3417,7004
2016,Oaxaca,20,San Miguel Coatlán,20263,1567,1819,3386
2016,Oaxaca,20,San Miguel Ejutla,20268,460,539,999
2016,Oaxaca,20,San Miguel Huautla,20270,561,648,1209
2016,Oaxaca,20,San Miguel Mixtepec,20271,1591,1662,3253
2016,Oaxaca,20,San Miguel Panixtlahuaca,20272,3125,3713,6838
2016,Oaxaca,20,San Miguel Peras,20273,1644,1779,3423
2016,Oaxaca,20,San Miguel Piedras,20274,652,687,1339
2016,Oaxaca,20,San Miguel Quetzaltepec,20275,4031,3993,8024
2016,Oaxaca,20,San Miguel Santa Flor,20276,379,374,753
2016,Oaxaca,20,San Miguel Soyaltepec,20278,19361,20405,39766
2016,Oaxaca,20,San Miguel Suchixtepec,20279,1352,1479,2831
2016,Oaxaca,20,San Miguel Tecomatlán,20281,164,140,304
2016,Oaxaca,20,San Miguel Tenango,20282,387,372,759
2016,Oaxaca,20,San Miguel Tequixtepec,20283,512,536,1048
2016,Oaxaca,20,San Miguel Tilquiápam,20284,1465,1796,3261
2016,Oaxaca,20,San Miguel Tlacamama,20285,1802,1870,3672
2016,Oaxaca,20,San Miguel Tlacotepec,20286,1538,1777,3315
2016,Oaxaca,20,San Miguel Tulancingo,20287,128,196,324
2016,Oaxaca,20,San Miguel Yotao,20288,302,326,628
2016,Oaxaca,20,San Miguel del Puerto,20266,4240,4320,8560
2016,Oaxaca,20,San Miguel del Río,20267,139,136,275
2016,Oaxaca,20,San Miguel el Grande,20269,1965,2230,4195
2016,Oaxaca,20,San Nicolás,20289,527,642,1169
2016,Oaxaca,20,San Nicolás Hidalgo,20290,471,549,1020
2016,Oaxaca,20,San Pablo Coatlán,20291,2104,2209,4313
2016,Oaxaca,20,San Pablo Cuatro Venados,20292,664,762,1426
2016,Oaxaca,20,San Pablo Etla,20293,8498,9356,17854
2016,Oaxaca,20,San Pablo Huitzo,20294,3346,3751,7097
2016,Oaxaca,20,San Pablo Huixtepec,20295,4539,5011,9550
2016,Oaxaca,20,San Pablo Macuiltianguis,20296,452,480,932
2016,Oaxaca,20,San Pablo Tijaltepec,20297,1134,1352,2486
2016,Oaxaca,20,San Pablo Villa de Mitla,20298,6122,6699,12821
2016,Oaxaca,20,San Pablo Yaganiza,20299,524,586,1110
2016,Oaxaca,20,San Pedro Amuzgos,20300,3149,3581,6730
2016,Oaxaca,20,San Pedro Apóstol,20301,727,856,1583
2016,Oaxaca,20,San Pedro Atoyac,20302,2095,2341,4436
2016,Oaxaca,20,San Pedro Cajonos,20303,513,627,1140
2016,Oaxaca,20,San Pedro Comitancillo,20305,2056,2269,4325
2016,Oaxaca,20,San Pedro Coxcaltepec Cántaros,20304,385,418,803
2016,Oaxaca,20,San Pedro Huamelula,20307,5081,5090,10171
2016,Oaxaca,20,San Pedro Huilotepec,20308,1569,1596,3165
2016,Oaxaca,20,San Pedro Ixcatlán,20309,5717,5931,11648
2016,Oaxaca,20,San Pedro Ixtlahuaca,20310,4123,4388,8511
2016,Oaxaca,20,San Pedro Jaltepetongo,20311,253,291,544
2016,Oaxaca,20,San Pedro Jicayán,20312,5912,6400,12312
2016,Oaxaca,20,San Pedro Jocotipac,20313,372,446,818
2016,Oaxaca,20,San Pedro Juchatengo,20314,792,876,1668
2016,Oaxaca,20,San Pedro Mixtepec Distrito 22,20318,23571,24854,48425
2016,Oaxaca,20,San Pedro Mixtepec Distrito 26,20319,528,584,1112
2016,Oaxaca,20,San Pedro Molinos,20320,340,380,720
2016,Oaxaca,20,San Pedro Mártir,20315,777,989,1766
2016,Oaxaca,20,San Pedro Mártir Quiechapa,20316,343,390,733
2016,Oaxaca,20,San Pedro Mártir Yucuxaco,20317,616,716,1332
2016,Oaxaca,20,San Pedro Nopala,20321,367,408,775
2016,Oaxaca,20,San Pedro Ocopetatillo,20322,400,461,861
2016,Oaxaca,20,San Pedro Ocotepec,20323,1073,1115,2188
2016,Oaxaca,20,San Pedro Pochutla,20324,23500,24213,47713
2016,Oaxaca,20,San Pedro Quiatoni,20325,5376,5697,11073
2016,Oaxaca,20,San Pedro Sochiápam,20326,2554,2622,5176
2016,Oaxaca,20,San Pedro Tapanatepec,20327,7557,7707,15264
2016,Oaxaca,20,San Pedro Taviche,20328,603,625,1228
2016,Oaxaca,20,San Pedro Teozacoalco,20329,624,674,1298
2016,Oaxaca,20,San Pedro Teutila,20330,2171,2230,4401
2016,Oaxaca,20,San Pedro Tidaá,20331,413,474,887
2016,Oaxaca,20,San Pedro Topiltepec,20332,181,196,377
2016,Oaxaca,20,San Pedro Totolápam,20333,1292,1434,2726
2016,Oaxaca,20,San Pedro Yaneri,20335,474,495,969
2016,Oaxaca,20,San Pedro Yucunama,20341,104,140,244
2016,Oaxaca,20,San Pedro Yólox,20336,964,1020,1984
2016,Oaxaca,20,San Pedro el Alto,20306,1926,2012,3938
2016,Oaxaca,20,San Pedro y San Pablo Ayutla,20337,2459,2894,5353
2016,Oaxaca,20,San Pedro y San Pablo Teposcolula,20339,1986,2180,4166
2016,Oaxaca,20,San Pedro y San Pablo Tequixtepec,20340,798,987,1785
2016,Oaxaca,20,San Raymundo Jalpan,20342,1532,1841,3373
2016,Oaxaca,20,San Sebastián Abasolo,20343,928,1011,1939
2016,Oaxaca,20,San Sebastián Coatlán,20344,1331,1413,2744
2016,Oaxaca,20,San Sebastián Ixcapa,20345,2013,2079,4092
2016,Oaxaca,20,San Sebastián Nicananduta,20346,646,853,1499
2016,Oaxaca,20,San Sebastián Río Hondo,20347,1829,1872,3701
2016,Oaxaca,20,San Sebastián Tecomaxtlahuaca,20348,3981,4415,8396
2016,Oaxaca,20,San Sebastián Teitipac,20349,931,1110,2041
2016,Oaxaca,20,San Sebastián Tutla,20350,9007,10343,19350
2016,Oaxaca,20,San Simón Almolongas,20351,1277,1467,2744
2016,Oaxaca,20,San Simón Zahuatlán,20352,2047,2098,4145
2016,Oaxaca,20,San Vicente Coatlán,20534,1838,2208,4046
2016,Oaxaca,20,San Vicente Lachixío,20535,1442,1620,3062
2016,Oaxaca,20,San Vicente Nuñú,20536,210,248,458
2016,Oaxaca,20,Santa Ana,20353,1036,1139,2175
2016,Oaxaca,20,Santa Ana Ateixtlahuaca,20354,268,267,535
2016,Oaxaca,20,Santa Ana Cuauhtémoc,20355,365,394,759
2016,Oaxaca,20,Santa Ana Tavela,20357,421,443,864
2016,Oaxaca,20,Santa Ana Tlapacoyan,20358,929,1039,1968
2016,Oaxaca,20,Santa Ana Yareni,20359,429,510,939
2016,Oaxaca,20,Santa Ana Zegache,20360,1787,2023,3810
2016,Oaxaca,20,Santa Ana del Valle,20356,1025,1104,2129
2016,Oaxaca,20,Santa Catalina Quierí,20361,427,508,935
2016,Oaxaca,20,Santa Catarina Cuixtla,20362,658,823,1481
2016,Oaxaca,20,Santa Catarina Ixtepeji,20363,1302,1396,2698
2016,Oaxaca,20,Santa Catarina Juquila,20364,7796,8256,16052
2016,Oaxaca,20,Santa Catarina Lachatao,20365,565,606,1171
2016,Oaxaca,20,Santa Catarina Loxicha,20366,1998,2037,4035
2016,Oaxaca,20,Santa Catarina Mechoacán,20367,2308,2350,4658
2016,Oaxaca,20,Santa Catarina Minas,20368,961,998,1959
2016,Oaxaca,20,Santa Catarina Quiané,20369,933,1016,1949
2016,Oaxaca,20,Santa Catarina Quioquitani,20074,252,274,526
2016,Oaxaca,20,Santa Catarina Tayata,20370,311,368,679
2016,Oaxaca,20,Santa Catarina Ticuá,20371,470,583,1053
2016,Oaxaca,20,Santa Catarina Yosonotú,20372,796,963,1759
2016,Oaxaca,20,Santa Catarina Zapoquila,20373,187,212,399
2016,Oaxaca,20,Santa Cruz Acatepec,20374,751,815,1566
2016,Oaxaca,20,Santa Cruz Amilpas,20375,5877,6803,12680
2016,Oaxaca,20,Santa Cruz Itundujia,20377,5627,6072,11699
2016,Oaxaca,20,Santa Cruz Mixtepec,20378,1691,1868,3559
2016,Oaxaca,20,Santa Cruz Nundaco,20379,1380,1617,2997
2016,Oaxaca,20,Santa Cruz Papalutla,20380,1054,1116,2170
2016,Oaxaca,20,Santa Cruz Tacache de Mina,20381,1297,1438,2735
2016,Oaxaca,20,Santa Cruz Tacahua,20382,546,618,1164
2016,Oaxaca,20,Santa Cruz Tayata,20383,300,309,609
2016,Oaxaca,20,Santa Cruz Xitla,20384,2271,2531,4802
2016,Oaxaca,20,Santa Cruz Xoxocotlán,20385,43628,48914,92542
2016,Oaxaca,20,Santa Cruz Zenzontepec,20386,9148,9551,18699
2016,Oaxaca,20,Santa Cruz de Bravo,20376,179,193,372
2016,Oaxaca,20,Santa Gertrudis,20387,1412,1540,2952
2016,Oaxaca,20,Santa Inés Yatzeche,20389,409,557,966
2016,Oaxaca,20,Santa Inés de Zaragoza,20569,798,894,1692
2016,Oaxaca,20,Santa Inés del Monte,20388,1207,1264,2471
2016,Oaxaca,20,Santa Lucía Miahuatlán,20391,1694,1763,3457
2016,Oaxaca,20,Santa Lucía Monteverde,20392,3185,3474,6659
2016,Oaxaca,20,Santa Lucía Ocotlán,20393,1811,2124,3935
2016,Oaxaca,20,Santa Lucía del Camino,20390,24890,26688,51578
2016,Oaxaca,20,Santa Magdalena Jicotlán,20047,42,53,95
2016,Oaxaca,20,Santa María Alotepec,20394,1409,1449,2858
2016,Oaxaca,20,Santa María Apazco,20395,813,979,1792
2016,Oaxaca,20,Santa María Atzompa,20399,16455,17750,34205
2016,Oaxaca,20,Santa María Camotlán,20400,757,878,1635
2016,Oaxaca,20,Santa María Chachoápam,20404,360,413,773
2016,Oaxaca,20,Santa María Chilchotla,20406,10396,10723,21119
2016,Oaxaca,20,Santa María Chimalapa,20407,4675,4542,9217
2016,Oaxaca,20,Santa María Colotepec,20401,12040,12186,24226
2016,Oaxaca,20,Santa María Cortijo,20402,528,569,1097
2016,Oaxaca,20,Santa María Coyotepec,20403,1457,1609,3066
2016,Oaxaca,20,Santa María Ecatepec,20410,1748,1783,3531
2016,Oaxaca,20,Santa María Guelacé,20411,377,464,841
2016,Oaxaca,20,Santa María Guienagati,20412,1637,1639,3276
2016,Oaxaca,20,Santa María Huatulco,20413,21848,22845,44693
2016,Oaxaca,20,Santa María Huazolotitlán,20414,5683,5906,11589
2016,Oaxaca,20,Santa María Ipalapa,20415,2371,2653,5024
2016,Oaxaca,20,Santa María Ixcatlán,20416,249,278,527
2016,Oaxaca,20,Santa María Jacatepec,20417,4579,5077,9656
2016,Oaxaca,20,Santa María Jalapa del Marqués,20418,6362,6802,13164
2016,Oaxaca,20,Santa María Jaltianguis,20419,251,296,547
2016,Oaxaca,20,Santa María Lachixío,20420,869,1008,1877
2016,Oaxaca,20,Santa María Mixtequilla,20421,2306,2432,4738
2016,Oaxaca,20,Santa María Nativitas,20422,284,342,626
2016,Oaxaca,20,Santa María Nduayaco,20423,261,260,521
2016,Oaxaca,20,Santa María Ozolotepec,20424,1956,2073,4029
2016,Oaxaca,20,Santa María Petapa,20427,8050,8614,16664
2016,Oaxaca,20,Santa María Peñoles,20426,4168,4379,8547
2016,Oaxaca,20,Santa María Pápalo,20425,1108,1098,2206
2016,Oaxaca,20,Santa María Quiegolani,20428,961,949,1910
2016,Oaxaca,20,Santa María Sola,20429,737,793,1530
2016,Oaxaca,20,Santa María Tataltepec,20430,168,183,351
2016,Oaxaca,20,Santa María Tecomavaca,20431,850,915,1765
2016,Oaxaca,20,Santa María Temaxcalapa,20432,467,499,966
2016,Oaxaca,20,Santa María Temaxcaltepec,20433,1274,1408,2682
2016,Oaxaca,20,Santa María Teopoxco,20434,2123,2364,4487
2016,Oaxaca,20,Santa María Tepantlali,20435,1821,1893,3714
2016,Oaxaca,20,Santa María Texcatitlán,20436,499,542,1041
2016,Oaxaca,20,Santa María Tlahuitoltepec,20437,4646,4913,9559
2016,Oaxaca,20,Santa María Tlalixtac,20438,845,895,1740
2016,Oaxaca,20,Santa María Tonameca,20439,12616,12922,25538
2016,Oaxaca,20,Santa María Totolapilla,20440,419,466,885
2016,Oaxaca,20,Santa María Xadani,20441,4386,4332,8718
2016,Oaxaca,20,Santa María Yalina,20442,140,162,302
2016,Oaxaca,20,Santa María Yavesía,20443,219,264,483
2016,Oaxaca,20,Santa María Yolotepec,20444,207,227,434
2016,Oaxaca,20,Santa María Yosoyúa,20445,825,825,1650
2016,Oaxaca,20,Santa María Yucuhiti,20446,3117,3372,6489
2016,Oaxaca,20,Santa María Zacatepec,20447,7577,8572,16149
2016,Oaxaca,20,Santa María Zaniza,20448,1074,1141,2215
2016,Oaxaca,20,Santa María Zoquitlán,20449,1550,1617,3167
2016,Oaxaca,20,Santa María del Rosario,20408,259,241,500
2016,Oaxaca,20,Santa María del Tule,20409,4277,4908,9185
2016,Oaxaca,20,Santa María la Asunción,20396,1495,1865,3360
2016,Oaxaca,20,Santiago Amoltepec,20450,6197,6573,12770
2016,Oaxaca,20,Santiago Apoala,20451,438,502,940
2016,Oaxaca,20,Santiago Apóstol,20452,1857,2296,4153
2016,Oaxaca,20,Santiago Astata,20453,1984,2013,3997
2016,Oaxaca,20,Santiago Atitlán,20454,1603,1543,3146
2016,Oaxaca,20,Santiago Ayuquililla,20455,1291,1438,2729
2016,Oaxaca,20,Santiago Cacaloxtepec,20456,788,857,1645
2016,Oaxaca,20,Santiago Camotlán,20457,1629,1653,3282
2016,Oaxaca,20,Santiago Chazumba,20459,2048,2524,4572
2016,Oaxaca,20,Santiago Choápam,20460,2557,2743,5300
2016,Oaxaca,20,Santiago Comaltepec,20458,505,568,1073
2016,Oaxaca,20,Santiago Huajolotitlán,20462,1948,2344,4292
2016,Oaxaca,20,Santiago Huauclilla,20463,277,305,582
2016,Oaxaca,20,Santiago Ihuitlán Plumas,20464,179,219,398
2016,Oaxaca,20,Santiago Ixcuintepec,20465,806,827,1633
2016,Oaxaca,20,Santiago Ixtayutla,20466,6324,6661,12985
2016,Oaxaca,20,Santiago Jamiltepec,20467,9358,10088,19446
2016,Oaxaca,20,Santiago Jocotepec,20468,6977,7221,14198
2016,Oaxaca,20,Santiago Juxtlahuaca,20469,17222,19078,36300
2016,Oaxaca,20,Santiago Lachiguiri,20470,2463,2510,4973
2016,Oaxaca,20,Santiago Lalopa,20471,241,262,503
2016,Oaxaca,20,Santiago Laollaga,20472,1685,1706,3391
2016,Oaxaca,20,Santiago Laxopa,20473,641,718,1359
2016,Oaxaca,20,Santiago Llano Grande,20474,1660,1699,3359
2016,Oaxaca,20,Santiago Matatlán,20475,4729,5349,10078
2016,Oaxaca,20,Santiago Miltepec,20476,201,208,409
2016,Oaxaca,20,Santiago Minas,20477,730,749,1479
2016,Oaxaca,20,Santiago Nacaltepec,20478,892,987,1879
2016,Oaxaca,20,Santiago Nejapilla,20479,111,102,213
2016,Oaxaca,20,Santiago Niltepec,20066,2745,2776,5521
2016,Oaxaca,20,Santiago Nundiche,20480,449,487,936
2016,Oaxaca,20,Santiago Nuyoó,20481,920,1011,1931
2016,Oaxaca,20,Santiago Pinotepa Nacional,20482,26173,27432,53605
2016,Oaxaca,20,Santiago Suchilquitongo,20483,5065,5455,10520
2016,Oaxaca,20,Santiago Tamazola,20484,2095,2437,4532
2016,Oaxaca,20,Santiago Tapextla,20485,1603,1561,3164
2016,Oaxaca,20,Santiago Tenango,20487,1028,1021,2049
2016,Oaxaca,20,Santiago Tepetlapa,20488,61,65,126
2016,Oaxaca,20,Santiago Tetepec,20489,2511,2576,5087
2016,Oaxaca,20,Santiago Texcalcingo,20490,1525,1632,3157
2016,Oaxaca,20,Santiago Textitlán,20491,2204,2231,4435
2016,Oaxaca,20,Santiago Tilantongo,20492,1449,1681,3130
2016,Oaxaca,20,Santiago Tillo,20493,258,295,553
2016,Oaxaca,20,Santiago Tlazoyaltepec,20494,2194,2636,4830
2016,Oaxaca,20,Santiago Xanica,20495,1537,1545,3082
2016,Oaxaca,20,Santiago Xiacuí,20496,1001,1105,2106
2016,Oaxaca,20,Santiago Yaitepec,20497,2014,2332,4346
2016,Oaxaca,20,Santiago Yaveo,20498,3449,3438,6887
2016,Oaxaca,20,Santiago Yolomécatl,20499,984,1170,2154
2016,Oaxaca,20,Santiago Yosondúa,20500,3960,4431,8391
2016,Oaxaca,20,Santiago Yucuyachi,20501,442,492,934
2016,Oaxaca,20,Santiago Zacatepec,20502,2673,2731,5404
2016,Oaxaca,20,Santiago Zoochila,20503,195,221,416
2016,Oaxaca,20,Santiago del Río,20461,269,291,560
2016,Oaxaca,20,Santo Domingo Albarradas,20506,369,423,792
2016,Oaxaca,20,Santo Domingo Armenta,20507,1720,1735,3455
2016,Oaxaca,20,Santo Domingo Chihuitán,20508,773,788,1561
2016,Oaxaca,20,Santo Domingo Ingenio,20505,4081,4075,8156
2016,Oaxaca,20,Santo Domingo Ixcatlán,20510,370,430,800
2016,Oaxaca,20,Santo Domingo Nuxaá,20511,1636,1743,3379
2016,Oaxaca,20,Santo Domingo Ozolotepec,20512,429,473,902
2016,Oaxaca,20,Santo Domingo Petapa,20513,4582,4546,9128
2016,Oaxaca,20,Santo Domingo Roayaga,20514,493,541,1034
2016,Oaxaca,20,Santo Domingo Tehuantepec,20515,32275,33968,66243
2016,Oaxaca,20,Santo Domingo Teojomulco,20516,2407,2582,4989
2016,Oaxaca,20,Santo Domingo Tepuxtepec,20517,2607,2939,5546
2016,Oaxaca,20,Santo Domingo Tlatayápam,20518,67,77,144
2016,Oaxaca,20,Santo Domingo Tomaltepec,20519,1477,1524,3001
2016,Oaxaca,20,Santo Domingo Tonaltepec,20521,112,148,260
2016,Oaxaca,20,Santo Domingo Tonalá,20520,3417,3776,7193
2016,Oaxaca,20,Santo Domingo Xagacía,20522,548,631,1179
2016,Oaxaca,20,Santo Domingo Yanhuitlán,20523,752,846,1598
2016,Oaxaca,20,Santo Domingo Yodohino,20524,165,184,349
2016,Oaxaca,20,Santo Domingo Zanatepec,20525,6139,6168,12307
2016,Oaxaca,20,Santo Domingo de Morelos,20509,5311,5890,11201
2016,Oaxaca,20,Santo Tomás Jalieza,20530,1718,1892,3610
2016,Oaxaca,20,Santo Tomás Mazaltepec,20531,1230,1356,2586
2016,Oaxaca,20,Santo Tomás Ocotepec,20532,1839,2098,3937
2016,Oaxaca,20,Santo Tomás Tamazulapan,20533,1087,1157,2244
2016,Oaxaca,20,Santos Reyes Nopala,20526,8547,9020,17567
2016,Oaxaca,20,Santos Reyes Pápalo,20527,1330,1420,2750
2016,Oaxaca,20,Santos Reyes Tepejillo,20528,457,626,1083
2016,Oaxaca,20,Santos Reyes Yucuná,20529,680,692,1372
2016,Oaxaca,20,Silacayoápam,20537,3142,3614,6756
2016,Oaxaca,20,Sitio de Xitlapehua,20538,337,373,710
2016,Oaxaca,20,Soledad Etla,20539,2735,2870,5605
2016,Oaxaca,20,Tamazulápam del Espíritu Santo,20031,3439,4064,7503
2016,Oaxaca,20,Tanetze de Zaragoza,20541,823,887,1710
2016,Oaxaca,20,Taniche,20542,367,456,823
2016,Oaxaca,20,Tataltepec de Valdés,20543,2897,3014,5911
2016,Oaxaca,20,Teococuilco de Marcos Pérez,20544,500,576,1076
2016,Oaxaca,20,Teotitlán de Flores Magón,20545,4754,5223,9977
2016,Oaxaca,20,Teotitlán del Valle,20546,2866,3165,6031
2016,Oaxaca,20,Teotongo,20547,444,530,974
2016,Oaxaca,20,Tepelmeme Villa de Morelos,20548,766,911,1677
2016,Oaxaca,20,Tlacolula de Matamoros,20551,10522,11903,22425
2016,Oaxaca,20,Tlacotepec Plumas,20552,225,249,474
2016,Oaxaca,20,Tlalixtac de Cabrera,20553,4940,5461,10401
2016,Oaxaca,20,Totontepec Villa de Morelos,20554,2646,2877,5523
2016,Oaxaca,20,Trinidad Zaachila,20555,1440,1605,3045
2016,Oaxaca,20,Unión Hidalgo,20557,7494,7985,15479
2016,Oaxaca,20,Valerio Trujano,20558,669,810,1479
2016,Oaxaca,20,Villa Díaz Ordaz,20560,3085,3663,6748
2016,Oaxaca,20,Villa Hidalgo,20038,971,1072,2043
2016,Oaxaca,20,Villa Sola de Vega,20277,6276,6454,12730
2016,Oaxaca,20,Villa Talea de Castro,20280,1134,1247,2381
2016,Oaxaca,20,Villa Tejúpam de la Unión,20486,1211,1295,2506
2016,Oaxaca,20,Villa Tezoatlán de Segura y Luna,20549,5250,6217,11467
2016,Oaxaca,20,Villa de Chilapa de Díaz,20405,920,1186,2106
2016,Oaxaca,20,Villa de Etla,20338,5173,5624,10797
2016,Oaxaca,20,Villa de Tamazulápam del Progreso,20540,3650,4120,7770
2016,Oaxaca,20,Villa de Tututepec de Melchor Ocampo,20334,22796,23833,46629
2016,Oaxaca,20,Villa de Zaachila,20565,20489,22491,42980
2016,Oaxaca,20,Yaxe,20561,1365,1478,2843
2016,Oaxaca,20,Yogana,20563,589,702,1291
2016,Oaxaca,20,Yutanduchi de Guerrero,20564,577,640,1217
2016,Oaxaca,20,Zapotitlán Lagunas,20567,1524,1729,3253
2016,Oaxaca,20,Zapotitlán Palmas,20568,672,820,1492
2016,Oaxaca,20,Zimatlán de Álvarez,20570,9573,10875,20448
2016,Oaxaca,20,Ánimas Trujano,20174,1914,2115,4029
2016,Puebla,21,Acajete,21001,31839,33978,65817
2016,Puebla,21,Acateno,21002,4748,4709,9457
2016,Puebla,21,Acatlán,21003,16983,19861,36844
2016,Puebla,21,Acatzingo,21004,28890,30054,58944
2016,Puebla,21,Acteopan,21005,1452,1653,3105
2016,Puebla,21,Ahuacatlán,21006,7670,8377,16047
2016,Puebla,21,Ahuatlán,21007,1660,1781,3441
2016,Puebla,21,Ahuazotepec,21008,5665,5862,11527
2016,Puebla,21,Ahuehuetitla,21009,907,1050,1957
2016,Puebla,21,Ajalpan,21010,32469,34318,66787
2016,Puebla,21,Albino Zertuche,21011,866,1015,1881
2016,Puebla,21,Aljojuca,21012,3192,3568,6760
2016,Puebla,21,Altepexi,21013,10428,10981,21409
2016,Puebla,21,Amixtlán,21014,2462,2706,5168
2016,Puebla,21,Amozoc,21015,56902,59444,116346
2016,Puebla,21,Aquixtla,21016,4402,4415,8817
2016,Puebla,21,Atempan,21017,13556,14935,28491
2016,Puebla,21,Atexcal,21018,1887,2030,3917
2016,Puebla,21,Atlequizayan,21080,1346,1500,2846
2016,Puebla,21,Atlixco,21019,65456,73508,138964
2016,Puebla,21,Atoyatempan,21020,3454,3707,7161
2016,Puebla,21,Atzala,21021,646,713,1359
2016,Puebla,21,Atzitzihuacán,21022,5828,6739,12567
2016,Puebla,21,Atzitzintla,21023,4619,4767,9386
2016,Puebla,21,Axutla,21024,450,522,972
2016,Puebla,21,Ayotoxco de Guerrero,21025,4356,4494,8850
2016,Puebla,21,Calpan,21026,7083,7840,14923
2016,Puebla,21,Caltepec,21027,1971,2257,4228
2016,Puebla,21,Camocuautla,21028,1323,1347,2670
2016,Puebla,21,Caxhuacan,21029,1886,2028,3914
2016,Puebla,21,Cañada Morelos,21099,9654,10307,19961
2016,Puebla,21,Chalchicomula de Sesma,21045,23064,24999,48063
2016,Puebla,21,Chapulco,21046,3762,4042,7804
2016,Puebla,21,Chiautla,21047,10004,10703,20707
2016,Puebla,21,Chiautzingo,21048,9835,10837,20672
2016,Puebla,21,Chichiquila,21050,12885,13510,26395
2016,Puebla,21,Chiconcuautla,21049,8245,8554,16799
2016,Puebla,21,Chietla,21051,17274,18651,35925
2016,Puebla,21,Chigmecatitlán,21052,569,674,1243
2016,Puebla,21,Chignahuapan,21053,31045,32215,63260
2016,Puebla,21,Chignautla,21054,16606,17522,34128
2016,Puebla,21,Chila,21055,2247,2559,4806
2016,Puebla,21,Chila de la Sal,21056,702,756,1458
2016,Puebla,21,Chilchotla,21058,10271,10193,20464
2016,Puebla,21,Chinantla,21059,1128,1288,2416
2016,Puebla,21,Coatepec,21030,372,412,784
2016,Puebla,21,Coatzingo,21031,1488,1640,3128
2016,Puebla,21,Cohetzala,21032,706,703,1409
2016,Puebla,21,Cohuecan,21033,2415,2643,5058
2016,Puebla,21,Coronango,21034,19772,20655,40427
2016,Puebla,21,Coxcatlán,21035,10201,11114,21315
2016,Puebla,21,Coyomeapan,21036,6969,7549,14518
2016,Puebla,21,Coyotepec,21037,1114,1292,2406
2016,Puebla,21,Cuapiaxtla de Madero,21038,4944,5032,9976
2016,Puebla,21,Cuautempan,21039,4670,5001,9671
2016,Puebla,21,Cuautinchán,21040,5113,5201,10314
2016,Puebla,21,Cuautlancingo,21041,54816,58299,113115
2016,Puebla,21,Cuayuca de Andrade,21042,1579,1713,3292
2016,Puebla,21,Cuetzalan del Progreso,21043,24629,25626,50255
2016,Puebla,21,Cuyoaco,21044,7844,8430,16274
2016,Puebla,21,Domingo Arenas,21060,3558,3935,7493
2016,Puebla,21,Eloxochitlán,21061,6418,6644,13062
2016,Puebla,21,Epatlán,21062,2410,2555,4965
2016,Puebla,21,Esperanza,21063,7384,7906,15290
2016,Puebla,21,Francisco Z. Mena,21064,8767,8686,17453
2016,Puebla,21,General Felipe Ángeles,21065,10008,10871,20879
2016,Puebla,21,Guadalupe,21066,2876,3346,6222
2016,Puebla,21,Guadalupe Victoria,21067,8499,8980,17479
2016,Puebla,21,Hermenegildo Galeana,21068,4003,4025,8028
2016,Puebla,21,Honey,21057,3811,4205,8016
2016,Puebla,21,Huaquechula,21069,12225,14009,26234
2016,Puebla,21,Huatlatlauca,21070,3064,3687,6751
2016,Puebla,21,Huauchinango,21071,50799,55940,106739
2016,Puebla,21,Huehuetla,21072,9256,9449,18705
2016,Puebla,21,Huehuetlán el Chico,21073,4324,4605,8929
2016,Puebla,21,Huehuetlán el Grande,21150,3587,3828,7415
2016,Puebla,21,Huejotzingo,21074,36006,37897,73903
2016,Puebla,21,Hueyapan,21075,6374,6711,13085
2016,Puebla,21,Hueytamalco,21076,13663,13901,27564
2016,Puebla,21,Hueytlalpan,21077,2762,2885,5647
2016,Puebla,21,Huitzilan de Serdán,21078,7687,7517,15204
2016,Puebla,21,Huitziltepec,21079,2696,2916,5612
2016,Puebla,21,Ixcamilpa de Guerrero,21081,1797,2006,3803
2016,Puebla,21,Ixcaquixtla,21082,4282,4681,8963
2016,Puebla,21,Ixtacamaxtitlán,21083,12747,13051,25798
2016,Puebla,21,Ixtepec,21084,3568,3764,7332
2016,Puebla,21,Izúcar de Matamoros,21085,37705,42071,79776
2016,Puebla,21,Jalpan,21086,6181,6600,12781
2016,Puebla,21,Jolalpan,21087,6438,7065,13503
2016,Puebla,21,Jonotla,21088,2359,2443,4802
2016,Puebla,21,Jopala,21089,6617,6925,13542
2016,Puebla,21,Juan C. Bonilla,21090,10052,10987,21039
2016,Puebla,21,Juan Galindo,21091,5198,5915,11113
2016,Puebla,21,Juan N. Méndez,21092,2689,2768,5457
2016,Puebla,21,La Magdalena Tlatlauquitepec,21095,294,288,582
2016,Puebla,21,Lafragua,21093,3992,4087,8079
2016,Puebla,21,Libres,21094,16756,17658,34414
2016,Puebla,21,Los Reyes de Juárez,21118,13736,14307,28043
2016,Puebla,21,Mazapiltepec de Juárez,21096,1426,1463,2889
2016,Puebla,21,Mixtla,21097,1147,1277,2424
2016,Puebla,21,Molcaxac,21098,3063,3484,6547
2016,Puebla,21,Naupan,21100,4943,5393,10336
2016,Puebla,21,Nauzontla,21101,1694,1899,3593
2016,Puebla,21,Nealtican,21102,6100,6625,12725
2016,Puebla,21,Nicolás Bravo,21103,3124,3318,6442
2016,Puebla,21,Nopalucan,21104,15268,15721,30989
2016,Puebla,21,Ocotepec,21105,2386,2593,4979
2016,Puebla,21,Ocoyucan,21106,13366,15229,28595
2016,Puebla,21,Olintla,21107,5994,6261,12255
2016,Puebla,21,Oriental,21108,8919,9430,18349
2016,Puebla,21,Pahuatlán,21109,10576,11721,22297
2016,Puebla,21,Palmar de Bravo,21110,23124,23792,46916
2016,Puebla,21,Pantepec,21111,9347,9907,19254
2016,Puebla,21,Petlalcingo,21112,4644,5349,9993
2016,Puebla,21,Piaxtla,21113,2207,2388,4595
2016,Puebla,21,Puebla,21114,790322,857494,1647816
2016,Puebla,21,Quecholac,21115,25299,26370,51669
2016,Puebla,21,Quimixtlán,21116,11207,11410,22617
2016,Puebla,21,Rafael Lara Grajales,21117,7042,7611,14653
2016,Puebla,21,San Andrés Cholula,21119,68035,69986,138021
2016,Puebla,21,San Antonio Cañada,21120,2645,2980,5625
2016,Puebla,21,San Diego la Mesa Tochimiltzingo,21121,615,635,1250
2016,Puebla,21,San Felipe Teotlalcingo,21122,5086,5432,10518
2016,Puebla,21,San Felipe Tepatlán,21123,2045,2109,4154
2016,Puebla,21,San Gabriel Chilac,21124,7656,8419,16075
2016,Puebla,21,San Gregorio Atzompa,21125,4396,4698,9094
2016,Puebla,21,San Jerónimo Tecuanipan,21126,3021,3336,6357
2016,Puebla,21,San Jerónimo Xayacatlán,21127,1748,2010,3758
2016,Puebla,21,San José Chiapa,21128,4389,4502,8891
2016,Puebla,21,San José Miahuatlán,21129,6511,7158,13669
2016,Puebla,21,San Juan Atenco,21130,1641,1896,3537
2016,Puebla,21,San Juan Atzompa,21131,468,445,913
2016,Puebla,21,San Martín Texmelucan,21132,75247,80639,155886
2016,Puebla,21,San Martín Totoltepec,21133,341,372,713
2016,Puebla,21,San Matías Tlalancaleca,21134,10186,10581,20767
2016,Puebla,21,San Miguel Ixitlán,21135,256,290,546
2016,Puebla,21,San Miguel Xoxtla,21136,6193,6524,12717
2016,Puebla,21,San Nicolás Buenos Aires,21137,4934,5147,10081
2016,Puebla,21,San Nicolás de los Ranchos,21138,5772,6095,11867
2016,Puebla,21,San Pablo Anicano,21139,1760,1945,3705
2016,Puebla,21,San Pedro Cholula,21140,64148,69412,133560
2016,Puebla,21,San Pedro Yeloixtlahuaca,21141,1672,1824,3496
2016,Puebla,21,San Salvador Huixcolotla,21144,7455,7636,15091
2016,Puebla,21,San Salvador el Seco,21142,14989,15742,30731
2016,Puebla,21,San Salvador el Verde,21143,15464,16073,31537
2016,Puebla,21,San Sebastián Tlacotepec,21145,7162,7270,14432
2016,Puebla,21,Santa Catarina Tlaltempan,21146,427,424,851
2016,Puebla,21,Santa Inés Ahuatempan,21147,3105,3383,6488
2016,Puebla,21,Santa Isabel Cholula,21148,4472,4871,9343
2016,Puebla,21,Santiago Miahuatlán,21149,12253,12949,25202
2016,Puebla,21,Santo Tomás Hueyotlipan,21151,4201,4556,8757
2016,Puebla,21,Soltepec,21152,6140,6464,12604
2016,Puebla,21,Tecali de Herrera,21153,10881,11504,22385
2016,Puebla,21,Tecamachalco,21154,38006,40450,78456
2016,Puebla,21,Tecomatlán,21155,2955,3063,6018
2016,Puebla,21,Tehuacán,21156,152330,168988,321318
2016,Puebla,21,Tehuitzingo,21157,5520,6146,11666
2016,Puebla,21,Tenampulco,21158,3590,3709,7299
2016,Puebla,21,Teopantlán,21159,1787,2233,4020
2016,Puebla,21,Teotlalco,21160,1606,1685,3291
2016,Puebla,21,Tepanco de López,21161,9900,10986,20886
2016,Puebla,21,Tepango de Rodríguez,21162,2039,2249,4288
2016,Puebla,21,Tepatlaxco de Hidalgo,21163,8610,9143,17753
2016,Puebla,21,Tepeaca,21164,39277,42584,81861
2016,Puebla,21,Tepemaxalco,21165,570,608,1178
2016,Puebla,21,Tepeojuma,21166,3994,4702,8696
2016,Puebla,21,Tepetzintla,21167,5562,5973,11535
2016,Puebla,21,Tepexco,21168,3402,3641,7043
2016,Puebla,21,Tepexi de Rodríguez,21169,10853,10803,21656
2016,Puebla,21,Tepeyahualco,21170,8688,8841,17529
2016,Puebla,21,Tepeyahualco de Cuauhtémoc,21171,1728,1909,3637
2016,Puebla,21,Tetela de Ocampo,21172,13789,14801,28590
2016,Puebla,21,Teteles de Ávila Castillo,21173,2844,3335,6179
2016,Puebla,21,Teziutlán,21174,48043,53301,101344
2016,Puebla,21,Tianguismanalco,21175,6017,6571,12588
2016,Puebla,21,Tilapa,21176,4296,4631,8927
2016,Puebla,21,Tlachichuca,21179,14721,15304,30025
2016,Puebla,21,Tlacotepec de Benito Juárez,21177,25425,27659,53084
2016,Puebla,21,Tlacuilotepec,21178,8644,8888,17532
2016,Puebla,21,Tlahuapan,21180,20225,20497,40722
2016,Puebla,21,Tlaltenango,21181,3524,3590,7114
2016,Puebla,21,Tlanepantla,21182,2483,2678,5161
2016,Puebla,21,Tlaola,21183,10158,10681,20839
2016,Puebla,21,Tlapacoya,21184,3286,3432,6718
2016,Puebla,21,Tlapanalá,21185,4142,4663,8805
2016,Puebla,21,Tlatlauquitepec,21186,26367,28785,55152
2016,Puebla,21,Tlaxco,21187,2798,2826,5624
2016,Puebla,21,Tochimilco,21188,8596,9659,18255
2016,Puebla,21,Tochtepec,21189,10391,11241,21632
2016,Puebla,21,Totoltepec de Guerrero,21190,563,674,1237
2016,Puebla,21,Tulcingo,21191,4631,5309,9940
2016,Puebla,21,Tuzamapan de Galeana,21192,3197,3358,6555
2016,Puebla,21,Tzicatlacoyan,21193,3503,3596,7099
2016,Puebla,21,Venustiano Carranza,21194,14467,15620,30087
2016,Puebla,21,Vicente Guerrero,21195,12066,13065,25131
2016,Puebla,21,Xayacatlán de Bravo,21196,738,887,1625
2016,Puebla,21,Xicotepec,21197,40157,42994,83151
2016,Puebla,21,Xicotlán,21198,601,665,1266
2016,Puebla,21,Xiutetelco,21199,19817,21123,40940
2016,Puebla,21,Xochiapulco,21200,1780,1935,3715
2016,Puebla,21,Xochiltepec,21201,1548,1855,3403
2016,Puebla,21,Xochitlán Todos Santos,21203,3074,3434,6508
2016,Puebla,21,Xochitlán de Vicente Suárez,21202,6374,6721,13095
2016,Puebla,21,Yaonáhuac,21204,3934,4249,8183
2016,Puebla,21,Yehualtepec,21205,12308,13023,25331
2016,Puebla,21,Zacapala,21206,2126,2395,4521
2016,Puebla,21,Zacapoaxtla,21207,27336,29789,57125
2016,Puebla,21,Zacatlán,21208,40039,43983,84022
2016,Puebla,21,Zapotitlán,21209,4005,4760,8765
2016,Puebla,21,Zapotitlán de Méndez,21210,2870,2925,5795
2016,Puebla,21,Zaragoza,21211,7770,8959,16729
2016,Puebla,21,Zautla,21212,9420,10557,19977
2016,Puebla,21,Zihuateutla,21213,6689,7027,13716
2016,Puebla,21,Zinacatepec,21214,8234,9085,17319
2016,Puebla,21,Zongozotla,21215,2502,2569,5071
2016,Puebla,21,Zoquiapan,21216,1236,1388,2624
2016,Puebla,21,Zoquitlán,21217,9592,10155,19747
2016,Querétaro,22,Amealco de Bonfil,22001,31919,33695,65614
2016,Querétaro,22,Arroyo Seco,22003,6765,7347,14112
2016,Querétaro,22,Cadereyta de Montes,22004,34485,37530,72015
2016,Querétaro,22,Colón,22005,32821,32225,65046
2016,Querétaro,22,Corregidora,22006,88731,94275,183006
2016,Querétaro,22,El Marqués,22011,79088,78297,157385
2016,Querétaro,22,Ezequiel Montes,22007,20694,22143,42837
2016,Querétaro,22,Huimilpan,22008,19250,20605,39855
2016,Querétaro,22,Jalpan de Serra,22009,13399,14581,27980
2016,Querétaro,22,Landa de Matamoros,22010,9589,10372,19961
2016,Querétaro,22,Pedro Escobedo,22012,35551,36003,71554
2016,Querétaro,22,Peñamiller,22013,10225,10524,20749
2016,Querétaro,22,Pinal de Amoles,22002,13373,14227,27600
2016,Querétaro,22,Querétaro,22014,453639,461036,914675
2016,Querétaro,22,San Joaquín,22015,4559,5196,9755
2016,Querétaro,22,San Juan del Río,22016,137110,141856,278966
2016,Querétaro,22,Tequisquiapan,22017,35892,37177,73069
2016,Querétaro,22,Tolimán,22018,14486,15066,29552
2016,Quintana Roo,23,Bacalar,23010,20135,20254,40389
2016,Quintana Roo,23,Benito Juárez,23005,384439,380516,764955
2016,Quintana Roo,23,Cozumel,23001,45952,45700,91652
2016,Quintana Roo,23,Felipe Carrillo Puerto,23002,42716,42304,85020
2016,Quintana Roo,23,Isla Mujeres,23003,10340,9640,19980
2016,Quintana Roo,23,José María Morelos,23006,20310,19413,39723
2016,Quintana Roo,23,Lázaro Cárdenas,23007,14625,14041,28666
2016,Quintana Roo,23,Othón P. Blanco,23004,122983,127377,250360
2016,Quintana Roo,23,Solidaridad,23008,109835,101103,210938
2016,Quintana Roo,23,Tulum,23009,17350,15887,33237
2016,San Luis Potosí,24,Ahualulco,24001,8927,10015,18942
2016,San Luis Potosí,24,Alaquines,24002,4213,4331,8544
2016,San Luis Potosí,24,Aquismón,24003,25249,24624,49873
2016,San Luis Potosí,24,Armadillo de los Infante,24004,2143,2219,4362
2016,San Luis Potosí,24,Axtla de Terrazas,24053,18657,18920,37577
2016,San Luis Potosí,24,Catorce,24006,5091,4913,10004
2016,San Luis Potosí,24,Cedral,24007,9589,9947,19536
2016,San Luis Potosí,24,Cerritos,24008,10761,11477,22238
2016,San Luis Potosí,24,Cerro de San Pedro,24009,2284,2259,4543
2016,San Luis Potosí,24,Charcas,24015,10681,11059,21740
2016,San Luis Potosí,24,Ciudad Fernández,24011,22612,23847,46459
2016,San Luis Potosí,24,Ciudad Valles,24013,88078,93769,181847
2016,San Luis Potosí,24,Ciudad del Maíz,24010,16729,16921,33650
2016,San Luis Potosí,24,Coxcatlán,24014,8337,8210,16547
2016,San Luis Potosí,24,Cárdenas,24005,9303,10126,19429
2016,San Luis Potosí,24,Ebano,24016,21816,22637,44453
2016,San Luis Potosí,24,El Naranjo,24058,11189,11053,22242
2016,San Luis Potosí,24,Guadalcázar,24017,13719,13456,27175
2016,San Luis Potosí,24,Huehuetlán,24018,8074,8272,16346
2016,San Luis Potosí,24,Lagunillas,24019,2822,2949,5771
2016,San Luis Potosí,24,Matehuala,24020,48610,51450,100060
2016,San Luis Potosí,24,Matlapa,24057,15949,15899,31848
2016,San Luis Potosí,24,Mexquitic de Carmona,24021,27497,30025,57522
2016,San Luis Potosí,24,Moctezuma,24022,9642,10452,20094
2016,San Luis Potosí,24,Rayón,24023,7765,8203,15968
2016,San Luis Potosí,24,Rioverde,24024,46903,49999,96902
2016,San Luis Potosí,24,Salinas,24025,15457,16699,32156
2016,San Luis Potosí,24,San Antonio,24026,4987,4754,9741
2016,San Luis Potosí,24,San Ciro de Acosta,24027,5113,5519,10632
2016,San Luis Potosí,24,San Luis Potosí,24028,408844,437055,845899
2016,San Luis Potosí,24,San Martín Chalchicuautla,24029,11048,11079,22127
2016,San Luis Potosí,24,San Nicolás Tolentino,24030,2588,2886,5474
2016,San Luis Potosí,24,San Vicente Tancuayalab,24034,7652,7634,15286
2016,San Luis Potosí,24,Santa Catarina,24031,5899,6189,12088
2016,San Luis Potosí,24,Santa María del Río,24032,19693,21587,41280
2016,San Luis Potosí,24,Santo Domingo,24033,6226,6299,12525
2016,San Luis Potosí,24,Soledad de Graciano Sánchez,24035,149436,157266,306702
2016,San Luis Potosí,24,Tamasopo,24036,15522,15267,30789
2016,San Luis Potosí,24,Tamazunchale,24037,48667,49300,97967
2016,San Luis Potosí,24,Tampacán,24038,8187,8001,16188
2016,San Luis Potosí,24,Tampamolón Corona,24039,7806,7883,15689
2016,San Luis Potosí,24,Tamuín,24040,19698,20157,39855
2016,San Luis Potosí,24,Tancanhuitz,24012,10662,10870,21532
2016,San Luis Potosí,24,Tanlajás,24041,10326,10036,20362
2016,San Luis Potosí,24,Tanquián de Escobedo,24042,7585,7864,15449
2016,San Luis Potosí,24,Tierra Nueva,24043,4477,5090,9567
2016,San Luis Potosí,24,Vanegas,24044,3997,3918,7915
2016,San Luis Potosí,24,Venado,24045,7409,7646,15055
2016,San Luis Potosí,24,Villa Hidalgo,24051,7625,7751,15376
2016,San Luis Potosí,24,Villa Juárez,24052,5144,5329,10473
2016,San Luis Potosí,24,Villa de Arista,24056,7875,7922,15797
2016,San Luis Potosí,24,Villa de Arriaga,24046,8881,9001,17882
2016,San Luis Potosí,24,Villa de Guadalupe,24047,5034,4996,10030
2016,San Luis Potosí,24,Villa de Ramos,24049,18748,19792,38540
2016,San Luis Potosí,24,Villa de Reyes,24050,24795,25130,49925
2016,San Luis Potosí,24,Villa de la Paz,24048,2751,2730,5481
2016,San Luis Potosí,24,Xilitla,24054,26544,27097,53641
2016,San Luis Potosí,24,Zaragoza,24055,12991,13371,26362
2016,Sinaloa,25,Ahome,25001,227390,234237,461627
2016,Sinaloa,25,Angostura,25002,24489,24337,48826
2016,Sinaloa,25,Badiraguato,25003,16821,15619,32440
2016,Sinaloa,25,Choix,25007,17652,16686,34338
2016,Sinaloa,25,Concordia,25004,14787,14281,29068
2016,Sinaloa,25,Cosalá,25005,8871,8443,17314
2016,Sinaloa,25,Culiacán,25006,457409,472571,929980
2016,Sinaloa,25,El Fuerte,25010,53114,51785,104899
2016,Sinaloa,25,Elota,25008,29923,27828,57751
2016,Sinaloa,25,Escuinapa,25009,30513,29718,60231
2016,Sinaloa,25,Guasave,25011,152759,154758,307517
2016,Sinaloa,25,Mazatlán,25012,250260,256342,506602
2016,Sinaloa,25,Mocorito,25013,24624,23175,47799
2016,Sinaloa,25,Navolato,25018,79148,76272,155420
2016,Sinaloa,25,Rosario,25014,28001,26976,54977
2016,Sinaloa,25,Salvador Alvarado,25015,41474,43374,84848
2016,Sinaloa,25,San Ignacio,25016,11897,11005,22902
2016,Sinaloa,25,Sinaloa,25017,47078,45766,92844
2016,Sonora,26,Aconchi,26001,1507,1366,2873
2016,Sonora,26,Agua Prieta,26002,42884,42249,85133
2016,Sonora,26,Alamos,26003,14018,13068,27086
2016,Sonora,26,Altar,26004,4927,4904,9831
2016,Sonora,26,Arivechi,26005,649,623,1272
2016,Sonora,26,Arizpe,26006,1515,1444,2959
2016,Sonora,26,Atil,26007,332,316,648
2016,Sonora,26,Bacadéhuachi,26008,643,577,1220
2016,Sonora,26,Bacanora,26009,431,398,829
2016,Sonora,26,Bacerac,26010,760,713,1473
2016,Sonora,26,Bacoachi,26011,838,833,1671
2016,Sonora,26,Banámichi,26013,862,845,1707
2016,Sonora,26,Bavispe,26015,803,724,1527
2016,Sonora,26,Baviácora,26014,1850,1751,3601
2016,Sonora,26,Benito Juárez,26071,11543,11544,23087
2016,Sonora,26,Benjamín Hill,26016,2722,2795,5517
2016,Sonora,26,Bácum,26012,12108,11974,24082
2016,Sonora,26,Caborca,26017,44124,43560,87684
2016,Sonora,26,Cajeme,26018,218975,228678,447653
2016,Sonora,26,Cananea,26019,18216,18589,36805
2016,Sonora,26,Carbó,26020,2717,2501,5218
2016,Sonora,26,Cucurpe,26022,556,450,1006
2016,Sonora,26,Cumpas,26023,3288,3230,6518
2016,Sonora,26,Divisaderos,26024,401,390,791
2016,Sonora,26,Empalme,26025,28962,29390,58352
2016,Sonora,26,Etchojoa,26026,32532,31545,64077
2016,Sonora,26,Fronteras,26027,4605,4420,9025
2016,Sonora,26,General Plutarco Elías Calles,26070,8713,8475,17188
2016,Sonora,26,Granados,26028,578,557,1135
2016,Sonora,26,Guaymas,26029,80511,81868,162379
2016,Sonora,26,Hermosillo,26030,439792,450188,889980
2016,Sonora,26,Huachinera,26031,688,654,1342
2016,Sonora,26,Huatabampo,26033,42274,42048,84322
2016,Sonora,26,Huásabas,26032,507,453,960
2016,Sonora,26,Huépac,26034,553,520,1073
2016,Sonora,26,Imuris,26035,6621,6575,13196
2016,Sonora,26,La Colorada,26021,1126,916,2042
2016,Sonora,26,Magdalena,26036,15911,16194,32105
2016,Sonora,26,Mazatán,26037,712,634,1346
2016,Sonora,26,Moctezuma,26038,2551,2591,5142
2016,Sonora,26,Naco,26039,3311,3262,6573
2016,Sonora,26,Nacozari de García,26041,7014,6943,13957
2016,Sonora,26,Navojoa,26042,83299,86658,169957
2016,Sonora,26,Nogales,26043,119929,120063,239992
2016,Sonora,26,Nácori Chico,26040,1097,1002,2099
2016,Sonora,26,Onavas,26044,255,213,468
2016,Sonora,26,Opodepe,26045,1515,1349,2864
2016,Sonora,26,Oquitoa,26046,201,221,422
2016,Sonora,26,Pitiquito,26047,5157,4827,9984
2016,Sonora,26,Puerto Peñasco,26048,33581,32453,66034
2016,Sonora,26,Quiriego,26049,1684,1463,3147
2016,Sonora,26,Rayón,26050,845,760,1605
2016,Sonora,26,Rosario,26051,2803,2575,5378
2016,Sonora,26,Sahuaripa,26052,3104,2947,6051
2016,Sonora,26,San Felipe de Jesús,26053,212,207,419
2016,Sonora,26,San Ignacio Río Muerto,26072,7757,7369,15126
2016,Sonora,26,San Javier,26054,333,262,595
2016,Sonora,26,San Luis Río Colorado,26055,98649,97798,196447
2016,Sonora,26,San Miguel de Horcasitas,26056,5066,4384,9450
2016,Sonora,26,San Pedro de la Cueva,26057,855,749,1604
2016,Sonora,26,Santa Ana,26058,8402,8625,17027
2016,Sonora,26,Santa Cruz,26059,980,997,1977
2016,Sonora,26,Soyopa,26061,776,644,1420
2016,Sonora,26,Suaqui Grande,26062,643,551,1194
2016,Sonora,26,Sáric,26060,961,900,1861
2016,Sonora,26,Tepache,26063,713,661,1374
2016,Sonora,26,Trincheras,26064,935,789,1724
2016,Sonora,26,Tubutama,26065,724,688,1412
2016,Sonora,26,Ures,26066,4776,4568,9344
2016,Sonora,26,Villa Hidalgo,26067,867,805,1672
2016,Sonora,26,Villa Pesqueira,26068,701,586,1287
2016,Sonora,26,Yécora,26069,3211,3136,6347
2016,Tabasco,27,Balancán,27001,31019,31095,62114
2016,Tabasco,27,Centla,27003,56438,56286,112724
2016,Tabasco,27,Centro,27004,344471,359354,703825
2016,Tabasco,27,Comalcalco,27005,102925,105536,208461
2016,Tabasco,27,Cunduacán,27006,69372,71284,140656
2016,Tabasco,27,Cárdenas,27002,130850,135230,266080
2016,Tabasco,27,Emiliano Zapata,27007,15328,16522,31850
2016,Tabasco,27,Huimanguillo,27008,95662,97776,193438
2016,Tabasco,27,Jalapa,27009,19916,19784,39700
2016,Tabasco,27,Jalpa de Méndez,27010,44875,45071,89946
2016,Tabasco,27,Jonuta,27011,16114,15841,31955
2016,Tabasco,27,Macuspana,27012,83689,86344,170033
2016,Tabasco,27,Nacajuca,27013,67424,69874,137298
2016,Tabasco,27,Paraíso,27014,48182,48573,96755
2016,Tabasco,27,Tacotalpa,27015,25194,25070,50264
2016,Tabasco,27,Teapa,27016,29442,30342,59784
2016,Tabasco,27,Tenosique,27017,30527,31963,62490
2016,Tamaulipas,28,Abasolo,28001,6305,6284,12589
2016,Tamaulipas,28,Aldama,28002,15380,15087,30467
2016,Tamaulipas,28,Altamira,28003,118350,119438,237788
2016,Tamaulipas,28,Antiguo Morelos,28004,4973,5005,9978
2016,Tamaulipas,28,Burgos,28005,2449,2277,4726
2016,Tamaulipas,28,Bustamante,28006,4280,3934,8214
2016,Tamaulipas,28,Camargo,28007,8393,8129,16522
2016,Tamaulipas,28,Casas,28008,2324,2075,4399
2016,Tamaulipas,28,Ciudad Madero,28009,103724,113024,216748
2016,Tamaulipas,28,Cruillas,28010,1060,1024,2084
2016,Tamaulipas,28,El Mante,28021,59796,62989,122785
2016,Tamaulipas,28,González,28012,22554,22792,45346
2016,Tamaulipas,28,Guerrero,28014,2394,2219,4613
2016,Tamaulipas,28,Gustavo Díaz Ordaz,28015,8249,8034,16283
2016,Tamaulipas,28,Gómez Farías,28011,4853,4600,9453
2016,Tamaulipas,28,Güémez,28013,8398,7761,16159
2016,Tamaulipas,28,Hidalgo,28016,12473,11809,24282
2016,Tamaulipas,28,Jaumave,28017,8075,7805,15880
2016,Tamaulipas,28,Jiménez,28018,4317,4268,8585
2016,Tamaulipas,28,Llera,28019,9030,8725,17755
2016,Tamaulipas,28,Mainero,28020,1343,1298,2641
2016,Tamaulipas,28,Matamoros,28022,262382,268701,531083
2016,Tamaulipas,28,Mier,28024,2411,2469,4880
2016,Tamaulipas,28,Miguel Alemán,28025,14157,14168,28325
2016,Tamaulipas,28,Miquihuana,28026,1946,1761,3707
2016,Tamaulipas,28,Méndez,28023,2317,2129,4446
2016,Tamaulipas,28,Nuevo Laredo,28027,205285,204589,409874
2016,Tamaulipas,28,Nuevo Morelos,28028,1890,1728,3618
2016,Tamaulipas,28,Ocampo,28029,7194,6932,14126
2016,Tamaulipas,28,Padilla,28030,7306,7151,14457
2016,Tamaulipas,28,Palmillas,28031,912,891,1803
2016,Tamaulipas,28,Reynosa,28032,326435,325799,652234
2016,Tamaulipas,28,Río Bravo,28033,64392,63879,128271
2016,Tamaulipas,28,San Carlos,28034,4936,4474,9410
2016,Tamaulipas,28,San Fernando,28035,29780,29325,59105
2016,Tamaulipas,28,San Nicolás,28036,569,516,1085
2016,Tamaulipas,28,Soto la Marina,28037,13393,12657,26050
2016,Tamaulipas,28,Tampico,28038,157146,169999,327145
2016,Tamaulipas,28,Tula,28039,14939,14957,29896
2016,Tamaulipas,28,Valle Hermoso,28040,32994,33902,66896
2016,Tamaulipas,28,Victoria,28041,172568,179744,352312
2016,Tamaulipas,28,Villagrán,28042,3395,3151,6546
2016,Tamaulipas,28,Xicoténcatl,28043,12294,12244,24538
2016,Tlaxcala,29,Acuamanala de Miguel Hidalgo,29022,3180,3172,6352
2016,Tlaxcala,29,Altzayanca,29004,8860,8833,17693
2016,Tlaxcala,29,Amaxac de Guerrero,29001,5541,5705,11246
2016,Tlaxcala,29,Apetatitlán de Antonio Carvajal,29002,7538,8004,15542
2016,Tlaxcala,29,Apizaco,29005,39808,43491,83299
2016,Tlaxcala,29,Atlangatepec,29003,3313,3444,6757
2016,Tlaxcala,29,Benito Juárez,29045,3072,3160,6232
2016,Tlaxcala,29,Calpulalpan,29006,24330,25584,49914
2016,Tlaxcala,29,Chiautempan,29010,35589,38057,73646
2016,Tlaxcala,29,Contla de Juan Cuamatzi,29018,19514,20021,39535
2016,Tlaxcala,29,Cuapiaxtla,29008,7813,7783,15596
2016,Tlaxcala,29,Cuaxomulco,29009,2734,2748,5482
2016,Tlaxcala,29,El Carmen Tequexquitla,29007,8615,8836,17451
2016,Tlaxcala,29,Emiliano Zapata,29046,2272,2380,4652
2016,Tlaxcala,29,Españita,29012,4531,4584,9115
2016,Tlaxcala,29,Huamantla,29013,46835,48631,95466
2016,Tlaxcala,29,Hueyotlipan,29014,7488,7623,15111
2016,Tlaxcala,29,Ixtacuixtla de Mariano Matamoros,29015,19255,20384,39639
2016,Tlaxcala,29,Ixtenco,29016,3585,3865,7450
2016,Tlaxcala,29,La Magdalena Tlaltelulco,29048,9221,9865,19086
2016,Tlaxcala,29,Lázaro Cárdenas,29047,1561,1589,3150
2016,Tlaxcala,29,Mazatecochco de José María Morelos,29017,5488,5586,11074
2016,Tlaxcala,29,Muñoz de Domingo Arenas,29011,2412,2373,4785
2016,Tlaxcala,29,Nanacamilpa de Mariano Arista,29021,9132,9545,18677
2016,Tlaxcala,29,Natívitas,29023,12579,13487,26066
2016,Tlaxcala,29,Panotla,29024,13585,14406,27991
2016,Tlaxcala,29,Papalotla de Xicohténcatl,29041,14991,16021,31012
2016,Tlaxcala,29,San Damián Texóloc,29049,2848,2881,5729
2016,Tlaxcala,29,San Francisco Tetlanohcan,29050,5485,5761,11246
2016,Tlaxcala,29,San Jerónimo Zacualpan,29051,1852,2067,3919
2016,Tlaxcala,29,San José Teacalco,29052,3008,3162,6170
2016,Tlaxcala,29,San Juan Huactzinco,29053,3695,4045,7740
2016,Tlaxcala,29,San Lorenzo Axocomanitla,29054,2779,2998,5777
2016,Tlaxcala,29,San Lucas Tecopilco,29055,1549,1655,3204
2016,Tlaxcala,29,San Pablo del Monte,29025,39277,39573,78850
2016,Tlaxcala,29,Sanctórum de Lázaro Cárdenas,29020,4818,4894,9712
2016,Tlaxcala,29,Santa Ana Nopalucan,29056,3890,4017,7907
2016,Tlaxcala,29,Santa Apolonia Teacalco,29057,2238,2502,4740
2016,Tlaxcala,29,Santa Catarina Ayometla,29058,4345,4702,9047
2016,Tlaxcala,29,Santa Cruz Quilehtla,29059,3588,3621,7209
2016,Tlaxcala,29,Santa Cruz Tlaxcala,29026,10124,10459,20583
2016,Tlaxcala,29,Santa Isabel Xiloxoxtla,29060,2478,2609,5087
2016,Tlaxcala,29,Tenancingo,29027,6481,6746,13227
2016,Tlaxcala,29,Teolocholco,29028,12002,12734,24736
2016,Tlaxcala,29,Tepetitla de Lardizábal,29019,10333,11094,21427
2016,Tlaxcala,29,Tepeyanco,29029,6120,6692,12812
2016,Tlaxcala,29,Terrenate,29030,7676,7605,15281
2016,Tlaxcala,29,Tetla de la Solidaridad,29031,16246,16702,32948
2016,Tlaxcala,29,Tetlatlahuca,29032,6818,7206,14024
2016,Tlaxcala,29,Tlaxcala,29033,47593,52001,99594
2016,Tlaxcala,29,Tlaxco,29034,21640,22380,44020
2016,Tlaxcala,29,Tocatlán,29035,3005,3076,6081
2016,Tlaxcala,29,Totolac,29036,11058,11964,23022
2016,Tlaxcala,29,Tzompantepec,29038,8211,8745,16956
2016,Tlaxcala,29,Xaloztoc,29039,12293,12215,24508
2016,Tlaxcala,29,Xaltocan,29040,5224,5566,10790
2016,Tlaxcala,29,Xicohtzinco,29042,6663,7313,13976
2016,Tlaxcala,29,Yauhquemehcan,29043,18820,20004,38824
2016,Tlaxcala,29,Zacatelco,29044,21129,22909,44038
2016,Tlaxcala,29,Ziltlaltépec de Trinidad Sánchez Santos,29037,4417,4795,9212
2016,Veracruz,30,Acajete,30001,4599,4332,8931
2016,Veracruz,30,Acatlán,30002,1602,1659,3261
2016,Veracruz,30,Acayucan,30003,43325,46484,89809
2016,Veracruz,30,Actopan,30004,21928,22651,44579
2016,Veracruz,30,Acula,30005,2777,2764,5541
2016,Veracruz,30,Acultzingo,30006,11351,11732,23083
2016,Veracruz,30,Agua Dulce,30204,24096,25469,49565
2016,Veracruz,30,Alpatláhuac,30008,5135,5170,10305
2016,Veracruz,30,Alto Lucero de Gutiérrez Barrios,30009,15046,14971,30017
2016,Veracruz,30,Altotonga,30010,32088,34184,66272
2016,Veracruz,30,Alvarado,30011,27527,27820,55347
2016,Veracruz,30,Amatitlán,30012,4043,4201,8244
2016,Veracruz,30,Amatlán de los Reyes,30014,22422,23932,46354
2016,Veracruz,30,Angel R. Cabada,30015,17264,18181,35445
2016,Veracruz,30,Apazapan,30017,2085,2102,4187
2016,Veracruz,30,Aquila,30018,930,1003,1933
2016,Veracruz,30,Astacinga,30019,3034,3443,6477
2016,Veracruz,30,Atlahuilco,30020,5337,5599,10936
2016,Veracruz,30,Atoyac,30021,11937,12674,24611
2016,Veracruz,30,Atzacan,30022,10735,10978,21713
2016,Veracruz,30,Atzalan,30023,25792,25809,51601
2016,Veracruz,30,Ayahualulco,30025,13551,13592,27143
2016,Veracruz,30,Banderilla,30026,11403,12610,24013
2016,Veracruz,30,Benito Juárez,30027,8860,9239,18099
2016,Veracruz,30,Boca del Río,30028,70848,79460,150308
2016,Veracruz,30,Calcahualco,30029,6744,6633,13377
2016,Veracruz,30,Camarón de Tejeda,30007,3333,3320,6653
2016,Veracruz,30,Camerino Z. Mendoza,30030,20902,23296,44198
2016,Veracruz,30,Carlos A. Carrillo,30208,12171,13168,25339
2016,Veracruz,30,Carrillo Puerto,30031,8511,8863,17374
2016,Veracruz,30,Castillo de Teayo,30157,10320,10132,20452
2016,Veracruz,30,Catemaco,30032,24978,26501,51479
2016,Veracruz,30,Cazones de Herrera,30033,12028,12663,24691
2016,Veracruz,30,Cerro Azul,30034,13215,14604,27819
2016,Veracruz,30,Chacaltianguis,30054,6256,6590,12846
2016,Veracruz,30,Chalma,30055,6863,7036,13899
2016,Veracruz,30,Chiconamel,30056,3433,3591,7024
2016,Veracruz,30,Chiconquiaco,30057,7218,7247,14465
2016,Veracruz,30,Chicontepec,30058,28529,29817,58346
2016,Veracruz,30,Chinameca,30059,8108,8488,16596
2016,Veracruz,30,Chinampa de Gorostiza,30060,8327,8556,16883
2016,Veracruz,30,Chocamán,30062,10471,10575,21046
2016,Veracruz,30,Chontla,30063,7620,7626,15246
2016,Veracruz,30,Chumatlán,30064,1958,2053,4011
2016,Veracruz,30,Citlaltépetl,30035,6011,6243,12254
2016,Veracruz,30,Coacoatzintla,30036,5128,5361,10489
2016,Veracruz,30,Coahuitlán,30037,4253,4346,8599
2016,Veracruz,30,Coatepec,30038,45945,49009,94954
2016,Veracruz,30,Coatzacoalcos,30039,160320,169843,330163
2016,Veracruz,30,Coatzintla,30040,27568,28972,56540
2016,Veracruz,30,Coetzala,30041,1135,1166,2301
2016,Veracruz,30,Colipa,30042,2937,3037,5974
2016,Veracruz,30,Comapa,30043,10435,10016,20451
2016,Veracruz,30,Cosamaloapan de Carpio,30045,28323,30668,58991
2016,Veracruz,30,Cosautlán de Carvajal,30046,8366,8447,16813
2016,Veracruz,30,Coscomatepec,30047,28753,29591,58344
2016,Veracruz,30,Cosoleacaque,30048,68150,72909,141059
2016,Veracruz,30,Cotaxtla,30049,10752,10802,21554
2016,Veracruz,30,Coxquihui,30050,8366,8663,17029
2016,Veracruz,30,Coyutla,30051,11229,11981,23210
2016,Veracruz,30,Cuichapa,30052,5968,6580,12548
2016,Veracruz,30,Cuitláhuac,30053,13591,14909,28500
2016,Veracruz,30,Córdoba,30044,104358,117321,221679
2016,Veracruz,30,El Higo,30205,10094,10118,20212
2016,Veracruz,30,Emiliano Zapata,30065,37556,40125,77681
2016,Veracruz,30,Espinal,30066,13659,14203,27862
2016,Veracruz,30,Filomeno Mata,30067,9222,9156,18378
2016,Veracruz,30,Fortín,30068,31897,35282,67179
2016,Veracruz,30,Gutiérrez Zamora,30069,12175,13652,25827
2016,Veracruz,30,Hidalgotitlán,30070,9833,9567,19400
2016,Veracruz,30,Huatusco,30071,29555,31499,61054
2016,Veracruz,30,Huayacocotla,30072,10681,11312,21993
2016,Veracruz,30,Hueyapan de Ocampo,30073,21637,22716,44353
2016,Veracruz,30,Huiloapan de Cuauhtémoc,30074,3586,3819,7405
2016,Veracruz,30,Ignacio de la Llave,30075,8721,9362,18083
2016,Veracruz,30,Ilamatlán,30076,6754,7342,14096
2016,Veracruz,30,Isla,30077,21901,22821,44722
2016,Veracruz,30,Ixcatepec,30078,6967,6948,13915
2016,Veracruz,30,Ixhuacán de los Reyes,30079,5893,5758,11651
2016,Veracruz,30,Ixhuatlancillo,30081,12103,13094,25197
2016,Veracruz,30,Ixhuatlán de Madero,30083,27025,28074,55099
2016,Veracruz,30,Ixhuatlán del Café,30080,11626,11667,23293
2016,Veracruz,30,Ixhuatlán del Sureste,30082,8099,8059,16158
2016,Veracruz,30,Ixmatlahuacan,30084,3010,3042,6052
2016,Veracruz,30,Ixtaczoquitlán,30085,34475,36439,70914
2016,Veracruz,30,Jalacingo,30086,22085,22823,44908
2016,Veracruz,30,Jalcomulco,30088,2667,2601,5268
2016,Veracruz,30,Jamapa,30090,5711,5884,11595
2016,Veracruz,30,Jesús Carranza,30091,14614,14724,29338
2016,Veracruz,30,Jilotepec,30093,8235,8668,16903
2016,Veracruz,30,José Azueta,30169,11908,12337,24245
2016,Veracruz,30,Juan Rodríguez Clara,30094,19749,20203,39952
2016,Veracruz,30,Juchique de Ferrer,30095,8344,8476,16820
2016,Veracruz,30,Jáltipan,30089,20501,22293,42794
2016,Veracruz,30,La Antigua,30016,13533,14427,27960
2016,Veracruz,30,La Perla,30127,13490,13894,27384
2016,Veracruz,30,Landero y Coss,30096,792,843,1635
2016,Veracruz,30,Las Choapas,30061,40602,42084,82686
2016,Veracruz,30,Las Minas,30107,1563,1486,3049
2016,Veracruz,30,Las Vigas de Ramírez,30132,9840,9891,19731
2016,Veracruz,30,Lerdo de Tejada,30097,9742,11036,20778
2016,Veracruz,30,Los Reyes,30137,2959,2991,5950
2016,Veracruz,30,Magdalena,30098,1564,1563,3127
2016,Veracruz,30,Maltrata,30099,8810,9430,18240
2016,Veracruz,30,Manlio Fabio Altamirano,30100,11955,12235,24190
2016,Veracruz,30,Mariano Escobedo,30101,18074,19379,37453
2016,Veracruz,30,Martínez de la Torre,30102,53566,57726,111292
2016,Veracruz,30,Mecatlán,30103,6262,6399,12661
2016,Veracruz,30,Mecayapan,30104,8420,8765,17185
2016,Veracruz,30,Medellín,30105,36185,39086,75271
2016,Veracruz,30,Miahuatlán,30106,2355,2431,4786
2016,Veracruz,30,Minatitlán,30108,78906,83918,162824
2016,Veracruz,30,Misantla,30109,32657,34074,66731
2016,Veracruz,30,Mixtla de Altamirano,30110,5899,5762,11661
2016,Veracruz,30,Moloacán,30111,8651,9092,17743
2016,Veracruz,30,Nanchital de Lázaro Cárdenas del Rio,30206,14840,15668,30508
2016,Veracruz,30,Naolinco,30112,10925,11369,22294
2016,Veracruz,30,Naranjal,30113,2320,2438,4758
2016,Veracruz,30,Naranjos Amatlán,30013,14009,15461,29470
2016,Veracruz,30,Nautla,30114,5492,5693,11185
2016,Veracruz,30,Nogales,30115,18439,20051,38490
2016,Veracruz,30,Oluta,30116,8049,8653,16702
2016,Veracruz,30,Omealca,30117,11878,12701,24579
2016,Veracruz,30,Orizaba,30118,60987,70775,131762
2016,Veracruz,30,Otatitlán,30119,2817,3060,5877
2016,Veracruz,30,Oteapan,30120,8028,8327,16355
2016,Veracruz,30,Ozuluama de Mascareñas,30121,12520,11884,24404
2016,Veracruz,30,Pajapan,30122,8846,8755,17601
2016,Veracruz,30,Papantla,30124,82331,84470,166801
2016,Veracruz,30,Paso de Ovejas,30126,17329,17387,34716
2016,Veracruz,30,Paso del Macho,30125,16034,16338,32372
2016,Veracruz,30,Perote,30128,37060,37258,74318
2016,Veracruz,30,Platón Sánchez,30129,9317,9598,18915
2016,Veracruz,30,Playa Vicente,30130,19517,21137,40654
2016,Veracruz,30,Poza Rica de Hidalgo,30131,99523,110241,209764
2016,Veracruz,30,Pueblo Viejo,30133,29980,29717,59697
2016,Veracruz,30,Puente Nacional,30134,11477,11795,23272
2016,Veracruz,30,Pánuco,30123,51823,52025,103848
2016,Veracruz,30,Rafael Delgado,30135,11391,11701,23092
2016,Veracruz,30,Rafael Lucio,30136,3911,4116,8027
2016,Veracruz,30,Río Blanco,30138,20708,23200,43908
2016,Veracruz,30,Saltabarranca,30139,3100,3289,6389
2016,Veracruz,30,San Andrés Tenejapan,30140,1458,1516,2974
2016,Veracruz,30,San Andrés Tuxtla,30141,81790,87721,169511
2016,Veracruz,30,San Juan Evangelista,30142,17233,17765,34998
2016,Veracruz,30,San Rafael,30211,15263,15818,31081
2016,Veracruz,30,Santiago Sochiapan,30212,6935,7384,14319
2016,Veracruz,30,Santiago Tuxtla,30143,28936,30933,59869
2016,Veracruz,30,Sayula de Alemán,30144,16545,17061,33606
2016,Veracruz,30,Sochiapa,30146,1882,1858,3740
2016,Veracruz,30,Soconusco,30145,7938,8325,16263
2016,Veracruz,30,Soledad Atzompa,30147,11641,11705,23346
2016,Veracruz,30,Soledad de Doblado,30148,14342,14565,28907
2016,Veracruz,30,Soteapan,30149,17221,17721,34942
2016,Veracruz,30,Tamalín,30150,6090,6031,12121
2016,Veracruz,30,Tamiahua,30151,12333,12153,24486
2016,Veracruz,30,Tampico Alto,30152,6701,6226,12927
2016,Veracruz,30,Tancoco,30153,2970,3110,6080
2016,Veracruz,30,Tantima,30154,6931,6690,13621
2016,Veracruz,30,Tantoyuca,30155,53461,54040,107501
2016,Veracruz,30,Tatahuicapan de Juárez,30209,7683,8023,15706
2016,Veracruz,30,Tatatila,30156,3123,2848,5971
2016,Veracruz,30,Tecolutla,30158,12573,12871,25444
2016,Veracruz,30,Tehuipango,30159,12682,13380,26062
2016,Veracruz,30,Tempoal,30161,18313,18678,36991
2016,Veracruz,30,Tenampa,30162,3358,3510,6868
2016,Veracruz,30,Tenochtitlán,30163,2596,2795,5391
2016,Veracruz,30,Teocelo,30164,8401,8830,17231
2016,Veracruz,30,Tepatlaxco,30165,4480,4241,8721
2016,Veracruz,30,Tepetlán,30166,5056,4855,9911
2016,Veracruz,30,Tepetzintla,30167,7507,7652,15159
2016,Veracruz,30,Tequila,30168,7614,7814,15428
2016,Veracruz,30,Texcatepec,30170,5513,5714,11227
2016,Veracruz,30,Texhuacán,30171,2619,2890,5509
2016,Veracruz,30,Texistepec,30172,10678,10657,21335
2016,Veracruz,30,Tezonapa,30173,28415,29006,57421
2016,Veracruz,30,Tierra Blanca,30174,51351,55277,106628
2016,Veracruz,30,Tihuatlán,30175,47993,49751,97744
2016,Veracruz,30,Tlachichilco,30180,5894,6071,11965
2016,Veracruz,30,Tlacojalpan,30176,2512,2557,5069
2016,Veracruz,30,Tlacolulan,30177,5800,5613,11413
2016,Veracruz,30,Tlacotalpan,30178,6846,7321,14167
2016,Veracruz,30,Tlacotepec de Mejía,30179,2017,2054,4071
2016,Veracruz,30,Tlalixcoyan,30181,19449,20036,39485
2016,Veracruz,30,Tlalnelhuayocan,30182,9200,9515,18715
2016,Veracruz,30,Tlaltetela,30024,8126,7903,16029
2016,Veracruz,30,Tlapacoyan,30183,30827,32511,63338
2016,Veracruz,30,Tlaquilpa,30184,3657,4146,7803
2016,Veracruz,30,Tlilapan,30185,2637,2737,5374
2016,Veracruz,30,Tomatlán,30186,3532,3635,7167
2016,Veracruz,30,Tonayán,30187,2893,3012,5905
2016,Veracruz,30,Totutla,30188,8870,8921,17791
2016,Veracruz,30,Tres Valles,30207,23436,24635,48071
2016,Veracruz,30,Tuxpan,30189,79682,83504,163186
2016,Veracruz,30,Tuxtilla,30190,1150,1175,2325
2016,Veracruz,30,Ursulo Galván,30191,15358,16245,31603
2016,Veracruz,30,Uxpanapa,30210,14981,14670,29651
2016,Veracruz,30,Vega de Alatorre,30192,10151,10798,20949
2016,Veracruz,30,Veracruz,30193,291012,314294,605306
2016,Veracruz,30,Villa Aldama,30194,5888,5969,11857
2016,Veracruz,30,Xalapa,30087,234882,263814,498696
2016,Veracruz,30,Xico,30092,19247,19654,38901
2016,Veracruz,30,Xoxocotla,30195,2833,2688,5521
2016,Veracruz,30,Yanga,30196,8667,9810,18477
2016,Veracruz,30,Yecuatla,30197,6088,6297,12385
2016,Veracruz,30,Zacualpan,30198,3573,3793,7366
2016,Veracruz,30,Zaragoza,30199,5665,5908,11573
2016,Veracruz,30,Zentla,30200,6929,6776,13705
2016,Veracruz,30,Zongolica,30201,22338,22589,44927
2016,Veracruz,30,Zontecomatlán de López y Fuentes,30202,7403,7505,14908
2016,Veracruz,30,Zozocolco de Hidalgo,30203,7419,7665,15084
2016,Veracruz,30,Álamo Temapache,30160,54356,55009,109365
2016,Yucatán,31,Abalá,31001,3476,3293,6769
2016,Yucatán,31,Acanceh,31002,8344,8317,16661
2016,Yucatán,31,Akil,31003,5626,5811,11437
2016,Yucatán,31,Baca,31004,3036,3076,6112
2016,Yucatán,31,Bokobá,31005,1151,1103,2254
2016,Yucatán,31,Buctzotz,31006,4657,4610,9267
2016,Yucatán,31,Cacalchén,31007,3813,3627,7440
2016,Yucatán,31,Calotmul,31008,2133,2087,4220
2016,Yucatán,31,Cansahcab,31009,2439,2457,4896
2016,Yucatán,31,Cantamayec,31010,1350,1235,2585
2016,Yucatán,31,Celestún,31011,4020,3826,7846
2016,Yucatán,31,Cenotillo,31012,1936,2082,4018
2016,Yucatán,31,Chacsinkín,31016,1552,1511,3063
2016,Yucatán,31,Chankom,31017,2418,2329,4747
2016,Yucatán,31,Chapab,31018,1646,1622,3268
2016,Yucatán,31,Chemax,31019,18683,18340,37023
2016,Yucatán,31,Chichimilá,31021,4322,4267,8589
2016,Yucatán,31,Chicxulub Pueblo,31020,2361,2216,4577
2016,Yucatán,31,Chikindzonot,31022,2216,2137,4353
2016,Yucatán,31,Chocholá,31023,2493,2396,4889
2016,Yucatán,31,Chumayel,31024,1669,1720,3389
2016,Yucatán,31,Conkal,31013,5550,5502,11052
2016,Yucatán,31,Cuncunul,31014,850,815,1665
2016,Yucatán,31,Cuzamá,31015,2732,2641,5373
2016,Yucatán,31,Dzemul,31026,1926,1875,3801
2016,Yucatán,31,Dzidzantún,31027,4401,4266,8667
2016,Yucatán,31,Dzilam González,31029,3290,3097,6387
2016,Yucatán,31,Dzilam de Bravo,31028,1424,1342,2766
2016,Yucatán,31,Dzitás,31030,1986,1887,3873
2016,Yucatán,31,Dzoncauich,31031,1407,1409,2816
2016,Yucatán,31,Dzán,31025,2663,2782,5445
2016,Yucatán,31,Espita,31032,8427,8164,16591
2016,Yucatán,31,Halachó,31033,10512,10239,20751
2016,Yucatán,31,Hocabá,31034,3214,3173,6387
2016,Yucatán,31,Hoctún,31035,3052,3122,6174
2016,Yucatán,31,Homún,31036,4034,3879,7913
2016,Yucatán,31,Huhí,31037,2722,2607,5329
2016,Yucatán,31,Hunucmá,31038,16690,16657,33347
2016,Yucatán,31,Ixil,31039,2147,2048,4195
2016,Yucatán,31,Izamal,31040,13797,13977,27774
2016,Yucatán,31,Kanasín,31041,48407,49003,97410
2016,Yucatán,31,Kantunil,31042,2827,2888,5715
2016,Yucatán,31,Kaua,31043,1606,1527,3133
2016,Yucatán,31,Kinchil,31044,3683,3597,7280
2016,Yucatán,31,Kopomá,31045,1350,1261,2611
2016,Yucatán,31,Mama,31046,1537,1689,3226
2016,Yucatán,31,Maní,31047,2806,2939,5745
2016,Yucatán,31,Maxcanú,31048,11816,11590,23406
2016,Yucatán,31,Mayapán,31049,1896,1786,3682
2016,Yucatán,31,Mocochá,31051,1695,1660,3355
2016,Yucatán,31,Motul,31052,18495,18703,37198
2016,Yucatán,31,Muna,31053,6496,6697,13193
2016,Yucatán,31,Muxupip,31054,1458,1506,2964
2016,Yucatán,31,Mérida,31050,444410,474700,919110
2016,Yucatán,31,Opichén,31055,3519,3379,6898
2016,Yucatán,31,Oxkutzcab,31056,15228,16598,31826
2016,Yucatán,31,Panabá,31057,4062,4029,8091
2016,Yucatán,31,Peto,31058,12867,13007,25874
2016,Yucatán,31,Progreso,31059,30091,30148,60239
2016,Yucatán,31,Quintana Roo,31060,504,499,1003
2016,Yucatán,31,Río Lagartos,31061,1894,1787,3681
2016,Yucatán,31,Sacalum,31062,2566,2394,4960
2016,Yucatán,31,Samahil,31063,2687,2654,5341
2016,Yucatán,31,San Felipe,31065,1050,972,2022
2016,Yucatán,31,Sanahcat,31064,870,876,1746
2016,Yucatán,31,Santa Elena,31066,2031,2118,4149
2016,Yucatán,31,Seyé,31067,5167,4893,10060
2016,Yucatán,31,Sinanché,31068,1708,1565,3273
2016,Yucatán,31,Sotuta,31069,4656,4469,9125
2016,Yucatán,31,Sucilá,31070,2100,2017,4117
2016,Yucatán,31,Sudzal,31071,930,845,1775
2016,Yucatán,31,Suma,31072,977,932,1909
2016,Yucatán,31,Tahdziú,31073,2590,2441,5031
2016,Yucatán,31,Tahmek,31074,1959,1879,3838
2016,Yucatán,31,Teabo,31075,3320,3377,6697
2016,Yucatán,31,Tecoh,31076,9059,8920,17979
2016,Yucatán,31,Tekal de Venegas,31077,1387,1353,2740
2016,Yucatán,31,Tekantó,31078,1973,1988,3961
2016,Yucatán,31,Tekax,31079,21598,22062,43660
2016,Yucatán,31,Tekit,31080,5383,5197,10580
2016,Yucatán,31,Tekom,31081,1666,1651,3317
2016,Yucatán,31,Telchac Pueblo,31082,1957,1917,3874
2016,Yucatán,31,Telchac Puerto,31083,973,887,1860
2016,Yucatán,31,Temax,31084,3748,3700,7448
2016,Yucatán,31,Temozón,31085,8123,7854,15977
2016,Yucatán,31,Tepakán,31086,1168,1113,2281
2016,Yucatán,31,Tetiz,31087,2584,2624,5208
2016,Yucatán,31,Teya,31088,1013,1033,2046
2016,Yucatán,31,Ticul,31089,20443,20835,41278
2016,Yucatán,31,Timucuy,31090,3867,3663,7530
2016,Yucatán,31,Tinum,31091,6244,5985,12229
2016,Yucatán,31,Tixcacalcupul,31092,3678,3591,7269
2016,Yucatán,31,Tixkokob,31093,9225,9335,18560
2016,Yucatán,31,Tixmehuac,31094,2524,2468,4992
2016,Yucatán,31,Tixpéhual,31095,2832,2874,5706
2016,Yucatán,31,Tizimín,31096,39556,40044,79600
2016,Yucatán,31,Tunkás,31097,1865,1801,3666
2016,Yucatán,31,Tzucacab,31098,7687,7472,15159
2016,Yucatán,31,Uayma,31099,2108,1995,4103
2016,Yucatán,31,Ucú,31100,1905,1866,3771
2016,Yucatán,31,Umán,31101,28538,28357,56895
2016,Yucatán,31,Valladolid,31102,40721,41298,82019
2016,Yucatán,31,Xocchel,31103,1811,1732,3543
2016,Yucatán,31,Yaxcabá,31104,8113,7611,15724
2016,Yucatán,31,Yaxkukul,31105,1595,1597,3192
2016,Yucatán,31,Yobaín,31106,1192,1132,2324
2016,Zacatecas,32,Apozol,32001,3089,3279,6368
2016,Zacatecas,32,Apulco,32002,2396,2657,5053
2016,Zacatecas,32,Atolinga,32003,1278,1365,2643
2016,Zacatecas,32,Benito Juárez,32004,2170,2112,4282
2016,Zacatecas,32,Calera,32005,22813,22651,45464
2016,Zacatecas,32,Cañitas de Felipe Pescador,32006,4292,4395,8687
2016,Zacatecas,32,Chalchihuites,32009,5624,5954,11578
2016,Zacatecas,32,Concepción del Oro,32007,6866,6656,13522
2016,Zacatecas,32,Cuauhtémoc,32008,6342,6582,12924
2016,Zacatecas,32,El Plateado de Joaquín Amaro,32015,677,694,1371
2016,Zacatecas,32,El Salvador,32041,1352,1292,2644
2016,Zacatecas,32,Fresnillo,32010,116172,118242,234414
2016,Zacatecas,32,Genaro Codina,32012,4114,4298,8412
2016,Zacatecas,32,General Enrique Estrada,32013,3214,3260,6474
2016,Zacatecas,32,General Francisco R. Murguía,32014,10961,11696,22657
2016,Zacatecas,32,General Pánfilo Natera,32016,11718,12161,23879
2016,Zacatecas,32,Guadalupe,32017,91325,95134,186459
2016,Zacatecas,32,Huanusco,32018,2095,2214,4309
2016,Zacatecas,32,Jalpa,32019,12222,12794,25016
2016,Zacatecas,32,Jerez,32020,29751,31461,61212
2016,Zacatecas,32,Jiménez del Teul,32021,2283,2314,4597
2016,Zacatecas,32,Juan Aldama,32022,10790,11368,22158
2016,Zacatecas,32,Juchipila,32023,6225,6851,13076
2016,Zacatecas,32,Loreto,32024,26852,27146,53998
2016,Zacatecas,32,Luis Moya,32025,6678,6755,13433
2016,Zacatecas,32,Mazapil,32026,9518,8546,18064
2016,Zacatecas,32,Melchor Ocampo,32027,1581,1388,2969
2016,Zacatecas,32,Mezquital del Oro,32028,1250,1358,2608
2016,Zacatecas,32,Miguel Auza,32029,11909,12309,24218
2016,Zacatecas,32,Momax,32030,1244,1334,2578
2016,Zacatecas,32,Monte Escobedo,32031,4702,4823,9525
2016,Zacatecas,32,Morelos,32032,6355,6323,12678
2016,Zacatecas,32,Moyahua de Estrada,32033,2045,2298,4343
2016,Zacatecas,32,Nochistlán de Mejía,32034,13722,15216,28938
2016,Zacatecas,32,Noria de Ángeles,32035,8369,8584,16953
2016,Zacatecas,32,Ojocaliente,32036,21642,22559,44201
2016,Zacatecas,32,Pinos,32038,36939,38201,75140
2016,Zacatecas,32,Pánuco,32037,9091,9022,18113
2016,Zacatecas,32,Río Grande,32039,32063,34067,66130
2016,Zacatecas,32,Sain Alto,32040,11078,11657,22735
2016,Zacatecas,32,Santa María de la Paz,32058,1407,1432,2839
2016,Zacatecas,32,Sombrerete,32042,31904,32612,64516
2016,Zacatecas,32,Susticacán,32043,668,721,1389
2016,Zacatecas,32,Tabasco,32044,7915,8287,16202
2016,Zacatecas,32,Tepechitlán,32045,4311,4685,8996
2016,Zacatecas,32,Tepetongo,32046,3577,3822,7399
2016,Zacatecas,32,Teúl de González Ortega,32047,2678,2793,5471
2016,Zacatecas,32,Tlaltenango de Sánchez Román,32048,13379,13756,27135
2016,Zacatecas,32,Trancoso,32057,9680,9806,19486
2016,Zacatecas,32,Trinidad García de la Cadena,32011,1498,1553,3051
2016,Zacatecas,32,Valparaíso,32049,16915,17408,34323
2016,Zacatecas,32,Vetagrande,32050,5006,5102,10108
2016,Zacatecas,32,Villa García,32052,9669,9793,19462
2016,Zacatecas,32,Villa González Ortega,32053,6561,7001,13562
2016,Zacatecas,32,Villa Hidalgo,32054,9804,9901,19705
2016,Zacatecas,32,Villa de Cos,32051,18284,17975,36259
2016,Zacatecas,32,Villanueva,32055,15317,16011,31328
2016,Zacatecas,32,Zacatecas,32056,73946,77675,151621
2017,Aguascalientes,01,Aguascalientes,01001,453087,470236,923323
2017,Aguascalientes,01,Asientos,01002,24551,24801,49352
2017,Aguascalientes,01,Calvillo,01003,28932,30250,59182
2017,Aguascalientes,01,Cosío,01004,8078,8388,16466
2017,Aguascalientes,01,El Llano,01010,10764,10464,21228
2017,Aguascalientes,01,Jesús María,01005,61481,61149,122630
2017,Aguascalientes,01,Pabellón de Arteaga,01006,23645,24701,48346
2017,Aguascalientes,01,Rincón de Romos,01007,27826,28279,56105
2017,Aguascalientes,01,San Francisco de los Romo,01011,23785,24100,47885
2017,Aguascalientes,01,San José de Gracia,01008,4520,4821,9341
2017,Aguascalientes,01,Tepezalá,01009,10778,11146,21924
2017,Baja California,02,Ensenada,02001,254943,255150,510093
2017,Baja California,02,Mexicali,02002,516666,517393,1034059
2017,Baja California,02,Playas de Rosarito,02005,51071,50839,101910
2017,Baja California,02,Tecate,02003,56100,52524,108624
2017,Baja California,02,Tijuana,02004,852704,855482,1708186
2017,Baja California Sur,03,Comondú,03001,40087,38996,79083
2017,Baja California Sur,03,La Paz,03003,143307,143444,286751
2017,Baja California Sur,03,Loreto,03009,10475,9604,20079
2017,Baja California Sur,03,Los Cabos,03008,156082,147038,303120
2017,Baja California Sur,03,Mulegé,03002,33848,31389,65237
2017,Campeche,04,Calakmul,04010,15357,14930,30287
2017,Campeche,04,Calkiní,04001,29741,30685,60426
2017,Campeche,04,Campeche,04002,145319,155843,301162
2017,Campeche,04,Candelaria,04011,23445,22993,46438
2017,Campeche,04,Carmen,04003,129643,130921,260564
2017,Campeche,04,Champotón,04004,47510,47280,94790
2017,Campeche,04,Escárcega,04009,30057,30898,60955
2017,Campeche,04,Hecelchakán,04005,16469,16573,33042
2017,Campeche,04,Hopelchén,04006,21399,20542,41941
2017,Campeche,04,Palizada,04007,4815,4699,9514
2017,Campeche,04,Tenabo,04008,5811,5528,11339
2017,Chiapas,07,Acacoyagua,07001,9526,9457,18983
2017,Chiapas,07,Acala,07002,16417,16616,33033
2017,Chiapas,07,Acapetahua,07003,14995,14971,29966
2017,Chiapas,07,Aldama,07113,3259,3523,6782
2017,Chiapas,07,Altamirano,07004,17169,16955,34124
2017,Chiapas,07,Amatenango de la Frontera,07006,15793,16690,32483
2017,Chiapas,07,Amatenango del Valle,07007,4967,5343,10310
2017,Chiapas,07,Amatán,07005,10882,10581,21463
2017,Chiapas,07,Angel Albino Corzo,07008,15020,15042,30062
2017,Chiapas,07,Arriaga,07009,20953,22224,43177
2017,Chiapas,07,Bejucal de Ocampo,07010,4042,3998,8040
2017,Chiapas,07,Bella Vista,07011,10530,10714,21244
2017,Chiapas,07,Benemérito de las Américas,07114,10366,10185,20551
2017,Chiapas,07,Berriozábal,07012,26545,26561,53106
2017,Chiapas,07,Bochil,07013,17925,18229,36154
2017,Chiapas,07,Cacahoatán,07015,23738,24894,48632
2017,Chiapas,07,Catazajá,07016,9339,9102,18441
2017,Chiapas,07,Chalchihuitán,07022,8545,8680,17225
2017,Chiapas,07,Chamula,07023,41921,48365,90286
2017,Chiapas,07,Chanal,07024,6256,6313,12569
2017,Chiapas,07,Chapultenango,07025,4029,4030,8059
2017,Chiapas,07,Chenalhó,07026,20359,20792,41151
2017,Chiapas,07,Chiapa de Corzo,07027,51562,53184,104746
2017,Chiapas,07,Chiapilla,07028,3156,3018,6174
2017,Chiapas,07,Chicoasén,07029,2743,2729,5472
2017,Chiapas,07,Chicomuselo,07030,18004,18225,36229
2017,Chiapas,07,Chilón,07031,65292,66617,131909
2017,Chiapas,07,Cintalapa,07017,44756,44749,89505
2017,Chiapas,07,Coapilla,07018,4772,4866,9638
2017,Chiapas,07,Comitán de Domínguez,07019,77489,84617,162106
2017,Chiapas,07,Copainalá,07021,11427,11875,23302
2017,Chiapas,07,El Bosque,07014,11053,11827,22880
2017,Chiapas,07,El Porvenir,07070,7456,7471,14927
2017,Chiapas,07,Escuintla,07032,16433,16988,33421
2017,Chiapas,07,Francisco León,07033,4006,3905,7911
2017,Chiapas,07,Frontera Comalapa,07034,37196,39586,76782
2017,Chiapas,07,Frontera Hidalgo,07035,7303,7626,14929
2017,Chiapas,07,Huehuetán,07037,17974,18950,36924
2017,Chiapas,07,Huitiupán,07039,12283,12124,24407
2017,Chiapas,07,Huixtla,07040,27673,29595,57268
2017,Chiapas,07,Huixtán,07038,12044,12428,24472
2017,Chiapas,07,Ixhuatán,07042,5796,5950,11746
2017,Chiapas,07,Ixtacomitán,07043,5659,5748,11407
2017,Chiapas,07,Ixtapa,07044,14118,14284,28402
2017,Chiapas,07,Ixtapangajoya,07045,2934,2864,5798
2017,Chiapas,07,Jiquipilas,07046,20626,21162,41788
2017,Chiapas,07,Jitotol,07047,10853,10543,21396
2017,Chiapas,07,Juárez,07048,11298,11513,22811
2017,Chiapas,07,La Concordia,07020,24600,24263,48863
2017,Chiapas,07,La Grandeza,07036,3794,3860,7654
2017,Chiapas,07,La Independencia,07041,23155,24135,47290
2017,Chiapas,07,La Libertad,07050,2641,2719,5360
2017,Chiapas,07,La Trinitaria,07099,39516,41565,81081
2017,Chiapas,07,Larráinzar,07049,11954,12345,24299
2017,Chiapas,07,Las Margaritas,07052,63321,64556,127877
2017,Chiapas,07,Las Rosas,07075,14707,14992,29699
2017,Chiapas,07,Mapastepec,07051,24451,25226,49677
2017,Chiapas,07,Maravilla Tenejapa,07115,6741,6497,13238
2017,Chiapas,07,Marqués de Comillas,07116,5897,5730,11627
2017,Chiapas,07,Mazapa de Madero,07053,4072,4192,8264
2017,Chiapas,07,Mazatán,07054,15087,15438,30525
2017,Chiapas,07,Metapa,07055,2879,3076,5955
2017,Chiapas,07,Mitontic,07056,6260,6361,12621
2017,Chiapas,07,Montecristo de Guerrero,07117,4085,3958,8043
2017,Chiapas,07,Motozintla,07057,37609,38861,76470
2017,Chiapas,07,Nicolás Ruíz,07058,2358,2232,4590
2017,Chiapas,07,Ocosingo,07059,113327,114073,227400
2017,Chiapas,07,Ocotepec,07060,6510,6726,13236
2017,Chiapas,07,Ocozocoautla de Espinosa,07061,47350,48366,95716
2017,Chiapas,07,Ostuacán,07062,9687,9557,19244
2017,Chiapas,07,Osumacinta,07063,2005,1994,3999
2017,Chiapas,07,Oxchuc,07064,25012,24773,49785
2017,Chiapas,07,Palenque,07065,62013,63825,125838
2017,Chiapas,07,Pantelhó,07066,11510,11670,23180
2017,Chiapas,07,Pantepec,07067,6314,6380,12694
2017,Chiapas,07,Pichucalco,07068,16510,16803,33313
2017,Chiapas,07,Pijijiapan,07069,27732,28420,56152
2017,Chiapas,07,Pueblo Nuevo Solistahuacán,07072,16358,17586,33944
2017,Chiapas,07,Rayón,07073,5026,5081,10107
2017,Chiapas,07,Reforma,07074,23323,23736,47059
2017,Chiapas,07,Sabanilla,07076,14229,14070,28299
2017,Chiapas,07,Salto de Agua,07077,32849,33152,66001
2017,Chiapas,07,San Andrés Duraznal,07118,2680,2824,5504
2017,Chiapas,07,San Cristóbal de las Casas,07078,104762,114989,219751
2017,Chiapas,07,San Fernando,07079,20430,20057,40487
2017,Chiapas,07,San Juan Cancuc,07112,17343,18083,35426
2017,Chiapas,07,San Lucas,07110,3794,3786,7580
2017,Chiapas,07,Santiago el Pinar,07119,1915,1890,3805
2017,Chiapas,07,Siltepec,07080,19667,19069,38736
2017,Chiapas,07,Simojovel,07081,22621,22974,45595
2017,Chiapas,07,Sitalá,07082,7231,7299,14530
2017,Chiapas,07,Socoltenango,07083,9686,9783,19469
2017,Chiapas,07,Solosuchiapa,07084,4335,4319,8654
2017,Chiapas,07,Soyaló,07085,5652,5579,11231
2017,Chiapas,07,Suchiapa,07086,12568,12504,25072
2017,Chiapas,07,Suchiate,07087,19851,20677,40528
2017,Chiapas,07,Sunuapa,07088,1265,1220,2485
2017,Chiapas,07,Tapachula,07089,176079,191019,367098
2017,Chiapas,07,Tapalapa,07090,2062,2185,4247
2017,Chiapas,07,Tapilula,07091,6625,6915,13540
2017,Chiapas,07,Tecpatán,07092,21881,22215,44096
2017,Chiapas,07,Tenejapa,07093,22361,23485,45846
2017,Chiapas,07,Teopisca,07094,21736,22952,44688
2017,Chiapas,07,Tila,07096,40836,40659,81495
2017,Chiapas,07,Tonalá,07097,46700,47856,94556
2017,Chiapas,07,Totolapa,07098,3787,3758,7545
2017,Chiapas,07,Tumbalá,07100,17585,18330,35915
2017,Chiapas,07,Tuxtla Chico,07102,21290,22435,43725
2017,Chiapas,07,Tuxtla Gutiérrez,07101,303133,332050,635183
2017,Chiapas,07,Tuzantán,07103,16228,16721,32949
2017,Chiapas,07,Tzimol,07104,7897,8245,16142
2017,Chiapas,07,Unión Juárez,07105,7859,8273,16132
2017,Chiapas,07,Venustiano Carranza,07106,34249,34361,68610
2017,Chiapas,07,Villa Comaltitlán,07071,15144,15476,30620
2017,Chiapas,07,Villa Corzo,07107,40895,42156,83051
2017,Chiapas,07,Villaflores,07108,54674,56751,111425
2017,Chiapas,07,Yajalón,07109,19440,20238,39678
2017,Chiapas,07,Zinacantán,07111,20025,22642,42667
2017,Chihuahua,08,Ahumada,08001,6424,6237,12661
2017,Chihuahua,08,Aldama,08002,12477,12593,25070
2017,Chihuahua,08,Allende,08003,4616,4511,9127
2017,Chihuahua,08,Aquiles Serdán,08004,8984,8395,17379
2017,Chihuahua,08,Ascensión,08005,13060,12680,25740
2017,Chihuahua,08,Bachíniva,08006,3300,3162,6462
2017,Chihuahua,08,Balleza,08007,8944,8641,17585
2017,Chihuahua,08,Batopilas,08008,6548,6514,13062
2017,Chihuahua,08,Bocoyna,08009,14539,15081,29620
2017,Chihuahua,08,Buenaventura,08010,12193,11965,24158
2017,Chihuahua,08,Camargo,08011,26206,27125,53331
2017,Chihuahua,08,Carichí,08012,4832,4770,9602
2017,Chihuahua,08,Casas Grandes,08013,5904,5645,11549
2017,Chihuahua,08,Chihuahua,08019,444200,466897,911097
2017,Chihuahua,08,Chínipas,08020,4372,3955,8327
2017,Chihuahua,08,Coronado,08014,1182,1089,2271
2017,Chihuahua,08,Coyame del Sotol,08015,949,792,1741
2017,Chihuahua,08,Cuauhtémoc,08017,83878,88769,172647
2017,Chihuahua,08,Cusihuiriachi,08018,2605,2436,5041
2017,Chihuahua,08,Delicias,08021,75067,78271,153338
2017,Chihuahua,08,Dr. Belisario Domínguez,08022,1374,1334,2708
2017,Chihuahua,08,El Tule,08064,926,887,1813
2017,Chihuahua,08,Galeana,08023,3330,3329,6659
2017,Chihuahua,08,Gran Morelos,08026,1427,1367,2794
2017,Chihuahua,08,Guachochi,08027,24070,24967,49037
2017,Chihuahua,08,Guadalupe,08028,2817,2828,5645
2017,Chihuahua,08,Guadalupe y Calvo,08029,29009,28392,57401
2017,Chihuahua,08,Guazapares,08030,4316,4127,8443
2017,Chihuahua,08,Guerrero,08031,20713,20449,41162
2017,Chihuahua,08,Gómez Farías,08025,4597,4608,9205
2017,Chihuahua,08,Hidalgo del Parral,08032,55528,58934,114462
2017,Chihuahua,08,Huejotitán,08033,520,516,1036
2017,Chihuahua,08,Ignacio Zaragoza,08034,3662,3592,7254
2017,Chihuahua,08,Janos,08035,5888,5384,11272
2017,Chihuahua,08,Jiménez,08036,22096,22317,44413
2017,Chihuahua,08,Julimes,08038,2458,2355,4813
2017,Chihuahua,08,Juárez,08037,718852,717167,1436019
2017,Chihuahua,08,La Cruz,08016,2085,1984,4069
2017,Chihuahua,08,López,08039,2186,2030,4216
2017,Chihuahua,08,Madera,08040,15488,15225,30713
2017,Chihuahua,08,Maguarichi,08041,914,856,1770
2017,Chihuahua,08,Manuel Benavides,08042,827,700,1527
2017,Chihuahua,08,Matachí,08043,1613,1590,3203
2017,Chihuahua,08,Matamoros,08044,2380,2288,4668
2017,Chihuahua,08,Meoqui,08045,23210,23579,46789
2017,Chihuahua,08,Morelos,08046,4222,4135,8357
2017,Chihuahua,08,Moris,08047,2812,2609,5421
2017,Chihuahua,08,Namiquipa,08048,12447,11910,24357
2017,Chihuahua,08,Nonoava,08049,1430,1350,2780
2017,Chihuahua,08,Nuevo Casas Grandes,08050,31786,33133,64919
2017,Chihuahua,08,Ocampo,08051,4049,3693,7742
2017,Chihuahua,08,Ojinaga,08052,14375,14180,28555
2017,Chihuahua,08,Praxedis G. Guerrero,08053,2809,2743,5552
2017,Chihuahua,08,Riva Palacio,08054,4181,4032,8213
2017,Chihuahua,08,Rosales,08055,8993,8813,17806
2017,Chihuahua,08,Rosario,08056,1092,1058,2150
2017,Chihuahua,08,San Francisco de Borja,08057,1204,1142,2346
2017,Chihuahua,08,San Francisco de Conchos,08058,1440,1335,2775
2017,Chihuahua,08,San Francisco del Oro,08059,2630,2605,5235
2017,Chihuahua,08,Santa Bárbara,08060,5539,5599,11138
2017,Chihuahua,08,Santa Isabel,08024,2085,2108,4193
2017,Chihuahua,08,Satevó,08061,1772,1643,3415
2017,Chihuahua,08,Saucillo,08062,16536,16390,32926
2017,Chihuahua,08,Temósachic,08063,3460,3274,6734
2017,Chihuahua,08,Urique,08065,10993,10662,21655
2017,Chihuahua,08,Uruachi,08066,3501,3345,6846
2017,Chihuahua,08,Valle de Zaragoza,08067,2752,2632,5384
2017,Ciudad de México,09,Azcapotzalco,09002,194905,218452,413357
2017,Ciudad de México,09,Benito Juárez,09014,194276,228606,422882
2017,Ciudad de México,09,Coyoacán,09003,295149,332626,627775
2017,Ciudad de México,09,Cuajimalpa de Morelos,09004,94669,102960,197629
2017,Ciudad de México,09,Cuauhtémoc,09015,258810,286865,545675
2017,Ciudad de México,09,Gustavo A. Madero,09005,571565,617565,1189130
2017,Ciudad de México,09,Iztacalco,09006,187841,208098,395939
2017,Ciudad de México,09,Iztapalapa,09007,892770,944726,1837496
2017,Ciudad de México,09,La Magdalena Contreras,09008,117946,127409,245355
2017,Ciudad de México,09,Miguel Hidalgo,09016,174098,202643,376741
2017,Ciudad de México,09,Milpa Alta,09009,67291,70312,137603
2017,Ciudad de México,09,Tlalpan,09012,325445,353458,678903
2017,Ciudad de México,09,Tláhuac,09011,177329,190481,367810
2017,Ciudad de México,09,Venustiano Carranza,09017,206199,230823,437022
2017,Ciudad de México,09,Xochimilco,09013,206819,214369,421188
2017,Ciudad de México,09,Álvaro Obregón,09010,359860,394721,754581
2017,Coahuila,05,Abasolo,05001,552,545,1097
2017,Coahuila,05,Acuña,05002,79694,78378,158072
2017,Coahuila,05,Allende,05003,11879,12131,24010
2017,Coahuila,05,Arteaga,05004,12556,11937,24493
2017,Coahuila,05,Candela,05005,988,891,1879
2017,Coahuila,05,Castaños,05006,14671,14611,29282
2017,Coahuila,05,Cuatro Ciénegas,05007,7183,6988,14171
2017,Coahuila,05,Escobedo,05008,1645,1586,3231
2017,Coahuila,05,Francisco I. Madero,05009,30812,30813,61625
2017,Coahuila,05,Frontera,05010,42546,42029,84575
2017,Coahuila,05,General Cepeda,05011,6801,6225,13026
2017,Coahuila,05,Guerrero,05012,1038,908,1946
2017,Coahuila,05,Hidalgo,05013,949,899,1848
2017,Coahuila,05,Jiménez,05014,5488,5292,10780
2017,Coahuila,05,Juárez,05015,867,804,1671
2017,Coahuila,05,Lamadrid,05016,990,934,1924
2017,Coahuila,05,Matamoros,05017,57876,57673,115549
2017,Coahuila,05,Monclova,05018,120571,121373,241944
2017,Coahuila,05,Morelos,05019,4593,4447,9040
2017,Coahuila,05,Múzquiz,05020,36912,36076,72988
2017,Coahuila,05,Nadadores,05021,3503,3425,6928
2017,Coahuila,05,Nava,05022,16349,15494,31843
2017,Coahuila,05,Ocampo,05023,6077,5606,11683
2017,Coahuila,05,Parras,05024,24484,23387,47871
2017,Coahuila,05,Piedras Negras,05025,86052,85194,171246
2017,Coahuila,05,Progreso,05026,1849,1729,3578
2017,Coahuila,05,Ramos Arizpe,05027,48637,46769,95406
2017,Coahuila,05,Sabinas,05028,33460,33276,66736
2017,Coahuila,05,Sacramento,05029,1276,1233,2509
2017,Coahuila,05,Saltillo,05030,414370,415503,829873
2017,Coahuila,05,San Buenaventura,05031,12368,12327,24695
2017,Coahuila,05,San Juan de Sabinas,05032,22564,23240,45804
2017,Coahuila,05,San Pedro,05033,56189,56095,112284
2017,Coahuila,05,Sierra Mojada,05034,3745,3450,7195
2017,Coahuila,05,Torreón,05035,349563,364033,713596
2017,Coahuila,05,Viesca,05036,11617,11226,22843
2017,Coahuila,05,Villa Unión,05037,3454,3265,6719
2017,Coahuila,05,Zaragoza,05038,6998,6894,13892
2017,Colima,06,Armería,06001,15641,15513,31154
2017,Colima,06,Colima,06002,78938,83213,162151
2017,Colima,06,Comala,06003,11579,11474,23053
2017,Colima,06,Coquimatlán,06004,10756,10616,21372
2017,Colima,06,Cuauhtémoc,06005,15752,15714,31466
2017,Colima,06,Ixtlahuacán,06006,2937,2906,5843
2017,Colima,06,Manzanillo,06007,96790,95192,191982
2017,Colima,06,Minatitlán,06008,4819,4473,9292
2017,Colima,06,Tecomán,06009,64754,63820,128574
2017,Colima,06,Villa de Álvarez,06010,69543,73173,142716
2017,Durango,10,Canatlán,10001,16851,17157,34008
2017,Durango,10,Canelas,10002,2472,2248,4720
2017,Durango,10,Coneto de Comonfort,10003,2277,2328,4605
2017,Durango,10,Cuencamé,10004,18483,18201,36684
2017,Durango,10,Durango,10005,326003,346178,672181
2017,Durango,10,El Oro,10018,5977,6035,12012
2017,Durango,10,General Simón Bolívar,10006,5289,5388,10677
2017,Durango,10,Guadalupe Victoria,10008,18318,18682,37000
2017,Durango,10,Guanaceví,10009,5408,5069,10477
2017,Durango,10,Gómez Palacio,10007,178904,181747,360651
2017,Durango,10,Hidalgo,10010,2115,2054,4169
2017,Durango,10,Indé,10011,2640,2641,5281
2017,Durango,10,Lerdo,10012,79440,80075,159515
2017,Durango,10,Mapimí,10013,13750,13736,27486
2017,Durango,10,Mezquital,10014,19341,19929,39270
2017,Durango,10,Nazas,10015,6762,6802,13564
2017,Durango,10,Nombre de Dios,10016,10124,10229,20353
2017,Durango,10,Nuevo Ideal,10039,14035,14164,28199
2017,Durango,10,Ocampo,10017,5170,4940,10110
2017,Durango,10,Otáez,10019,2832,2640,5472
2017,Durango,10,Peñón Blanco,10021,5692,5641,11333
2017,Durango,10,Poanas,10022,13047,13418,26465
2017,Durango,10,Pueblo Nuevo,10023,26175,26321,52496
2017,Durango,10,Pánuco de Coronado,10020,6291,6477,12768
2017,Durango,10,Rodeo,10024,6981,6974,13955
2017,Durango,10,San Bernardo,10025,1833,1631,3464
2017,Durango,10,San Dimas,10026,10411,9762,20173
2017,Durango,10,San Juan de Guadalupe,10027,2921,2998,5919
2017,Durango,10,San Juan del Río,10028,6403,6563,12966
2017,Durango,10,San Luis del Cordero,10029,1123,1093,2216
2017,Durango,10,San Pedro del Gallo,10030,830,782,1612
2017,Durango,10,Santa Clara,10031,3667,3707,7374
2017,Durango,10,Santiago Papasquiaro,10032,24982,24926,49908
2017,Durango,10,Súchil,10033,3272,3538,6810
2017,Durango,10,Tamazula,10034,14400,13179,27579
2017,Durango,10,Tepehuanes,10035,5741,5792,11533
2017,Durango,10,Tlahualilo,10036,12109,11900,24009
2017,Durango,10,Topia,10037,4921,4639,9560
2017,Durango,10,Vicente Guerrero,10038,11135,11785,22920
2017,Estado de México,15,Acambay de Ruíz Castañeda,15001,32720,34816,67536
2017,Estado de México,15,Acolman,15002,86234,85863,172097
2017,Estado de México,15,Aculco,15003,24781,25512,50293
2017,Estado de México,15,Almoloya de Alquisiras,15004,7406,8097,15503
2017,Estado de México,15,Almoloya de Juárez,15005,88039,90046,178085
2017,Estado de México,15,Almoloya del Río,15006,5632,6063,11695
2017,Estado de México,15,Amanalco,15007,12308,12800,25108
2017,Estado de México,15,Amatepec,15008,13623,14498,28121
2017,Estado de México,15,Amecameca,15009,25766,27589,53355
2017,Estado de México,15,Apaxco,15010,15087,15480,30567
2017,Estado de México,15,Atenco,15011,32669,33263,65932
2017,Estado de México,15,Atizapán,15012,5816,6153,11969
2017,Estado de México,15,Atizapán de Zaragoza,15013,265401,280584,545985
2017,Estado de México,15,Atlacomulco,15014,49519,53627,103146
2017,Estado de México,15,Atlautla,15015,15360,16134,31494
2017,Estado de México,15,Axapusco,15016,14264,14446,28710
2017,Estado de México,15,Ayapango,15017,5100,5298,10398
2017,Estado de México,15,Calimaya,15018,27761,29226,56987
2017,Estado de México,15,Capulhuac,15019,18032,19028,37060
2017,Estado de México,15,Chalco,15025,180259,188758,369017
2017,Estado de México,15,Chapa de Mota,15026,14335,14874,29209
2017,Estado de México,15,Chapultepec,15027,5901,6152,12053
2017,Estado de México,15,Chiautla,15028,14812,15394,30206
2017,Estado de México,15,Chicoloapan,15029,103404,109311,212715
2017,Estado de México,15,Chiconcuac,15030,12909,13328,26237
2017,Estado de México,15,Chimalhuacán,15031,342204,354453,696657
2017,Estado de México,15,Coacalco de Berriozábal,15020,147769,158344,306113
2017,Estado de México,15,Coatepec Harinas,15021,19388,20972,40360
2017,Estado de México,15,Cocotitlán,15022,7204,7525,14729
2017,Estado de México,15,Coyotepec,15023,21452,21873,43325
2017,Estado de México,15,Cuautitlán,15024,81394,83448,164842
2017,Estado de México,15,Cuautitlán Izcalli,15121,274853,288995,563848
2017,Estado de México,15,Donato Guerra,15032,17334,17846,35180
2017,Estado de México,15,Ecatepec de Morelos,15033,833086,853038,1686124
2017,Estado de México,15,Ecatzingo,15034,4839,4984,9823
2017,Estado de México,15,El Oro,15064,18590,19675,38265
2017,Estado de México,15,Huehuetoca,15035,66265,68318,134583
2017,Estado de México,15,Hueypoxtla,15036,22624,22379,45003
2017,Estado de México,15,Huixquilucan,15037,134125,144509,278634
2017,Estado de México,15,Isidro Fabela,15038,5915,6041,11956
2017,Estado de México,15,Ixtapaluca,15039,258652,268909,527561
2017,Estado de México,15,Ixtapan de la Sal,15040,17752,19199,36951
2017,Estado de México,15,Ixtapan del Oro,15041,3587,3508,7095
2017,Estado de México,15,Ixtlahuaca,15042,75979,81299,157278
2017,Estado de México,15,Jaltenco,15044,14142,14957,29099
2017,Estado de México,15,Jilotepec,15045,44903,46398,91301
2017,Estado de México,15,Jilotzingo,15046,9710,10233,19943
2017,Estado de México,15,Jiquipilco,15047,36917,39296,76213
2017,Estado de México,15,Jocotitlán,15048,32847,35096,67943
2017,Estado de México,15,Joquicingo,15049,6905,7293,14198
2017,Estado de México,15,Juchitepec,15050,12914,13312,26226
2017,Estado de México,15,La Paz,15070,146764,150874,297638
2017,Estado de México,15,Lerma,15051,74934,76988,151922
2017,Estado de México,15,Luvianos,15123,14471,14807,29278
2017,Estado de México,15,Malinalco,15052,13977,14466,28443
2017,Estado de México,15,Melchor Ocampo,15053,28299,29543,57842
2017,Estado de México,15,Metepec,15054,116088,123511,239599
2017,Estado de México,15,Mexicaltzingo,15055,6372,6792,13164
2017,Estado de México,15,Morelos,15056,14833,16141,30974
2017,Estado de México,15,Naucalpan de Juárez,15057,434064,459813,893877
2017,Estado de México,15,Nextlalpan,15059,20075,20576,40651
2017,Estado de México,15,Nezahualcóyotl,15058,545626,584567,1130193
2017,Estado de México,15,Nicolás Romero,15060,205914,213915,419829
2017,Estado de México,15,Nopaltepec,15061,4744,4758,9502
2017,Estado de México,15,Ocoyoacac,15062,33872,34993,68865
2017,Estado de México,15,Ocuilan,15063,17209,17931,35140
2017,Estado de México,15,Otumba,15065,18568,18367,36935
2017,Estado de México,15,Otzoloapan,15066,2195,2163,4358
2017,Estado de México,15,Otzolotepec,15067,42872,44095,86967
2017,Estado de México,15,Ozumba,15068,14455,15623,30078
2017,Estado de México,15,Papalotla,15069,2082,2196,4278
2017,Estado de México,15,Polotitlán,15071,7103,7411,14514
2017,Estado de México,15,Rayón,15072,6867,7095,13962
2017,Estado de México,15,San Antonio la Isla,15073,14287,14729,29016
2017,Estado de México,15,San Felipe del Progreso,15074,65882,73382,139264
2017,Estado de México,15,San José del Rincón,15124,47896,48613,96509
2017,Estado de México,15,San Martín de las Pirámides,15075,13798,14145,27943
2017,Estado de México,15,San Mateo Atenco,15076,38667,40023,78690
2017,Estado de México,15,San Simón de Guerrero,15077,3104,3301,6405
2017,Estado de México,15,Santo Tomás,15078,4931,5086,10017
2017,Estado de México,15,Soyaniquilpan de Juárez,15079,6772,6920,13692
2017,Estado de México,15,Sultepec,15080,13130,14595,27725
2017,Estado de México,15,Tecámac,15081,225577,236936,462513
2017,Estado de México,15,Tejupilco,15082,38084,41270,79354
2017,Estado de México,15,Temamatla,15083,6376,6756,13132
2017,Estado de México,15,Temascalapa,15084,20096,20158,40254
2017,Estado de México,15,Temascalcingo,15085,31766,34352,66118
2017,Estado de México,15,Temascaltepec,15086,16513,17149,33662
2017,Estado de México,15,Temoaya,15087,50783,53656,104439
2017,Estado de México,15,Tenancingo,15088,49174,52002,101176
2017,Estado de México,15,Tenango del Aire,15089,6247,6425,12672
2017,Estado de México,15,Tenango del Valle,15090,43274,45137,88411
2017,Estado de México,15,Teoloyucan,15091,34623,35231,69854
2017,Estado de México,15,Teotihuacán,15092,29022,29905,58927
2017,Estado de México,15,Tepetlaoxtoc,15093,15725,16080,31805
2017,Estado de México,15,Tepetlixpa,15094,10096,10402,20498
2017,Estado de México,15,Tepotzotlán,15095,48760,50477,99237
2017,Estado de México,15,Tequixquiac,15096,18958,19239,38197
2017,Estado de México,15,Texcaltitlán,15097,9416,10089,19505
2017,Estado de México,15,Texcalyacac,15098,2719,2801,5520
2017,Estado de México,15,Texcoco,15099,124077,130298,254375
2017,Estado de México,15,Tezoyuca,15100,21481,21804,43285
2017,Estado de México,15,Tianguistenco,15101,38658,40814,79472
2017,Estado de México,15,Timilpan,15102,7915,8526,16441
2017,Estado de México,15,Tlalmanalco,15103,24212,25927,50139
2017,Estado de México,15,Tlalnepantla de Baz,15104,358145,381886,740031
2017,Estado de México,15,Tlatlaya,15105,17875,18739,36614
2017,Estado de México,15,Toluca,15106,441528,472613,914141
2017,Estado de México,15,Tonanitla,15125,5284,5425,10709
2017,Estado de México,15,Tonatico,15107,6342,6775,13117
2017,Estado de México,15,Tultepec,15108,75198,78234,153432
2017,Estado de México,15,Tultitlán,15109,267275,277325,544600
2017,Estado de México,15,Valle de Bravo,15110,33493,34838,68331
2017,Estado de México,15,Valle de Chalco Solidaridad,15122,199377,205891,405268
2017,Estado de México,15,Villa Guerrero,15113,33679,34916,68595
2017,Estado de México,15,Villa Victoria,15114,52337,53025,105362
2017,Estado de México,15,Villa de Allende,15111,26039,26962,53001
2017,Estado de México,15,Villa del Carbón,15112,24555,24338,48893
2017,Estado de México,15,Xalatlaco,15043,14801,15631,30432
2017,Estado de México,15,Xonacatlán,15115,26477,26493,52970
2017,Estado de México,15,Zacazonapan,15116,2161,2142,4303
2017,Estado de México,15,Zacualpan,15117,7505,8252,15757
2017,Estado de México,15,Zinacantepec,15118,94522,97319,191841
2017,Estado de México,15,Zumpahuacán,15119,8444,9197,17641
2017,Estado de México,15,Zumpango,15120,98052,105008,203060
2017,Guanajuato,11,Abasolo,11001,45142,48208,93350
2017,Guanajuato,11,Acámbaro,11002,56106,60770,116876
2017,Guanajuato,11,Apaseo el Alto,11004,34449,36097,70546
2017,Guanajuato,11,Apaseo el Grande,11005,46364,49106,95470
2017,Guanajuato,11,Atarjea,11006,2702,2804,5506
2017,Guanajuato,11,Celaya,11007,251205,265002,516207
2017,Guanajuato,11,Comonfort,11009,40384,44728,85112
2017,Guanajuato,11,Coroneo,11010,6026,6662,12688
2017,Guanajuato,11,Cortazar,11011,48157,50788,98945
2017,Guanajuato,11,Cuerámaro,11012,14080,15218,29298
2017,Guanajuato,11,Doctor Mora,11013,12117,12973,25090
2017,Guanajuato,11,Dolores Hidalgo Cuna de la Independencia Nacional,11014,75069,82947,158016
2017,Guanajuato,11,Guanajuato,11015,94233,97700,191933
2017,Guanajuato,11,Huanímaro,11016,10482,11648,22130
2017,Guanajuato,11,Irapuato,11017,288962,303040,592002
2017,Guanajuato,11,Jaral del Progreso,11018,19526,20388,39914
2017,Guanajuato,11,Jerécuaro,11019,24025,27219,51244
2017,Guanajuato,11,León,11020,808639,818675,1627314
2017,Guanajuato,11,Manuel Doblado,11008,18981,20949,39930
2017,Guanajuato,11,Moroleón,11021,25440,27791,53231
2017,Guanajuato,11,Ocampo,11022,11737,12515,24252
2017,Guanajuato,11,Pueblo Nuevo,11024,5775,6456,12231
2017,Guanajuato,11,Purísima del Rincón,11025,40820,40823,81643
2017,Guanajuato,11,Pénjamo,11023,75287,82366,157653
2017,Guanajuato,11,Romita,11026,29740,31629,61369
2017,Guanajuato,11,Salamanca,11027,139397,146198,285595
2017,Guanajuato,11,Salvatierra,11028,50026,54856,104882
2017,Guanajuato,11,San Diego de la Unión,11029,19001,21629,40630
2017,Guanajuato,11,San Felipe,11030,56171,59566,115737
2017,Guanajuato,11,San Francisco del Rincón,11031,60368,63124,123492
2017,Guanajuato,11,San José Iturbide,11032,39042,41448,80490
2017,Guanajuato,11,San Luis de la Paz,11033,59552,65134,124686
2017,Guanajuato,11,San Miguel de Allende,11003,85338,92007,177345
2017,Guanajuato,11,Santa Catarina,11034,2610,2846,5456
2017,Guanajuato,11,Santa Cruz de Juventino Rosas,11035,41690,44610,86300
2017,Guanajuato,11,Santiago Maravatío,11036,3375,3758,7133
2017,Guanajuato,11,Silao de la Victoria,11037,95827,98062,193889
2017,Guanajuato,11,Tarandacuao,11038,6010,6607,12617
2017,Guanajuato,11,Tarimoro,11039,17533,18745,36278
2017,Guanajuato,11,Tierra Blanca,11040,9542,10109,19651
2017,Guanajuato,11,Uriangato,11041,31670,33697,65367
2017,Guanajuato,11,Valle de Santiago,11042,71444,78325,149769
2017,Guanajuato,11,Victoria,11043,10056,11053,21109
2017,Guanajuato,11,Villagrán,11044,29956,31245,61201
2017,Guanajuato,11,Xichú,11045,5802,6264,12066
2017,Guanajuato,11,Yuriria,11046,34640,38286,72926
2017,Guerrero,12,Acapulco de Juárez,12001,401181,430471,831652
2017,Guerrero,12,Acatepec,12076,18642,19517,38159
2017,Guerrero,12,Ahuacuotzingo,12002,12587,14316,26903
2017,Guerrero,12,Ajuchitlán del Progreso,12003,18894,20276,39170
2017,Guerrero,12,Alcozauca de Guerrero,12004,9231,10485,19716
2017,Guerrero,12,Alpoyeca,12005,3219,3642,6861
2017,Guerrero,12,Apaxtla,12006,5695,6173,11868
2017,Guerrero,12,Arcelia,12007,15874,16852,32726
2017,Guerrero,12,Atenango del Río,12008,4213,4627,8840
2017,Guerrero,12,Atlamajalcingo del Monte,12009,2585,2842,5427
2017,Guerrero,12,Atlixtac,12010,13358,14308,27666
2017,Guerrero,12,Atoyac de Álvarez,12011,30740,31905,62645
2017,Guerrero,12,Ayutla de los Libres,12012,33806,35205,69011
2017,Guerrero,12,Azoyú,12013,6914,7340,14254
2017,Guerrero,12,Benito Juárez,12014,7729,8122,15851
2017,Guerrero,12,Buenavista de Cuéllar,12015,6640,7002,13642
2017,Guerrero,12,Chilapa de Álvarez,12028,62056,68472,130528
2017,Guerrero,12,Chilpancingo de los Bravo,12029,132219,143911,276130
2017,Guerrero,12,Coahuayutla de José María Izazaga,12016,6611,6383,12994
2017,Guerrero,12,Cochoapa el Grande,12078,9150,10090,19240
2017,Guerrero,12,Cocula,12017,6823,7383,14206
2017,Guerrero,12,Copala,12018,7086,7357,14443
2017,Guerrero,12,Copalillo,12019,7150,7896,15046
2017,Guerrero,12,Copanatoyac,12020,9740,10611,20351
2017,Guerrero,12,Coyuca de Benítez,12021,38354,39850,78204
2017,Guerrero,12,Coyuca de Catalán,12022,20749,20425,41174
2017,Guerrero,12,Cuajinicuilapa,12023,13762,13800,27562
2017,Guerrero,12,Cualác,12024,3700,3996,7696
2017,Guerrero,12,Cuautepec,12025,8208,8252,16460
2017,Guerrero,12,Cuetzala del Progreso,12026,4380,4643,9023
2017,Guerrero,12,Cutzamala de Pinzón,12027,10105,10577,20682
2017,Guerrero,12,Eduardo Neri,12075,25212,26345,51557
2017,Guerrero,12,Florencio Villarreal,12030,10523,10790,21313
2017,Guerrero,12,General Canuto A. Neri,12031,2896,3151,6047
2017,Guerrero,12,General Heliodoro Castillo,12032,18906,18877,37783
2017,Guerrero,12,Huamuxtitlán,12033,7313,8271,15584
2017,Guerrero,12,Huitzuco de los Figueroa,12034,18409,20069,38478
2017,Guerrero,12,Iguala de la Independencia,12035,74791,80311,155102
2017,Guerrero,12,Igualapa,12036,5667,5877,11544
2017,Guerrero,12,Iliatenco,12081,5351,5863,11214
2017,Guerrero,12,Ixcateopan de Cuauhtémoc,12037,3063,3408,6471
2017,Guerrero,12,José Joaquín de Herrera,12079,8700,8875,17575
2017,Guerrero,12,Juan R. Escudero,12039,12412,13150,25562
2017,Guerrero,12,Juchitán,12080,3901,3870,7771
2017,Guerrero,12,La Unión de Isidoro Montes de Oca,12068,13772,13259,27031
2017,Guerrero,12,Leonardo Bravo,12040,13112,13430,26542
2017,Guerrero,12,Malinaltepec,12041,13601,15103,28704
2017,Guerrero,12,Marquelia,12077,6981,7070,14051
2017,Guerrero,12,Metlatónoc,12043,9304,10649,19953
2017,Guerrero,12,Mochitlán,12044,6298,6561,12859
2017,Guerrero,12,Mártir de Cuilapan,12042,8968,9832,18800
2017,Guerrero,12,Olinalá,12045,12507,13520,26027
2017,Guerrero,12,Ometepec,12046,33258,34910,68168
2017,Guerrero,12,Pedro Ascencio Alquisiras,12047,3272,3829,7101
2017,Guerrero,12,Petatlán,12048,22707,23069,45776
2017,Guerrero,12,Pilcaya,12049,6295,6712,13007
2017,Guerrero,12,Pungarabato,12050,18890,20062,38952
2017,Guerrero,12,Quechultenango,12051,17883,18790,36673
2017,Guerrero,12,San Luis Acatlán,12052,22142,22714,44856
2017,Guerrero,12,San Marcos,12053,24792,25746,50538
2017,Guerrero,12,San Miguel Totolapan,12054,14004,14475,28479
2017,Guerrero,12,Taxco de Alarcón,12055,53658,57929,111587
2017,Guerrero,12,Tecoanapa,12056,23343,23974,47317
2017,Guerrero,12,Teloloapan,12058,27448,30831,58279
2017,Guerrero,12,Tepecoacuilco de Trujano,12059,15531,16898,32429
2017,Guerrero,12,Tetipac,12060,7112,7544,14656
2017,Guerrero,12,Tixtla de Guerrero,12061,20992,22673,43665
2017,Guerrero,12,Tlacoachistlahuaca,12062,11045,12366,23411
2017,Guerrero,12,Tlacoapa,12063,4847,5348,10195
2017,Guerrero,12,Tlalchapa,12064,6238,6299,12537
2017,Guerrero,12,Tlalixtaquilla de Maldonado,12065,3592,3918,7510
2017,Guerrero,12,Tlapa de Comonfort,12066,42863,47402,90265
2017,Guerrero,12,Tlapehuala,12067,10958,11778,22736
2017,Guerrero,12,Técpan de Galeana,12057,32827,33354,66181
2017,Guerrero,12,Xalpatláhuac,12069,5704,6609,12313
2017,Guerrero,12,Xochihuehuetlán,12070,3449,3961,7410
2017,Guerrero,12,Xochistlahuaca,12071,14438,15277,29715
2017,Guerrero,12,Zapotitlán Tablas,12072,5578,6158,11736
2017,Guerrero,12,Zihuatanejo de Azueta,12038,63467,64984,128451
2017,Guerrero,12,Zirándaro,12073,9565,9239,18804
2017,Guerrero,12,Zitlala,12074,11051,12345,23396
2017,Hidalgo,13,Acatlán,13001,10446,11196,21642
2017,Hidalgo,13,Acaxochitlán,13002,21530,23212,44742
2017,Hidalgo,13,Actopan,13003,28145,31248,59393
2017,Hidalgo,13,Agua Blanca de Iturbide,13004,4544,4990,9534
2017,Hidalgo,13,Ajacuba,13005,9391,9848,19239
2017,Hidalgo,13,Alfajayucan,13006,10299,10926,21225
2017,Hidalgo,13,Almoloya,13007,6348,6424,12772
2017,Hidalgo,13,Apan,13008,22436,24320,46756
2017,Hidalgo,13,Atitalaquia,13010,15343,15649,30992
2017,Hidalgo,13,Atlapexco,13011,10209,10940,21149
2017,Hidalgo,13,Atotonilco de Tula,13013,18912,19992,38904
2017,Hidalgo,13,Atotonilco el Grande,13012,13517,15182,28699
2017,Hidalgo,13,Calnali,13014,8804,9424,18228
2017,Hidalgo,13,Cardonal,13015,9252,10052,19304
2017,Hidalgo,13,Chapantongo,13017,6899,7244,14143
2017,Hidalgo,13,Chapulhuacán,13018,12459,12300,24759
2017,Hidalgo,13,Chilcuautla,13019,9299,9698,18997
2017,Hidalgo,13,Cuautepec de Hinojosa,13016,28716,31423,60139
2017,Hidalgo,13,El Arenal,13009,9299,10131,19430
2017,Hidalgo,13,Eloxochitlán,13020,1353,1537,2890
2017,Hidalgo,13,Emiliano Zapata,13021,7272,7993,15265
2017,Hidalgo,13,Epazoyucan,13022,7474,7907,15381
2017,Hidalgo,13,Francisco I. Madero,13023,17903,19577,37480
2017,Hidalgo,13,Huasca de Ocampo,13024,8852,9680,18532
2017,Hidalgo,13,Huautla,13025,11110,11972,23082
2017,Hidalgo,13,Huazalingo,13026,7090,7397,14487
2017,Hidalgo,13,Huehuetla,13027,12944,13713,26657
2017,Hidalgo,13,Huejutla de Reyes,13028,67003,69061,136064
2017,Hidalgo,13,Huichapan,13029,23117,25194,48311
2017,Hidalgo,13,Ixmiquilpan,13030,45400,50819,96219
2017,Hidalgo,13,Jacala de Ledezma,13031,6660,7414,14074
2017,Hidalgo,13,Jaltocán,13032,6111,6277,12388
2017,Hidalgo,13,Juárez Hidalgo,13033,1600,1728,3328
2017,Hidalgo,13,La Misión,13040,5321,5478,10799
2017,Hidalgo,13,Lolotla,13034,4970,5195,10165
2017,Hidalgo,13,Metepec,13035,5714,6457,12171
2017,Hidalgo,13,Metztitlán,13037,10354,11528,21882
2017,Hidalgo,13,Mineral de la Reforma,13051,81247,88859,170106
2017,Hidalgo,13,Mineral del Chico,13038,4468,4736,9204
2017,Hidalgo,13,Mineral del Monte,13039,7232,7970,15202
2017,Hidalgo,13,Mixquiahuala de Juárez,13041,23058,25001,48059
2017,Hidalgo,13,Molango de Escamilla,13042,5985,6214,12199
2017,Hidalgo,13,Nicolás Flores,13043,3406,3822,7228
2017,Hidalgo,13,Nopala de Villagrán,13044,8675,8966,17641
2017,Hidalgo,13,Omitlán de Juárez,13045,4830,5293,10123
2017,Hidalgo,13,Pachuca de Soto,13048,132247,144423,276670
2017,Hidalgo,13,Pacula,13047,2455,2836,5291
2017,Hidalgo,13,Pisaflores,13049,9318,9291,18609
2017,Hidalgo,13,Progreso de Obregón,13050,11620,12915,24535
2017,Hidalgo,13,San Agustín Metzquititlán,13036,4803,5264,10067
2017,Hidalgo,13,San Agustín Tlaxiaca,13052,18217,19043,37260
2017,Hidalgo,13,San Bartolo Tutotepec,13053,9797,9946,19743
2017,Hidalgo,13,San Felipe Orizatlán,13046,20373,20925,41298
2017,Hidalgo,13,San Salvador,13054,17725,18965,36690
2017,Hidalgo,13,Santiago Tulantepec de Lugo Guerrero,13056,18410,20116,38526
2017,Hidalgo,13,Santiago de Anaya,13055,8642,9097,17739
2017,Hidalgo,13,Singuilucan,13057,8253,8498,16751
2017,Hidalgo,13,Tasquillo,13058,7997,9409,17406
2017,Hidalgo,13,Tecozautla,13059,18719,20429,39148
2017,Hidalgo,13,Tenango de Doria,13060,9139,10021,19160
2017,Hidalgo,13,Tepeapulco,13061,27736,29592,57328
2017,Hidalgo,13,Tepehuacán de Guerrero,13062,16280,15696,31976
2017,Hidalgo,13,Tepeji del Río de Ocampo,13063,44569,45884,90453
2017,Hidalgo,13,Tepetitlán,13064,5526,5827,11353
2017,Hidalgo,13,Tetepango,13065,6046,6114,12160
2017,Hidalgo,13,Tezontepec de Aldama,13067,27044,27679,54723
2017,Hidalgo,13,Tianguistengo,13068,7638,7993,15631
2017,Hidalgo,13,Tizayuca,13069,62298,63888,126186
2017,Hidalgo,13,Tlahuelilpan,13070,9797,10119,19916
2017,Hidalgo,13,Tlahuiltepa,13071,5305,5400,10705
2017,Hidalgo,13,Tlanalapa,13072,5267,5607,10874
2017,Hidalgo,13,Tlanchinol,13073,20266,20629,40895
2017,Hidalgo,13,Tlaxcoapan,13074,14704,15126,29830
2017,Hidalgo,13,Tolcayuca,13075,8186,8662,16848
2017,Hidalgo,13,Tula de Allende,13076,55949,59023,114972
2017,Hidalgo,13,Tulancingo de Bravo,13077,77422,86012,163434
2017,Hidalgo,13,Villa de Tezontepec,13066,6391,6605,12996
2017,Hidalgo,13,Xochiatipan,13078,10119,10618,20737
2017,Hidalgo,13,Xochicoatlán,13079,3972,4093,8065
2017,Hidalgo,13,Yahualica,13080,12497,12990,25487
2017,Hidalgo,13,Zacualtipán de Ángeles,13081,17180,18835,36015
2017,Hidalgo,13,Zapotlán de Juárez,13082,9547,10283,19830
2017,Hidalgo,13,Zempoala,13083,22910,24181,47091
2017,Hidalgo,13,Zimapán,13084,19267,22330,41597
2017,Jalisco,14,Acatic,14001,10992,11444,22436
2017,Jalisco,14,Acatlán de Juárez,14002,12438,11488,23926
2017,Jalisco,14,Ahualulco de Mercado,14003,11930,12288,24218
2017,Jalisco,14,Amacueca,14004,2789,2946,5735
2017,Jalisco,14,Amatitán,14005,7964,8028,15992
2017,Jalisco,14,Ameca,14006,30981,32213,63194
2017,Jalisco,14,Arandas,14008,38697,41488,80185
2017,Jalisco,14,Atemajac de Brizuela,14010,3487,3530,7017
2017,Jalisco,14,Atengo,14011,2986,2767,5753
2017,Jalisco,14,Atenguillo,14012,2071,2142,4213
2017,Jalisco,14,Atotonilco el Alto,14013,30835,31981,62816
2017,Jalisco,14,Atoyac,14014,4147,4491,8638
2017,Jalisco,14,Autlán de Navarro,14015,31266,32154,63420
2017,Jalisco,14,Ayotlán,14016,19513,20430,39943
2017,Jalisco,14,Ayutla,14017,6577,6592,13169
2017,Jalisco,14,Bolaños,14019,3855,3874,7729
2017,Jalisco,14,Cabo Corrientes,14020,5617,5164,10781
2017,Jalisco,14,Casimiro Castillo,14021,11281,11325,22606
2017,Jalisco,14,Cañadas de Obregón,14117,2114,2231,4345
2017,Jalisco,14,Chapala,14030,26035,27089,53124
2017,Jalisco,14,Chimaltitán,14031,1781,1826,3607
2017,Jalisco,14,Chiquilistlán,14032,3158,3128,6286
2017,Jalisco,14,Cihuatlán,14022,21461,20909,42370
2017,Jalisco,14,Cocula,14024,13650,14377,28027
2017,Jalisco,14,Colotlán,14025,9130,9763,18893
2017,Jalisco,14,Concepción de Buenos Aires,14026,3244,3126,6370
2017,Jalisco,14,Cuautitlán de García Barragán,14027,9536,9227,18763
2017,Jalisco,14,Cuautla,14028,1083,1167,2250
2017,Jalisco,14,Cuquío,14029,9019,9847,18866
2017,Jalisco,14,Degollado,14033,10787,11545,22332
2017,Jalisco,14,Ejutla,14034,1046,989,2035
2017,Jalisco,14,El Arenal,14009,9980,10167,20147
2017,Jalisco,14,El Grullo,14037,12526,13096,25622
2017,Jalisco,14,El Limón,14054,2892,2889,5781
2017,Jalisco,14,El Salto,14070,93403,94304,187707
2017,Jalisco,14,Encarnación de Díaz,14035,26820,28871,55691
2017,Jalisco,14,Etzatlán,14036,10088,10485,20573
2017,Jalisco,14,Guachinango,14038,2265,2188,4453
2017,Jalisco,14,Guadalajara,14039,731274,769256,1500530
2017,Jalisco,14,Gómez Farías,14079,7235,7715,14950
2017,Jalisco,14,Hostotipaquillo,14040,5696,4951,10647
2017,Jalisco,14,Huejuquilla el Alto,14042,4413,4785,9198
2017,Jalisco,14,Huejúcar,14041,2875,3172,6047
2017,Jalisco,14,Ixtlahuacán de los Membrillos,14044,27231,27868,55099
2017,Jalisco,14,Ixtlahuacán del Río,14045,9695,10322,20017
2017,Jalisco,14,Jalostotitlán,14046,17186,17740,34926
2017,Jalisco,14,Jamay,14047,12797,12817,25614
2017,Jalisco,14,Jesús María,14048,9187,10831,20018
2017,Jalisco,14,Jilotlán de los Dolores,14049,5144,4924,10068
2017,Jalisco,14,Jocotepec,14050,23659,23945,47604
2017,Jalisco,14,Juanacatlán,14051,9082,9095,18177
2017,Jalisco,14,Juchitlán,14052,2848,3042,5890
2017,Jalisco,14,La Barca,14018,33111,35290,68401
2017,Jalisco,14,La Huerta,14043,12844,12447,25291
2017,Jalisco,14,La Manzanilla de la Paz,14057,1900,2058,3958
2017,Jalisco,14,Lagos de Moreno,14053,83190,86972,170162
2017,Jalisco,14,Magdalena,14055,11648,11703,23351
2017,Jalisco,14,Mascota,14058,7486,7725,15211
2017,Jalisco,14,Mazamitla,14059,6917,7496,14413
2017,Jalisco,14,Mexticacán,14060,2579,3033,5612
2017,Jalisco,14,Mezquitic,14061,9691,10222,19913
2017,Jalisco,14,Mixtlán,14062,1863,1846,3709
2017,Jalisco,14,Ocotlán,14063,50896,52451,103347
2017,Jalisco,14,Ojuelos de Jalisco,14064,16203,16951,33154
2017,Jalisco,14,Pihuamo,14065,6024,5945,11969
2017,Jalisco,14,Poncitlán,14066,26419,27082,53501
2017,Jalisco,14,Puerto Vallarta,14067,145501,141959,287460
2017,Jalisco,14,Quitupan,14069,4145,4640,8785
2017,Jalisco,14,San Cristóbal de la Barranca,14071,1583,1612,3195
2017,Jalisco,14,San Diego de Alejandría,14072,3587,3878,7465
2017,Jalisco,14,San Gabriel,14113,8183,8533,16716
2017,Jalisco,14,San Ignacio Cerro Gordo,14125,9518,10079,19597
2017,Jalisco,14,San Juan de los Lagos,14073,35561,36179,71740
2017,Jalisco,14,San Juanito de Escobedo,14007,4889,4827,9716
2017,Jalisco,14,San Julián,14074,7808,8672,16480
2017,Jalisco,14,San Marcos,14075,2019,1955,3974
2017,Jalisco,14,San Martín Hidalgo,14077,13992,14720,28712
2017,Jalisco,14,San Martín de Bolaños,14076,1662,1640,3302
2017,Jalisco,14,San Miguel el Alto,14078,16519,17445,33964
2017,Jalisco,14,San Pedro Tlaquepaque,14098,341514,344019,685533
2017,Jalisco,14,San Sebastián del Oeste,14080,3098,2823,5921
2017,Jalisco,14,Santa María de los Ángeles,14081,1623,1808,3431
2017,Jalisco,14,Santa María del Oro,14056,1152,1139,2291
2017,Jalisco,14,Sayula,14082,18566,19885,38451
2017,Jalisco,14,Tala,14083,40303,40891,81194
2017,Jalisco,14,Talpa de Allende,14084,7887,7775,15662
2017,Jalisco,14,Tamazula de Gordiano,14085,19721,20593,40314
2017,Jalisco,14,Tapalpa,14086,9811,10188,19999
2017,Jalisco,14,Tecalitlán,14087,8556,8921,17477
2017,Jalisco,14,Techaluta de Montenegro,14089,1889,1956,3845
2017,Jalisco,14,Tecolotlán,14088,8987,8955,17942
2017,Jalisco,14,Tenamaxtlán,14090,3724,3700,7424
2017,Jalisco,14,Teocaltiche,14091,20492,22544,43036
2017,Jalisco,14,Teocuitatlán de Corona,14092,5397,5617,11014
2017,Jalisco,14,Tepatitlán de Morelos,14093,72431,75141,147572
2017,Jalisco,14,Tequila,14094,21835,22018,43853
2017,Jalisco,14,Teuchitlán,14095,4866,5082,9948
2017,Jalisco,14,Tizapán el Alto,14096,10723,11267,21990
2017,Jalisco,14,Tlajomulco de Zúñiga,14097,289987,294873,584860
2017,Jalisco,14,Tolimán,14099,5241,5346,10587
2017,Jalisco,14,Tomatlán,14100,19058,18105,37163
2017,Jalisco,14,Tonalá,14101,278130,276329,554459
2017,Jalisco,14,Tonaya,14102,3071,3193,6264
2017,Jalisco,14,Tonila,14103,4071,4115,8186
2017,Jalisco,14,Totatiche,14104,2286,2313,4599
2017,Jalisco,14,Tototlán,14105,11796,12120,23916
2017,Jalisco,14,Tuxcacuesco,14106,2284,2194,4478
2017,Jalisco,14,Tuxcueca,14107,3166,3378,6544
2017,Jalisco,14,Tuxpan,14108,17629,18710,36339
2017,Jalisco,14,Unión de San Antonio,14109,8979,9655,18634
2017,Jalisco,14,Unión de Tula,14110,6880,7359,14239
2017,Jalisco,14,Valle de Guadalupe,14111,3604,3652,7256
2017,Jalisco,14,Valle de Juárez,14112,2826,2993,5819
2017,Jalisco,14,Villa Corona,14114,9118,9385,18503
2017,Jalisco,14,Villa Guerrero,14115,2834,2928,5762
2017,Jalisco,14,Villa Hidalgo,14116,10167,10839,21006
2017,Jalisco,14,Villa Purificación,14068,5962,5593,11555
2017,Jalisco,14,Yahualica de González Gallo,14118,11365,12434,23799
2017,Jalisco,14,Zacoalco de Torres,14119,14687,14964,29651
2017,Jalisco,14,Zapopan,14120,684710,705194,1389904
2017,Jalisco,14,Zapotiltic,14121,15036,15689,30725
2017,Jalisco,14,Zapotitlán de Vadillo,14122,3652,3634,7286
2017,Jalisco,14,Zapotlanejo,14124,34579,35651,70230
2017,Jalisco,14,Zapotlán del Rey,14123,9371,9450,18821
2017,Jalisco,14,Zapotlán el Grande,14023,54067,56725,110792
2017,Michoacán,16,Acuitzio,16001,5661,6109,11770
2017,Michoacán,16,Aguililla,16002,7956,7802,15758
2017,Michoacán,16,Angamacutiro,16004,7315,8145,15460
2017,Michoacán,16,Angangueo,16005,5602,5931,11533
2017,Michoacán,16,Apatzingán,16006,65595,66661,132256
2017,Michoacán,16,Aporo,16007,1623,1728,3351
2017,Michoacán,16,Aquila,16008,12963,12504,25467
2017,Michoacán,16,Ario,16009,18339,19335,37674
2017,Michoacán,16,Arteaga,16010,11326,11395,22721
2017,Michoacán,16,Briseñas,16011,5661,5974,11635
2017,Michoacán,16,Buenavista,16012,24386,23520,47906
2017,Michoacán,16,Carácuaro,16013,4843,4831,9674
2017,Michoacán,16,Charapan,16021,5985,6775,12760
2017,Michoacán,16,Charo,16022,11879,10978,22857
2017,Michoacán,16,Chavinda,16023,5142,5462,10604
2017,Michoacán,16,Cherán,16024,9407,10114,19521
2017,Michoacán,16,Chilchota,16025,19156,20645,39801
2017,Michoacán,16,Chinicuila,16026,2684,2476,5160
2017,Michoacán,16,Chucándiro,16027,2174,2612,4786
2017,Michoacán,16,Churintzio,16028,2487,2852,5339
2017,Michoacán,16,Churumuco,16029,7810,7821,15631
2017,Michoacán,16,Coahuayana,16014,7660,7139,14799
2017,Michoacán,16,Coalcomán de Vázquez Pallares,16015,9227,9437,18664
2017,Michoacán,16,Coeneo,16016,9809,11595,21404
2017,Michoacán,16,Cojumatlán de Régules,16074,5247,5490,10737
2017,Michoacán,16,Contepec,16017,17160,18130,35290
2017,Michoacán,16,Copándaro,16018,4406,4956,9362
2017,Michoacán,16,Cotija,16019,9342,10390,19732
2017,Michoacán,16,Cuitzeo,16020,14530,16090,30620
2017,Michoacán,16,Ecuandureo,16030,6003,7169,13172
2017,Michoacán,16,Epitacio Huerta,16031,8444,8835,17279
2017,Michoacán,16,Erongarícuaro,16032,7596,8139,15735
2017,Michoacán,16,Gabriel Zamora,16033,11630,11703,23333
2017,Michoacán,16,Hidalgo,16034,61652,65120,126772
2017,Michoacán,16,Huandacareo,16036,5701,6549,12250
2017,Michoacán,16,Huaniqueo,16037,3776,4524,8300
2017,Michoacán,16,Huetamo,16038,20866,21849,42715
2017,Michoacán,16,Huiramba,16039,4405,4569,8974
2017,Michoacán,16,Indaparapeo,16040,8414,8974,17388
2017,Michoacán,16,Irimbo,16041,7388,8136,15524
2017,Michoacán,16,Ixtlán,16042,6608,6883,13491
2017,Michoacán,16,Jacona,16043,34637,36592,71229
2017,Michoacán,16,Jiménez,16044,6299,6944,13243
2017,Michoacán,16,Jiquilpan,16045,16451,18137,34588
2017,Michoacán,16,José Sixto Verduzco,16113,12778,14253,27031
2017,Michoacán,16,Jungapeo,16047,10890,11076,21966
2017,Michoacán,16,Juárez,16046,7234,7615,14849
2017,Michoacán,16,La Huacana,16035,17431,17658,35089
2017,Michoacán,16,La Piedad,16069,51543,56145,107688
2017,Michoacán,16,Lagunillas,16048,2816,2932,5748
2017,Michoacán,16,Los Reyes,16075,34544,36147,70691
2017,Michoacán,16,Lázaro Cárdenas,16052,95496,94469,189965
2017,Michoacán,16,Madero,16049,9272,9177,18449
2017,Michoacán,16,Maravatío,16050,43096,46595,89691
2017,Michoacán,16,Marcos Castellanos,16051,6788,7304,14092
2017,Michoacán,16,Morelia,16053,388885,416920,805805
2017,Michoacán,16,Morelos,16054,3609,4418,8027
2017,Michoacán,16,Múgica,16055,23332,23809,47141
2017,Michoacán,16,Nahuatzen,16056,14178,15053,29231
2017,Michoacán,16,Nocupétaro,16057,4154,4241,8395
2017,Michoacán,16,Nuevo Parangaricutiro,16058,9904,10334,20238
2017,Michoacán,16,Nuevo Urecho,16059,4206,4201,8407
2017,Michoacán,16,Numarán,16060,4836,5333,10169
2017,Michoacán,16,Ocampo,16061,12453,12460,24913
2017,Michoacán,16,Pajacuarán,16062,9723,10444,20167
2017,Michoacán,16,Panindícuaro,16063,7694,8723,16417
2017,Michoacán,16,Paracho,16065,18273,20050,38323
2017,Michoacán,16,Parácuaro,16064,13818,13579,27397
2017,Michoacán,16,Penjamillo,16067,8168,9420,17588
2017,Michoacán,16,Peribán,16068,14200,14125,28325
2017,Michoacán,16,Puruándiro,16071,32999,37033,70032
2017,Michoacán,16,Purépero,16070,7828,8222,16050
2017,Michoacán,16,Pátzcuaro,16066,46021,49843,95864
2017,Michoacán,16,Queréndaro,16072,6910,7291,14201
2017,Michoacán,16,Quiroga,16073,13569,14820,28389
2017,Michoacán,16,Sahuayo,16076,38554,40394,78948
2017,Michoacán,16,Salvador Escalante,16079,24309,25797,50106
2017,Michoacán,16,San Lucas,16077,9290,9491,18781
2017,Michoacán,16,Santa Ana Maya,16078,6047,6943,12990
2017,Michoacán,16,Senguio,16080,9450,10093,19543
2017,Michoacán,16,Susupuato,16081,4479,4565,9044
2017,Michoacán,16,Tacámbaro,16082,38221,39968,78189
2017,Michoacán,16,Tancítaro,16083,16110,15810,31920
2017,Michoacán,16,Tangamandapio,16084,14538,15714,30252
2017,Michoacán,16,Tangancícuaro,16085,16770,17911,34681
2017,Michoacán,16,Tanhuato,16086,7815,8252,16067
2017,Michoacán,16,Taretan,16087,7429,7634,15063
2017,Michoacán,16,Tarímbaro,16088,52664,57058,109722
2017,Michoacán,16,Tepalcatepec,16089,12428,12153,24581
2017,Michoacán,16,Tingambato,16090,7498,7950,15448
2017,Michoacán,16,Tingüindín,16091,7160,7766,14926
2017,Michoacán,16,Tiquicheo de Nicolás Romero,16092,7032,7165,14197
2017,Michoacán,16,Tlalpujahua,16093,14075,15606,29681
2017,Michoacán,16,Tlazazalca,16094,3193,3443,6636
2017,Michoacán,16,Tocumbo,16095,6061,6211,12272
2017,Michoacán,16,Tumbiscatío,16096,3738,3606,7344
2017,Michoacán,16,Turicato,16097,15947,16820,32767
2017,Michoacán,16,Tuxpan,16098,13547,14553,28100
2017,Michoacán,16,Tuzantla,16099,7976,8106,16082
2017,Michoacán,16,Tzintzuntzan,16100,6996,7772,14768
2017,Michoacán,16,Tzitzio,16101,4659,4543,9202
2017,Michoacán,16,Uruapan,16102,167857,177514,345371
2017,Michoacán,16,Venustiano Carranza,16103,12447,12971,25418
2017,Michoacán,16,Villamar,16104,8320,9098,17418
2017,Michoacán,16,Vista Hermosa,16105,10346,10726,21072
2017,Michoacán,16,Yurécuaro,16106,15733,16568,32301
2017,Michoacán,16,Zacapu,16107,37982,40758,78740
2017,Michoacán,16,Zamora,16108,98693,104410,203103
2017,Michoacán,16,Zinapécuaro,16110,23462,25482,48944
2017,Michoacán,16,Zináparo,16109,1517,1799,3316
2017,Michoacán,16,Ziracuaretiro,16111,8700,8909,17609
2017,Michoacán,16,Zitácuaro,16112,80834,87467,168301
2017,Michoacán,16,Álvaro Obregón,16003,10750,11592,22342
2017,Morelos,17,Amacuzac,17001,8953,9439,18392
2017,Morelos,17,Atlatlahucan,17002,11158,11655,22813
2017,Morelos,17,Axochiapan,17003,18195,18803,36998
2017,Morelos,17,Ayala,17004,42524,45423,87947
2017,Morelos,17,Coatlán del Río,17005,4994,5161,10155
2017,Morelos,17,Cuautla,17006,96578,103938,200516
2017,Morelos,17,Cuernavaca,17007,184534,206408,390942
2017,Morelos,17,Emiliano Zapata,17008,49467,51225,100692
2017,Morelos,17,Huitzilac,17009,9780,9837,19617
2017,Morelos,17,Jantetelco,17010,8618,9031,17649
2017,Morelos,17,Jiutepec,17011,107310,114233,221543
2017,Morelos,17,Jojutla,17012,28885,30975,59860
2017,Morelos,17,Jonacatepec,17013,7806,8442,16248
2017,Morelos,17,Mazatepec,17014,5081,5316,10397
2017,Morelos,17,Miacatlán,17015,13368,14120,27488
2017,Morelos,17,Ocuituco,17016,9354,9624,18978
2017,Morelos,17,Puente de Ixtla,17017,33610,34987,68597
2017,Morelos,17,Temixco,17018,58655,61414,120069
2017,Morelos,17,Temoac,17033,7877,8373,16250
2017,Morelos,17,Tepalcingo,17019,13684,14337,28021
2017,Morelos,17,Tepoztlán,17020,23908,24734,48642
2017,Morelos,17,Tetecala,17021,4016,4050,8066
2017,Morelos,17,Tetela del Volcán,17022,10294,10930,21224
2017,Morelos,17,Tlalnepantla,17023,3752,3672,7424
2017,Morelos,17,Tlaltizapán de Zapata,17024,26278,27648,53926
2017,Morelos,17,Tlaquiltenango,17025,17293,17757,35050
2017,Morelos,17,Tlayacapan,17026,9114,9307,18421
2017,Morelos,17,Totolapan,17027,6081,6252,12333
2017,Morelos,17,Xochitepec,17028,36169,35281,71450
2017,Morelos,17,Yautepec,17029,51852,54685,106537
2017,Morelos,17,Yecapixtla,17030,26546,27186,53732
2017,Morelos,17,Zacatepec,17031,18335,19810,38145
2017,Morelos,17,Zacualpan,17032,4796,5028,9824
2017,Nayarit,18,Acaponeta,18001,19797,19670,39467
2017,Nayarit,18,Ahuacatlán,18002,8384,8319,16703
2017,Nayarit,18,Amatlán de Cañas,18003,6272,6064,12336
2017,Nayarit,18,Bahía de Banderas,18020,81704,78871,160575
2017,Nayarit,18,Compostela,18004,39620,39323,78943
2017,Nayarit,18,Del Nayar,18009,21565,21443,43008
2017,Nayarit,18,Huajicori,18005,6655,6381,13036
2017,Nayarit,18,Ixtlán del Río,18006,14892,15822,30714
2017,Nayarit,18,Jala,18007,9623,9785,19408
2017,Nayarit,18,La Yesca,18019,7520,7160,14680
2017,Nayarit,18,Rosamorada,18010,18519,17743,36262
2017,Nayarit,18,Ruíz,18011,13147,12807,25954
2017,Nayarit,18,San Blas,18012,24423,21997,46420
2017,Nayarit,18,San Pedro Lagunillas,18013,4063,3958,8021
2017,Nayarit,18,Santa María del Oro,18014,12742,12089,24831
2017,Nayarit,18,Santiago Ixcuintla,18015,52095,50406,102501
2017,Nayarit,18,Tecuala,18016,21397,20673,42070
2017,Nayarit,18,Tepic,18017,209046,218315,427361
2017,Nayarit,18,Tuxpan,18018,16164,16280,32444
2017,Nayarit,18,Xalisco,18008,28925,30057,58982
2017,Nuevo León,19,Abasolo,19001,1460,1451,2911
2017,Nuevo León,19,Agualeguas,19002,1386,1324,2710
2017,Nuevo León,19,Allende,19004,18571,18220,36791
2017,Nuevo León,19,Anáhuac,19005,9813,9849,19662
2017,Nuevo León,19,Apodaca,19006,316383,311512,627895
2017,Nuevo León,19,Aramberri,19007,8717,8495,17212
2017,Nuevo León,19,Bustamante,19008,2114,2108,4222
2017,Nuevo León,19,Cadereyta Jiménez,19009,51866,48958,100824
2017,Nuevo León,19,Cerralvo,19011,4301,4045,8346
2017,Nuevo León,19,China,19013,6001,5704,11705
2017,Nuevo León,19,Ciénega de Flores,19012,23294,22462,45756
2017,Nuevo León,19,Doctor Arroyo,19014,18630,18343,36973
2017,Nuevo León,19,Doctor Coss,19015,917,878,1795
2017,Nuevo León,19,Doctor González,19016,1668,1590,3258
2017,Nuevo León,19,El Carmen,19010,21342,20963,42305
2017,Nuevo León,19,Galeana,19017,22183,21643,43826
2017,Nuevo León,19,García,19018,134621,133685,268306
2017,Nuevo León,19,General Bravo,19020,3068,2887,5955
2017,Nuevo León,19,General Escobedo,19021,221930,220605,442535
2017,Nuevo León,19,General Terán,19022,7921,7941,15862
2017,Nuevo León,19,General Treviño,19023,598,614,1212
2017,Nuevo León,19,General Zaragoza,19024,3337,3104,6441
2017,Nuevo León,19,General Zuazua,19025,41423,40778,82201
2017,Nuevo León,19,Guadalupe,19026,355401,344623,700024
2017,Nuevo León,19,Hidalgo,19047,7982,7894,15876
2017,Nuevo León,19,Higueras,19028,868,801,1669
2017,Nuevo León,19,Hualahuises,19029,3720,3806,7526
2017,Nuevo León,19,Iturbide,19030,2008,1867,3875
2017,Nuevo León,19,Juárez,19031,182032,178487,360519
2017,Nuevo León,19,Lampazos de Naranjo,19032,2842,2763,5605
2017,Nuevo León,19,Linares,19033,42787,42997,85784
2017,Nuevo León,19,Los Aldamas,19003,743,722,1465
2017,Nuevo León,19,Los Herreras,19027,984,1002,1986
2017,Nuevo León,19,Los Ramones,19042,2663,2589,5252
2017,Nuevo León,19,Marín,19034,3127,2932,6059
2017,Nuevo León,19,Melchor Ocampo,19035,527,512,1039
2017,Nuevo León,19,Mier y Noriega,19036,3787,3710,7497
2017,Nuevo León,19,Mina,19037,2964,2819,5783
2017,Nuevo León,19,Montemorelos,19038,32705,32586,65291
2017,Nuevo León,19,Monterrey,19039,540331,559606,1099937
2017,Nuevo León,19,Parás,19040,546,532,1078
2017,Nuevo León,19,Pesquería,19041,50153,50027,100180
2017,Nuevo León,19,Rayones,19043,1494,1388,2882
2017,Nuevo León,19,Sabinas Hidalgo,19044,18775,19243,38018
2017,Nuevo León,19,Salinas Victoria,19045,29097,27894,56991
2017,Nuevo León,19,San Nicolás de los Garza,19046,234130,240091,474221
2017,Nuevo León,19,San Pedro Garza García,19019,63572,71132,134704
2017,Nuevo León,19,Santa Catarina,19048,156624,154824,311448
2017,Nuevo León,19,Santiago,19049,22872,22585,45457
2017,Nuevo León,19,Vallecillo,19050,1028,872,1900
2017,Nuevo León,19,Villaldama,19051,2249,2228,4477
2017,Oaxaca,20,Abejones,20001,472,605,1077
2017,Oaxaca,20,Acatlán de Pérez Figueroa,20002,23056,24095,47151
2017,Oaxaca,20,Asunción Cacalotepec,20003,1072,1140,2212
2017,Oaxaca,20,Asunción Cuyotepeji,20004,471,542,1013
2017,Oaxaca,20,Asunción Ixtaltepec,20005,7805,7880,15685
2017,Oaxaca,20,Asunción Nochixtlán,20006,9001,10059,19060
2017,Oaxaca,20,Asunción Ocotlán,20007,1178,1456,2634
2017,Oaxaca,20,Asunción Tlacolulita,20008,390,408,798
2017,Oaxaca,20,Ayoquezco de Aldama,20398,2105,2386,4491
2017,Oaxaca,20,Ayotzintepec,20009,3623,3672,7295
2017,Oaxaca,20,Calihualá,20011,587,615,1202
2017,Oaxaca,20,Candelaria Loxicha,20012,5135,5458,10593
2017,Oaxaca,20,Capulálpam de Méndez,20247,708,872,1580
2017,Oaxaca,20,Chahuites,20025,5846,5937,11783
2017,Oaxaca,20,Chalcatongo de Hidalgo,20026,4284,4891,9175
2017,Oaxaca,20,Chiquihuitlán de Benito Juárez,20027,1111,1305,2416
2017,Oaxaca,20,Ciudad Ixtepec,20014,14119,15356,29475
2017,Oaxaca,20,Ciénega de Zimatlán,20013,1440,1586,3026
2017,Oaxaca,20,Coatecas Altas,20015,2316,2566,4882
2017,Oaxaca,20,Coicoyán de las Flores,20016,4666,5260,9926
2017,Oaxaca,20,Concepción Buenavista,20018,405,429,834
2017,Oaxaca,20,Concepción Pápalo,20019,1539,1533,3072
2017,Oaxaca,20,Constancia del Rosario,20020,1872,2170,4042
2017,Oaxaca,20,Cosolapa,20021,7748,8321,16069
2017,Oaxaca,20,Cosoltepec,20022,375,439,814
2017,Oaxaca,20,Cuilápam de Guerrero,20023,10510,11158,21668
2017,Oaxaca,20,Cuyamecalco Villa de Zaragoza,20024,1931,1890,3821
2017,Oaxaca,20,El Barrio de la Soledad,20010,7129,7635,14764
2017,Oaxaca,20,El Espinal,20030,4399,4589,8988
2017,Oaxaca,20,Eloxochitlán de Flores Magón,20029,2072,2302,4374
2017,Oaxaca,20,Fresnillo de Trujano,20032,494,539,1033
2017,Oaxaca,20,Guadalupe Etla,20033,1299,1447,2746
2017,Oaxaca,20,Guadalupe de Ramírez,20034,646,672,1318
2017,Oaxaca,20,Guelatao de Juárez,20035,289,293,582
2017,Oaxaca,20,Guevea de Humboldt,20036,2696,2803,5499
2017,Oaxaca,20,Heroica Ciudad de Ejutla de Crespo,20028,10031,11221,21252
2017,Oaxaca,20,Heroica Ciudad de Huajuapan de León,20039,37040,41301,78341
2017,Oaxaca,20,Heroica Ciudad de Juchitán de Zaragoza,20043,49360,51778,101138
2017,Oaxaca,20,Heroica Ciudad de Tlaxiaco,20397,19497,22016,41513
2017,Oaxaca,20,Huautepec,20040,3007,3414,6421
2017,Oaxaca,20,Huautla de Jiménez,20041,15166,17333,32499
2017,Oaxaca,20,Ixpantepec Nieves,20065,546,676,1222
2017,Oaxaca,20,Ixtlán de Juárez,20042,4125,4252,8377
2017,Oaxaca,20,La Compañía,20017,1622,1796,3418
2017,Oaxaca,20,La Pe,20069,1280,1381,2661
2017,Oaxaca,20,La Reforma,20076,1576,1751,3327
2017,Oaxaca,20,La Trinidad Vista Hermosa,20556,115,143,258
2017,Oaxaca,20,Loma Bonita,20044,21001,22994,43995
2017,Oaxaca,20,Magdalena Apasco,20045,4172,4630,8802
2017,Oaxaca,20,Magdalena Jaltepec,20046,1541,1793,3334
2017,Oaxaca,20,Magdalena Mixtepec,20048,678,699,1377
2017,Oaxaca,20,Magdalena Ocotlán,20049,567,624,1191
2017,Oaxaca,20,Magdalena Peñasco,20050,1694,1949,3643
2017,Oaxaca,20,Magdalena Teitipac,20051,2272,2436,4708
2017,Oaxaca,20,Magdalena Tequisistlán,20052,3085,3230,6315
2017,Oaxaca,20,Magdalena Tlacotepec,20053,612,672,1284
2017,Oaxaca,20,Magdalena Yodocono de Porfirio Díaz,20562,755,803,1558
2017,Oaxaca,20,Magdalena Zahuatlán,20054,201,227,428
2017,Oaxaca,20,Mariscala de Juárez,20055,1732,1882,3614
2017,Oaxaca,20,Matías Romero Avendaño,20057,19565,21058,40623
2017,Oaxaca,20,Mazatlán Villa de Flores,20058,6734,6804,13538
2017,Oaxaca,20,Mesones Hidalgo,20037,2064,2428,4492
2017,Oaxaca,20,Miahuatlán de Porfirio Díaz,20059,21124,23067,44191
2017,Oaxaca,20,Mixistlán de la Reforma,20060,1278,1429,2707
2017,Oaxaca,20,Monjas,20061,1262,1489,2751
2017,Oaxaca,20,Mártires de Tacubaya,20056,700,760,1460
2017,Oaxaca,20,Natividad,20062,280,314,594
2017,Oaxaca,20,Nazareno Etla,20063,1973,2177,4150
2017,Oaxaca,20,Nejapa de Madero,20064,3757,3912,7669
2017,Oaxaca,20,Nuevo Zoquiápam,20504,801,875,1676
2017,Oaxaca,20,Oaxaca de Juárez,20067,121567,137530,259097
2017,Oaxaca,20,Ocotlán de Morelos,20068,10784,11763,22547
2017,Oaxaca,20,Pinotepa de Don Luis,20070,3516,3610,7126
2017,Oaxaca,20,Pluma Hidalgo,20071,1479,1549,3028
2017,Oaxaca,20,Putla Villa de Guerrero,20073,15880,17920,33800
2017,Oaxaca,20,Reforma de Pineda,20075,1388,1468,2856
2017,Oaxaca,20,Reyes Etla,20077,1901,2034,3935
2017,Oaxaca,20,Rojas de Cuauhtémoc,20078,546,600,1146
2017,Oaxaca,20,Salina Cruz,20079,43737,47181,90918
2017,Oaxaca,20,San Agustín Amatengo,20080,685,786,1471
2017,Oaxaca,20,San Agustín Atenango,20081,847,988,1835
2017,Oaxaca,20,San Agustín Chayuco,20082,1982,2192,4174
2017,Oaxaca,20,San Agustín Etla,20084,1977,2175,4152
2017,Oaxaca,20,San Agustín Loxicha,20085,12240,12736,24976
2017,Oaxaca,20,San Agustín Tlacotepec,20086,412,548,960
2017,Oaxaca,20,San Agustín Yatareni,20087,2080,2378,4458
2017,Oaxaca,20,San Agustín de las Juntas,20083,4715,4907,9622
2017,Oaxaca,20,San Andrés Cabecera Nueva,20088,1408,1451,2859
2017,Oaxaca,20,San Andrés Dinicuiti,20089,1072,1136,2208
2017,Oaxaca,20,San Andrés Huaxpaltepec,20090,3070,3242,6312
2017,Oaxaca,20,San Andrés Huayápam,20091,2632,2884,5516
2017,Oaxaca,20,San Andrés Ixtlahuaca,20092,756,865,1621
2017,Oaxaca,20,San Andrés Lagunas,20093,236,272,508
2017,Oaxaca,20,San Andrés Nuxiño,20094,887,966,1853
2017,Oaxaca,20,San Andrés Paxtlán,20095,2200,2218,4418
2017,Oaxaca,20,San Andrés Sinaxtla,20096,360,404,764
2017,Oaxaca,20,San Andrés Solaga,20097,856,907,1763
2017,Oaxaca,20,San Andrés Teotilálpam,20098,2205,2369,4574
2017,Oaxaca,20,San Andrés Tepetlapa,20099,240,277,517
2017,Oaxaca,20,San Andrés Yaá,20100,207,248,455
2017,Oaxaca,20,San Andrés Zabache,20101,329,414,743
2017,Oaxaca,20,San Andrés Zautla,20102,2276,2411,4687
2017,Oaxaca,20,San Antonino Castillo Velasco,20103,2934,3217,6151
2017,Oaxaca,20,San Antonino Monte Verde,20105,3394,3940,7334
2017,Oaxaca,20,San Antonino el Alto,20104,1329,1374,2703
2017,Oaxaca,20,San Antonio Acutla,20106,124,151,275
2017,Oaxaca,20,San Antonio Huitepec,20108,2096,2421,4517
2017,Oaxaca,20,San Antonio Nanahuatípam,20109,635,644,1279
2017,Oaxaca,20,San Antonio Sinicahua,20110,745,864,1609
2017,Oaxaca,20,San Antonio Tepetlapa,20111,2119,2284,4403
2017,Oaxaca,20,San Antonio de la Cal,20107,11648,12950,24598
2017,Oaxaca,20,San Baltazar Chichicápam,20112,1224,1390,2614
2017,Oaxaca,20,San Baltazar Loxicha,20113,1482,1562,3044
2017,Oaxaca,20,San Baltazar Yatzachi el Bajo,20114,320,361,681
2017,Oaxaca,20,San Bartolo Coyotepec,20115,4642,5122,9764
2017,Oaxaca,20,San Bartolo Soyaltepec,20121,298,375,673
2017,Oaxaca,20,San Bartolo Yautepec,20122,335,339,674
2017,Oaxaca,20,San Bartolomé Ayautla,20116,2213,2343,4556
2017,Oaxaca,20,San Bartolomé Loxicha,20117,1216,1245,2461
2017,Oaxaca,20,San Bartolomé Quialana,20118,1067,1490,2557
2017,Oaxaca,20,San Bartolomé Yucuañe,20119,162,233,395
2017,Oaxaca,20,San Bartolomé Zoogocho,20120,143,194,337
2017,Oaxaca,20,San Bernardo Mixtepec,20123,1318,1446,2764
2017,Oaxaca,20,San Blas Atempa,20124,9441,9368,18809
2017,Oaxaca,20,San Carlos Yautepec,20125,6158,6115,12273
2017,Oaxaca,20,San Cristóbal Amatlán,20126,2474,2792,5266
2017,Oaxaca,20,San Cristóbal Amoltepec,20127,537,628,1165
2017,Oaxaca,20,San Cristóbal Lachirioag,20128,609,667,1276
2017,Oaxaca,20,San Cristóbal Suchixtlahuaca,20129,174,188,362
2017,Oaxaca,20,San Dionisio Ocotepec,20131,5130,5839,10969
2017,Oaxaca,20,San Dionisio Ocotlán,20132,586,608,1194
2017,Oaxaca,20,San Dionisio del Mar,20130,2729,2624,5353
2017,Oaxaca,20,San Esteban Atatlahuca,20133,1888,1975,3863
2017,Oaxaca,20,San Felipe Jalapa de Díaz,20134,13913,14761,28674
2017,Oaxaca,20,San Felipe Tejalápam,20135,3792,4146,7938
2017,Oaxaca,20,San Felipe Usila,20136,5771,6239,12010
2017,Oaxaca,20,San Francisco Cahuacuá,20137,1728,1754,3482
2017,Oaxaca,20,San Francisco Cajonos,20138,207,237,444
2017,Oaxaca,20,San Francisco Chapulapa,20139,1024,1103,2127
2017,Oaxaca,20,San Francisco Chindúa,20140,404,424,828
2017,Oaxaca,20,San Francisco Huehuetlán,20142,495,620,1115
2017,Oaxaca,20,San Francisco Ixhuatán,20143,4603,4703,9306
2017,Oaxaca,20,San Francisco Jaltepetongo,20144,498,518,1016
2017,Oaxaca,20,San Francisco Lachigoló,20145,2084,2170,4254
2017,Oaxaca,20,San Francisco Logueche,20146,1364,1547,2911
2017,Oaxaca,20,San Francisco Nuxaño,20147,196,185,381
2017,Oaxaca,20,San Francisco Ozolotepec,20148,960,1013,1973
2017,Oaxaca,20,San Francisco Sola,20149,812,905,1717
2017,Oaxaca,20,San Francisco Telixtlahuaca,20150,6316,6772,13088
2017,Oaxaca,20,San Francisco Teopan,20151,184,168,352
2017,Oaxaca,20,San Francisco Tlapancingo,20152,1027,1272,2299
2017,Oaxaca,20,San Francisco del Mar,20141,4008,3891,7899
2017,Oaxaca,20,San Gabriel Mixtepec,20153,2397,2559,4956
2017,Oaxaca,20,San Ildefonso Amatlán,20154,1167,1332,2499
2017,Oaxaca,20,San Ildefonso Sola,20155,494,490,984
2017,Oaxaca,20,San Ildefonso Villa Alta,20156,1694,1803,3497
2017,Oaxaca,20,San Jacinto Amilpas,20157,8270,9124,17394
2017,Oaxaca,20,San Jacinto Tlacotepec,20158,1109,1176,2285
2017,Oaxaca,20,San Jerónimo Coatlán,20159,2669,2821,5490
2017,Oaxaca,20,San Jerónimo Silacayoapilla,20160,711,750,1461
2017,Oaxaca,20,San Jerónimo Sosola,20161,1252,1407,2659
2017,Oaxaca,20,San Jerónimo Taviche,20162,940,1030,1970
2017,Oaxaca,20,San Jerónimo Tecóatl,20163,778,876,1654
2017,Oaxaca,20,San Jerónimo Tlacochahuaya,20550,2637,2979,5616
2017,Oaxaca,20,San Jorge Nuchita,20164,1362,1596,2958
2017,Oaxaca,20,San José Ayuquila,20165,721,842,1563
2017,Oaxaca,20,San José Chiltepec,20166,5947,6310,12257
2017,Oaxaca,20,San José Estancia Grande,20168,533,539,1072
2017,Oaxaca,20,San José Independencia,20169,1861,2005,3866
2017,Oaxaca,20,San José Lachiguiri,20170,1625,1995,3620
2017,Oaxaca,20,San José Tenango,20171,9132,9801,18933
2017,Oaxaca,20,San José del Peñasco,20167,1062,1101,2163
2017,Oaxaca,20,San José del Progreso,20072,3381,3592,6973
2017,Oaxaca,20,San Juan Achiutla,20172,202,212,414
2017,Oaxaca,20,San Juan Atepec,20173,715,801,1516
2017,Oaxaca,20,San Juan Bautista Atatlahuca,20175,797,846,1643
2017,Oaxaca,20,San Juan Bautista Coixtlahuaca,20176,1332,1461,2793
2017,Oaxaca,20,San Juan Bautista Cuicatlán,20177,4948,5237,10185
2017,Oaxaca,20,San Juan Bautista Guelache,20178,3506,3909,7415
2017,Oaxaca,20,San Juan Bautista Jayacatlán,20179,758,745,1503
2017,Oaxaca,20,San Juan Bautista Lo de Soto,20180,1278,1301,2579
2017,Oaxaca,20,San Juan Bautista Suchitepec,20181,206,245,451
2017,Oaxaca,20,San Juan Bautista Tlachichilco,20183,668,777,1445
2017,Oaxaca,20,San Juan Bautista Tlacoatzintepec,20182,1076,1192,2268
2017,Oaxaca,20,San Juan Bautista Tuxtepec,20184,80628,87126,167754
2017,Oaxaca,20,San Juan Bautista Valle Nacional,20559,11112,12139,23251
2017,Oaxaca,20,San Juan Cacahuatepec,20185,4440,4663,9103
2017,Oaxaca,20,San Juan Chicomezúchil,20191,155,183,338
2017,Oaxaca,20,San Juan Chilateca,20192,720,835,1555
2017,Oaxaca,20,San Juan Cieneguilla,20186,281,308,589
2017,Oaxaca,20,San Juan Coatzóspam,20187,1127,1102,2229
2017,Oaxaca,20,San Juan Colorado,20188,4920,5218,10138
2017,Oaxaca,20,San Juan Comaltepec,20189,1396,1465,2861
2017,Oaxaca,20,San Juan Cotzocón,20190,11791,12426,24217
2017,Oaxaca,20,San Juan Diuxi,20195,570,578,1148
2017,Oaxaca,20,San Juan Evangelista Analco,20196,206,219,425
2017,Oaxaca,20,San Juan Guelavía,20197,1619,1719,3338
2017,Oaxaca,20,San Juan Guichicovi,20198,14273,16070,30343
2017,Oaxaca,20,San Juan Ihualtepec,20199,300,348,648
2017,Oaxaca,20,San Juan Juquila Mixes,20200,1851,2068,3919
2017,Oaxaca,20,San Juan Juquila Vijanos,20201,959,1040,1999
2017,Oaxaca,20,San Juan Lachao,20202,2362,2514,4876
2017,Oaxaca,20,San Juan Lachigalla,20203,1653,1756,3409
2017,Oaxaca,20,San Juan Lajarcia,20204,303,370,673
2017,Oaxaca,20,San Juan Lalana,20205,8580,8983,17563
2017,Oaxaca,20,San Juan Mazatlán,20207,9388,9528,18916
2017,Oaxaca,20,San Juan Mixtepec Distrito 08,20208,3351,3851,7202
2017,Oaxaca,20,San Juan Mixtepec Distrito 26,20209,302,425,727
2017,Oaxaca,20,San Juan Ozolotepec,20211,1427,1411,2838
2017,Oaxaca,20,San Juan Petlapa,20212,1450,1547,2997
2017,Oaxaca,20,San Juan Quiahije,20213,1957,2221,4178
2017,Oaxaca,20,San Juan Quiotepec,20214,1070,1107,2177
2017,Oaxaca,20,San Juan Sayultepec,20215,376,441,817
2017,Oaxaca,20,San Juan Tabaá,20216,644,704,1348
2017,Oaxaca,20,San Juan Tamazola,20217,1526,1599,3125
2017,Oaxaca,20,San Juan Teita,20218,297,315,612
2017,Oaxaca,20,San Juan Teitipac,20219,1287,1412,2699
2017,Oaxaca,20,San Juan Tepeuxila,20220,1431,1348,2779
2017,Oaxaca,20,San Juan Teposcolula,20221,637,675,1312
2017,Oaxaca,20,San Juan Yaeé,20222,731,827,1558
2017,Oaxaca,20,San Juan Yatzona,20223,219,273,492
2017,Oaxaca,20,San Juan Yucuita,20224,285,341,626
2017,Oaxaca,20,San Juan de los Cués,20206,1240,1261,2501
2017,Oaxaca,20,San Juan del Estado,20193,1294,1402,2696
2017,Oaxaca,20,San Juan del Río,20194,592,711,1303
2017,Oaxaca,20,San Juan Ñumí,20210,2900,3305,6205
2017,Oaxaca,20,San Lorenzo,20225,3024,3255,6279
2017,Oaxaca,20,San Lorenzo Albarradas,20226,1429,1395,2824
2017,Oaxaca,20,San Lorenzo Cacaotepec,20227,7632,8298,15930
2017,Oaxaca,20,San Lorenzo Cuaunecuiltitla,20228,435,394,829
2017,Oaxaca,20,San Lorenzo Texmelúcan,20229,3821,4423,8244
2017,Oaxaca,20,San Lorenzo Victoria,20230,489,511,1000
2017,Oaxaca,20,San Lucas Camotlán,20231,1517,1603,3120
2017,Oaxaca,20,San Lucas Ojitlán,20232,10248,10890,21138
2017,Oaxaca,20,San Lucas Quiaviní,20233,747,1049,1796
2017,Oaxaca,20,San Lucas Zoquiápam,20234,3721,3929,7650
2017,Oaxaca,20,San Luis Amatlán,20235,1721,2020,3741
2017,Oaxaca,20,San Marcial Ozolotepec,20236,741,815,1556
2017,Oaxaca,20,San Marcos Arteaga,20237,704,814,1518
2017,Oaxaca,20,San Martín Huamelúlpam,20239,492,586,1078
2017,Oaxaca,20,San Martín Itunyoso,20240,1061,1332,2393
2017,Oaxaca,20,San Martín Lachilá,20241,494,615,1109
2017,Oaxaca,20,San Martín Peras,20242,6018,6430,12448
2017,Oaxaca,20,San Martín Tilcajete,20243,836,1028,1864
2017,Oaxaca,20,San Martín Toxpalan,20244,1907,2013,3920
2017,Oaxaca,20,San Martín Zacatepec,20245,640,666,1306
2017,Oaxaca,20,San Martín de los Cansecos,20238,431,442,873
2017,Oaxaca,20,San Mateo Cajonos,20246,292,350,642
2017,Oaxaca,20,San Mateo Etlatongo,20250,567,606,1173
2017,Oaxaca,20,San Mateo Nejápam,20251,560,620,1180
2017,Oaxaca,20,San Mateo Peñasco,20252,1002,1162,2164
2017,Oaxaca,20,San Mateo Piñas,20253,1050,1053,2103
2017,Oaxaca,20,San Mateo Río Hondo,20254,1579,1653,3232
2017,Oaxaca,20,San Mateo Sindihui,20255,992,1100,2092
2017,Oaxaca,20,San Mateo Tlapiltepec,20256,109,125,234
2017,Oaxaca,20,San Mateo Yoloxochitlán,20249,1765,1932,3697
2017,Oaxaca,20,San Mateo Yucutindoo,20566,1557,1595,3152
2017,Oaxaca,20,San Mateo del Mar,20248,7767,7530,15297
2017,Oaxaca,20,San Melchor Betaza,20257,488,563,1051
2017,Oaxaca,20,San Miguel Achiutla,20258,364,404,768
2017,Oaxaca,20,San Miguel Ahuehuetitlán,20259,1167,1286,2453
2017,Oaxaca,20,San Miguel Aloápam,20260,1100,1248,2348
2017,Oaxaca,20,San Miguel Amatitlán,20261,3600,3994,7594
2017,Oaxaca,20,San Miguel Amatlán,20262,501,530,1031
2017,Oaxaca,20,San Miguel Chicahua,20264,987,1215,2202
2017,Oaxaca,20,San Miguel Chimalapa,20265,3604,3426,7030
2017,Oaxaca,20,San Miguel Coatlán,20263,1567,1825,3392
2017,Oaxaca,20,San Miguel Ejutla,20268,465,545,1010
2017,Oaxaca,20,San Miguel Huautla,20270,553,642,1195
2017,Oaxaca,20,San Miguel Mixtepec,20271,1604,1668,3272
2017,Oaxaca,20,San Miguel Panixtlahuaca,20272,3108,3715,6823
2017,Oaxaca,20,San Miguel Peras,20273,1651,1785,3436
2017,Oaxaca,20,San Miguel Piedras,20274,651,684,1335
2017,Oaxaca,20,San Miguel Quetzaltepec,20275,4102,4060,8162
2017,Oaxaca,20,San Miguel Santa Flor,20276,373,372,745
2017,Oaxaca,20,San Miguel Soyaltepec,20278,19433,20519,39952
2017,Oaxaca,20,San Miguel Suchixtepec,20279,1350,1483,2833
2017,Oaxaca,20,San Miguel Tecomatlán,20281,165,142,307
2017,Oaxaca,20,San Miguel Tenango,20282,382,370,752
2017,Oaxaca,20,San Miguel Tequixtepec,20283,510,536,1046
2017,Oaxaca,20,San Miguel Tilquiápam,20284,1453,1794,3247
2017,Oaxaca,20,San Miguel Tlacamama,20285,1819,1881,3700
2017,Oaxaca,20,San Miguel Tlacotepec,20286,1528,1765,3293
2017,Oaxaca,20,San Miguel Tulancingo,20287,126,193,319
2017,Oaxaca,20,San Miguel Yotao,20288,299,324,623
2017,Oaxaca,20,San Miguel del Puerto,20266,4239,4328,8567
2017,Oaxaca,20,San Miguel del Río,20267,138,135,273
2017,Oaxaca,20,San Miguel el Grande,20269,1989,2252,4241
2017,Oaxaca,20,San Nicolás,20289,530,643,1173
2017,Oaxaca,20,San Nicolás Hidalgo,20290,472,552,1024
2017,Oaxaca,20,San Pablo Coatlán,20291,2112,2213,4325
2017,Oaxaca,20,San Pablo Cuatro Venados,20292,668,763,1431
2017,Oaxaca,20,San Pablo Etla,20293,8676,9567,18243
2017,Oaxaca,20,San Pablo Huitzo,20294,3388,3799,7187
2017,Oaxaca,20,San Pablo Huixtepec,20295,4568,5037,9605
2017,Oaxaca,20,San Pablo Macuiltianguis,20296,450,476,926
2017,Oaxaca,20,San Pablo Tijaltepec,20297,1131,1352,2483
2017,Oaxaca,20,San Pablo Villa de Mitla,20298,6174,6745,12919
2017,Oaxaca,20,San Pablo Yaganiza,20299,523,587,1110
2017,Oaxaca,20,San Pedro Amuzgos,20300,3180,3627,6807
2017,Oaxaca,20,San Pedro Apóstol,20301,728,855,1583
2017,Oaxaca,20,San Pedro Atoyac,20302,2118,2368,4486
2017,Oaxaca,20,San Pedro Cajonos,20303,512,625,1137
2017,Oaxaca,20,San Pedro Comitancillo,20305,2072,2281,4353
2017,Oaxaca,20,San Pedro Coxcaltepec Cántaros,20304,382,412,794
2017,Oaxaca,20,San Pedro Huamelula,20307,5089,5102,10191
2017,Oaxaca,20,San Pedro Huilotepec,20308,1582,1610,3192
2017,Oaxaca,20,San Pedro Ixcatlán,20309,5731,5953,11684
2017,Oaxaca,20,San Pedro Ixtlahuaca,20310,4239,4507,8746
2017,Oaxaca,20,San Pedro Jaltepetongo,20311,256,293,549
2017,Oaxaca,20,San Pedro Jicayán,20312,5961,6474,12435
2017,Oaxaca,20,San Pedro Jocotipac,20313,369,445,814
2017,Oaxaca,20,San Pedro Juchatengo,20314,792,876,1668
2017,Oaxaca,20,San Pedro Mixtepec Distrito 22,20318,23975,25250,49225
2017,Oaxaca,20,San Pedro Mixtepec Distrito 26,20319,528,584,1112
2017,Oaxaca,20,San Pedro Molinos,20320,338,376,714
2017,Oaxaca,20,San Pedro Mártir,20315,772,982,1754
2017,Oaxaca,20,San Pedro Mártir Quiechapa,20316,342,389,731
2017,Oaxaca,20,San Pedro Mártir Yucuxaco,20317,609,710,1319
2017,Oaxaca,20,San Pedro Nopala,20321,363,402,765
2017,Oaxaca,20,San Pedro Ocopetatillo,20322,397,455,852
2017,Oaxaca,20,San Pedro Ocotepec,20323,1074,1120,2194
2017,Oaxaca,20,San Pedro Pochutla,20324,23725,24468,48193
2017,Oaxaca,20,San Pedro Quiatoni,20325,5415,5736,11151
2017,Oaxaca,20,San Pedro Sochiápam,20326,2565,2630,5195
2017,Oaxaca,20,San Pedro Tapanatepec,20327,7564,7722,15286
2017,Oaxaca,20,San Pedro Taviche,20328,609,628,1237
2017,Oaxaca,20,San Pedro Teozacoalco,20329,624,670,1294
2017,Oaxaca,20,San Pedro Teutila,20330,2170,2235,4405
2017,Oaxaca,20,San Pedro Tidaá,20331,419,480,899
2017,Oaxaca,20,San Pedro Topiltepec,20332,178,196,374
2017,Oaxaca,20,San Pedro Totolápam,20333,1292,1432,2724
2017,Oaxaca,20,San Pedro Yaneri,20335,470,497,967
2017,Oaxaca,20,San Pedro Yucunama,20341,103,138,241
2017,Oaxaca,20,San Pedro Yólox,20336,936,994,1930
2017,Oaxaca,20,San Pedro el Alto,20306,1901,1991,3892
2017,Oaxaca,20,San Pedro y San Pablo Ayutla,20337,2458,2903,5361
2017,Oaxaca,20,San Pedro y San Pablo Teposcolula,20339,2002,2199,4201
2017,Oaxaca,20,San Pedro y San Pablo Tequixtepec,20340,796,982,1778
2017,Oaxaca,20,San Raymundo Jalpan,20342,1572,1891,3463
2017,Oaxaca,20,San Sebastián Abasolo,20343,934,1017,1951
2017,Oaxaca,20,San Sebastián Coatlán,20344,1338,1421,2759
2017,Oaxaca,20,San Sebastián Ixcapa,20345,2033,2096,4129
2017,Oaxaca,20,San Sebastián Nicananduta,20346,643,853,1496
2017,Oaxaca,20,San Sebastián Río Hondo,20347,1841,1884,3725
2017,Oaxaca,20,San Sebastián Tecomaxtlahuaca,20348,3997,4423,8420
2017,Oaxaca,20,San Sebastián Teitipac,20349,927,1105,2032
2017,Oaxaca,20,San Sebastián Tutla,20350,9005,10344,19349
2017,Oaxaca,20,San Simón Almolongas,20351,1290,1483,2773
2017,Oaxaca,20,San Simón Zahuatlán,20352,2081,2127,4208
2017,Oaxaca,20,San Vicente Coatlán,20534,1841,2209,4050
2017,Oaxaca,20,San Vicente Lachixío,20535,1423,1605,3028
2017,Oaxaca,20,San Vicente Nuñú,20536,208,245,453
2017,Oaxaca,20,Santa Ana,20353,1047,1150,2197
2017,Oaxaca,20,Santa Ana Ateixtlahuaca,20354,268,267,535
2017,Oaxaca,20,Santa Ana Cuauhtémoc,20355,362,390,752
2017,Oaxaca,20,Santa Ana Tavela,20357,416,437,853
2017,Oaxaca,20,Santa Ana Tlapacoyan,20358,944,1044,1988
2017,Oaxaca,20,Santa Ana Yareni,20359,425,507,932
2017,Oaxaca,20,Santa Ana Zegache,20360,1798,2037,3835
2017,Oaxaca,20,Santa Ana del Valle,20356,1028,1104,2132
2017,Oaxaca,20,Santa Catalina Quierí,20361,423,511,934
2017,Oaxaca,20,Santa Catarina Cuixtla,20362,661,824,1485
2017,Oaxaca,20,Santa Catarina Ixtepeji,20363,1302,1398,2700
2017,Oaxaca,20,Santa Catarina Juquila,20364,7834,8295,16129
2017,Oaxaca,20,Santa Catarina Lachatao,20365,560,599,1159
2017,Oaxaca,20,Santa Catarina Loxicha,20366,1984,2028,4012
2017,Oaxaca,20,Santa Catarina Mechoacán,20367,2312,2349,4661
2017,Oaxaca,20,Santa Catarina Minas,20368,968,1005,1973
2017,Oaxaca,20,Santa Catarina Quiané,20369,945,1020,1965
2017,Oaxaca,20,Santa Catarina Quioquitani,20074,255,279,534
2017,Oaxaca,20,Santa Catarina Tayata,20370,310,369,679
2017,Oaxaca,20,Santa Catarina Ticuá,20371,473,588,1061
2017,Oaxaca,20,Santa Catarina Yosonotú,20372,794,959,1753
2017,Oaxaca,20,Santa Catarina Zapoquila,20373,182,211,393
2017,Oaxaca,20,Santa Cruz Acatepec,20374,758,825,1583
2017,Oaxaca,20,Santa Cruz Amilpas,20375,6017,6950,12967
2017,Oaxaca,20,Santa Cruz Itundujia,20377,5656,6113,11769
2017,Oaxaca,20,Santa Cruz Mixtepec,20378,1704,1880,3584
2017,Oaxaca,20,Santa Cruz Nundaco,20379,1388,1625,3013
2017,Oaxaca,20,Santa Cruz Papalutla,20380,1060,1125,2185
2017,Oaxaca,20,Santa Cruz Tacache de Mina,20381,1304,1442,2746
2017,Oaxaca,20,Santa Cruz Tacahua,20382,547,614,1161
2017,Oaxaca,20,Santa Cruz Tayata,20383,302,314,616
2017,Oaxaca,20,Santa Cruz Xitla,20384,2292,2556,4848
2017,Oaxaca,20,Santa Cruz Xoxocotlán,20385,44512,49895,94407
2017,Oaxaca,20,Santa Cruz Zenzontepec,20386,9189,9610,18799
2017,Oaxaca,20,Santa Cruz de Bravo,20376,179,193,372
2017,Oaxaca,20,Santa Gertrudis,20387,1413,1532,2945
2017,Oaxaca,20,Santa Inés Yatzeche,20389,408,549,957
2017,Oaxaca,20,Santa Inés de Zaragoza,20569,789,890,1679
2017,Oaxaca,20,Santa Inés del Monte,20388,1211,1268,2479
2017,Oaxaca,20,Santa Lucía Miahuatlán,20391,1703,1778,3481
2017,Oaxaca,20,Santa Lucía Monteverde,20392,3186,3472,6658
2017,Oaxaca,20,Santa Lucía Ocotlán,20393,1812,2133,3945
2017,Oaxaca,20,Santa Lucía del Camino,20390,24940,26799,51739
2017,Oaxaca,20,Santa Magdalena Jicotlán,20047,42,51,93
2017,Oaxaca,20,Santa María Alotepec,20394,1415,1454,2869
2017,Oaxaca,20,Santa María Apazco,20395,806,979,1785
2017,Oaxaca,20,Santa María Atzompa,20399,16883,18192,35075
2017,Oaxaca,20,Santa María Camotlán,20400,763,882,1645
2017,Oaxaca,20,Santa María Chachoápam,20404,359,412,771
2017,Oaxaca,20,Santa María Chilchotla,20406,10369,10713,21082
2017,Oaxaca,20,Santa María Chimalapa,20407,4701,4564,9265
2017,Oaxaca,20,Santa María Colotepec,20401,12177,12328,24505
2017,Oaxaca,20,Santa María Cortijo,20402,529,569,1098
2017,Oaxaca,20,Santa María Coyotepec,20403,1483,1640,3123
2017,Oaxaca,20,Santa María Ecatepec,20410,1742,1779,3521
2017,Oaxaca,20,Santa María Guelacé,20411,379,465,844
2017,Oaxaca,20,Santa María Guienagati,20412,1638,1640,3278
2017,Oaxaca,20,Santa María Huatulco,20413,22171,23161,45332
2017,Oaxaca,20,Santa María Huazolotitlán,20414,5717,5933,11650
2017,Oaxaca,20,Santa María Ipalapa,20415,2386,2667,5053
2017,Oaxaca,20,Santa María Ixcatlán,20416,242,274,516
2017,Oaxaca,20,Santa María Jacatepec,20417,4567,5076,9643
2017,Oaxaca,20,Santa María Jalapa del Marqués,20418,6428,6852,13280
2017,Oaxaca,20,Santa María Jaltianguis,20419,246,294,540
2017,Oaxaca,20,Santa María Lachixío,20420,886,1028,1914
2017,Oaxaca,20,Santa María Mixtequilla,20421,2317,2447,4764
2017,Oaxaca,20,Santa María Nativitas,20422,286,340,626
2017,Oaxaca,20,Santa María Nduayaco,20423,259,256,515
2017,Oaxaca,20,Santa María Ozolotepec,20424,1946,2063,4009
2017,Oaxaca,20,Santa María Petapa,20427,8109,8674,16783
2017,Oaxaca,20,Santa María Peñoles,20426,4200,4410,8610
2017,Oaxaca,20,Santa María Pápalo,20425,1108,1098,2206
2017,Oaxaca,20,Santa María Quiegolani,20428,972,961,1933
2017,Oaxaca,20,Santa María Sola,20429,733,792,1525
2017,Oaxaca,20,Santa María Tataltepec,20430,172,186,358
2017,Oaxaca,20,Santa María Tecomavaca,20431,846,911,1757
2017,Oaxaca,20,Santa María Temaxcalapa,20432,464,497,961
2017,Oaxaca,20,Santa María Temaxcaltepec,20433,1274,1413,2687
2017,Oaxaca,20,Santa María Teopoxco,20434,2108,2357,4465
2017,Oaxaca,20,Santa María Tepantlali,20435,1849,1920,3769
2017,Oaxaca,20,Santa María Texcatitlán,20436,496,539,1035
2017,Oaxaca,20,Santa María Tlahuitoltepec,20437,4654,4923,9577
2017,Oaxaca,20,Santa María Tlalixtac,20438,846,899,1745
2017,Oaxaca,20,Santa María Tonameca,20439,12743,13041,25784
2017,Oaxaca,20,Santa María Totolapilla,20440,412,463,875
2017,Oaxaca,20,Santa María Xadani,20441,4450,4387,8837
2017,Oaxaca,20,Santa María Yalina,20442,137,158,295
2017,Oaxaca,20,Santa María Yavesía,20443,222,267,489
2017,Oaxaca,20,Santa María Yolotepec,20444,203,226,429
2017,Oaxaca,20,Santa María Yosoyúa,20445,834,829,1663
2017,Oaxaca,20,Santa María Yucuhiti,20446,3110,3369,6479
2017,Oaxaca,20,Santa María Zacatepec,20447,7626,8622,16248
2017,Oaxaca,20,Santa María Zaniza,20448,1086,1153,2239
2017,Oaxaca,20,Santa María Zoquitlán,20449,1543,1604,3147
2017,Oaxaca,20,Santa María del Rosario,20408,258,245,503
2017,Oaxaca,20,Santa María del Tule,20409,4308,4936,9244
2017,Oaxaca,20,Santa María la Asunción,20396,1493,1870,3363
2017,Oaxaca,20,Santiago Amoltepec,20450,6246,6630,12876
2017,Oaxaca,20,Santiago Apoala,20451,434,498,932
2017,Oaxaca,20,Santiago Apóstol,20452,1848,2289,4137
2017,Oaxaca,20,Santiago Astata,20453,2003,2029,4032
2017,Oaxaca,20,Santiago Atitlán,20454,1600,1541,3141
2017,Oaxaca,20,Santiago Ayuquililla,20455,1303,1447,2750
2017,Oaxaca,20,Santiago Cacaloxtepec,20456,789,860,1649
2017,Oaxaca,20,Santiago Camotlán,20457,1630,1650,3280
2017,Oaxaca,20,Santiago Chazumba,20459,2048,2529,4577
2017,Oaxaca,20,Santiago Choápam,20460,2565,2746,5311
2017,Oaxaca,20,Santiago Comaltepec,20458,492,552,1044
2017,Oaxaca,20,Santiago Huajolotitlán,20462,1952,2343,4295
2017,Oaxaca,20,Santiago Huauclilla,20463,270,299,569
2017,Oaxaca,20,Santiago Ihuitlán Plumas,20464,178,215,393
2017,Oaxaca,20,Santiago Ixcuintepec,20465,814,833,1647
2017,Oaxaca,20,Santiago Ixtayutla,20466,6370,6715,13085
2017,Oaxaca,20,Santiago Jamiltepec,20467,9388,10127,19515
2017,Oaxaca,20,Santiago Jocotepec,20468,7022,7255,14277
2017,Oaxaca,20,Santiago Juxtlahuaca,20469,17360,19225,36585
2017,Oaxaca,20,Santiago Lachiguiri,20470,2443,2493,4936
2017,Oaxaca,20,Santiago Lalopa,20471,243,262,505
2017,Oaxaca,20,Santiago Laollaga,20472,1702,1721,3423
2017,Oaxaca,20,Santiago Laxopa,20473,641,715,1356
2017,Oaxaca,20,Santiago Llano Grande,20474,1665,1699,3364
2017,Oaxaca,20,Santiago Matatlán,20475,4750,5375,10125
2017,Oaxaca,20,Santiago Miltepec,20476,203,210,413
2017,Oaxaca,20,Santiago Minas,20477,721,742,1463
2017,Oaxaca,20,Santiago Nacaltepec,20478,880,977,1857
2017,Oaxaca,20,Santiago Nejapilla,20479,112,102,214
2017,Oaxaca,20,Santiago Niltepec,20066,2745,2781,5526
2017,Oaxaca,20,Santiago Nundiche,20480,448,488,936
2017,Oaxaca,20,Santiago Nuyoó,20481,898,990,1888
2017,Oaxaca,20,Santiago Pinotepa Nacional,20482,26399,27656,54055
2017,Oaxaca,20,Santiago Suchilquitongo,20483,5122,5517,10639
2017,Oaxaca,20,Santiago Tamazola,20484,2108,2445,4553
2017,Oaxaca,20,Santiago Tapextla,20485,1603,1562,3165
2017,Oaxaca,20,Santiago Tenango,20487,1037,1029,2066
2017,Oaxaca,20,Santiago Tepetlapa,20488,60,67,127
2017,Oaxaca,20,Santiago Tetepec,20489,2510,2573,5083
2017,Oaxaca,20,Santiago Texcalcingo,20490,1533,1641,3174
2017,Oaxaca,20,Santiago Textitlán,20491,2229,2249,4478
2017,Oaxaca,20,Santiago Tilantongo,20492,1429,1662,3091
2017,Oaxaca,20,Santiago Tillo,20493,258,296,554
2017,Oaxaca,20,Santiago Tlazoyaltepec,20494,2205,2642,4847
2017,Oaxaca,20,Santiago Xanica,20495,1539,1545,3084
2017,Oaxaca,20,Santiago Xiacuí,20496,1004,1111,2115
2017,Oaxaca,20,Santiago Yaitepec,20497,2027,2358,4385
2017,Oaxaca,20,Santiago Yaveo,20498,3476,3467,6943
2017,Oaxaca,20,Santiago Yolomécatl,20499,993,1177,2170
2017,Oaxaca,20,Santiago Yosondúa,20500,3994,4468,8462
2017,Oaxaca,20,Santiago Yucuyachi,20501,444,490,934
2017,Oaxaca,20,Santiago Zacatepec,20502,2678,2742,5420
2017,Oaxaca,20,Santiago Zoochila,20503,192,220,412
2017,Oaxaca,20,Santiago del Río,20461,269,287,556
2017,Oaxaca,20,Santo Domingo Albarradas,20506,366,423,789
2017,Oaxaca,20,Santo Domingo Armenta,20507,1727,1745,3472
2017,Oaxaca,20,Santo Domingo Chihuitán,20508,773,790,1563
2017,Oaxaca,20,Santo Domingo Ingenio,20505,4097,4090,8187
2017,Oaxaca,20,Santo Domingo Ixcatlán,20510,357,412,769
2017,Oaxaca,20,Santo Domingo Nuxaá,20511,1632,1738,3370
2017,Oaxaca,20,Santo Domingo Ozolotepec,20512,422,467,889
2017,Oaxaca,20,Santo Domingo Petapa,20513,4633,4591,9224
2017,Oaxaca,20,Santo Domingo Roayaga,20514,496,543,1039
2017,Oaxaca,20,Santo Domingo Tehuantepec,20515,32512,34217,66729
2017,Oaxaca,20,Santo Domingo Teojomulco,20516,2435,2605,5040
2017,Oaxaca,20,Santo Domingo Tepuxtepec,20517,2652,2990,5642
2017,Oaxaca,20,Santo Domingo Tlatayápam,20518,67,76,143
2017,Oaxaca,20,Santo Domingo Tomaltepec,20519,1489,1535,3024
2017,Oaxaca,20,Santo Domingo Tonaltepec,20521,111,145,256
2017,Oaxaca,20,Santo Domingo Tonalá,20520,3416,3775,7191
2017,Oaxaca,20,Santo Domingo Xagacía,20522,552,635,1187
2017,Oaxaca,20,Santo Domingo Yanhuitlán,20523,754,848,1602
2017,Oaxaca,20,Santo Domingo Yodohino,20524,162,178,340
2017,Oaxaca,20,Santo Domingo Zanatepec,20525,6177,6215,12392
2017,Oaxaca,20,Santo Domingo de Morelos,20509,5353,5948,11301
2017,Oaxaca,20,Santo Tomás Jalieza,20530,1733,1909,3642
2017,Oaxaca,20,Santo Tomás Mazaltepec,20531,1252,1381,2633
2017,Oaxaca,20,Santo Tomás Ocotepec,20532,1834,2094,3928
2017,Oaxaca,20,Santo Tomás Tamazulapan,20533,1098,1168,2266
2017,Oaxaca,20,Santos Reyes Nopala,20526,8635,9133,17768
2017,Oaxaca,20,Santos Reyes Pápalo,20527,1328,1420,2748
2017,Oaxaca,20,Santos Reyes Tepejillo,20528,448,615,1063
2017,Oaxaca,20,Santos Reyes Yucuná,20529,677,690,1367
2017,Oaxaca,20,Silacayoápam,20537,3156,3613,6769
2017,Oaxaca,20,Sitio de Xitlapehua,20538,338,371,709
2017,Oaxaca,20,Soledad Etla,20539,2781,2916,5697
2017,Oaxaca,20,Tamazulápam del Espíritu Santo,20031,3454,4096,7550
2017,Oaxaca,20,Tanetze de Zaragoza,20541,818,886,1704
2017,Oaxaca,20,Taniche,20542,367,455,822
2017,Oaxaca,20,Tataltepec de Valdés,20543,2906,3030,5936
2017,Oaxaca,20,Teococuilco de Marcos Pérez,20544,485,562,1047
2017,Oaxaca,20,Teotitlán de Flores Magón,20545,4796,5279,10075
2017,Oaxaca,20,Teotitlán del Valle,20546,2868,3173,6041
2017,Oaxaca,20,Teotongo,20547,442,530,972
2017,Oaxaca,20,Tepelmeme Villa de Morelos,20548,765,916,1681
2017,Oaxaca,20,Tlacolula de Matamoros,20551,10742,12127,22869
2017,Oaxaca,20,Tlacotepec Plumas,20552,225,247,472
2017,Oaxaca,20,Tlalixtac de Cabrera,20553,5009,5536,10545
2017,Oaxaca,20,Totontepec Villa de Morelos,20554,2652,2883,5535
2017,Oaxaca,20,Trinidad Zaachila,20555,1446,1608,3054
2017,Oaxaca,20,Unión Hidalgo,20557,7573,8055,15628
2017,Oaxaca,20,Valerio Trujano,20558,665,807,1472
2017,Oaxaca,20,Villa Díaz Ordaz,20560,3113,3697,6810
2017,Oaxaca,20,Villa Hidalgo,20038,965,1068,2033
2017,Oaxaca,20,Villa Sola de Vega,20277,6274,6440,12714
2017,Oaxaca,20,Villa Talea de Castro,20280,1131,1243,2374
2017,Oaxaca,20,Villa Tejúpam de la Unión,20486,1219,1299,2518
2017,Oaxaca,20,Villa Tezoatlán de Segura y Luna,20549,5239,6192,11431
2017,Oaxaca,20,Villa de Chilapa de Díaz,20405,934,1198,2132
2017,Oaxaca,20,Villa de Etla,20338,5253,5720,10973
2017,Oaxaca,20,Villa de Tamazulápam del Progreso,20540,3691,4149,7840
2017,Oaxaca,20,Villa de Tututepec de Melchor Ocampo,20334,22883,23916,46799
2017,Oaxaca,20,Villa de Zaachila,20565,21043,23052,44095
2017,Oaxaca,20,Yaxe,20561,1379,1492,2871
2017,Oaxaca,20,Yogana,20563,587,699,1286
2017,Oaxaca,20,Yutanduchi de Guerrero,20564,571,637,1208
2017,Oaxaca,20,Zapotitlán Lagunas,20567,1528,1727,3255
2017,Oaxaca,20,Zapotitlán Palmas,20568,667,823,1490
2017,Oaxaca,20,Zimatlán de Álvarez,20570,9626,10937,20563
2017,Oaxaca,20,Ánimas Trujano,20174,1940,2143,4083
2017,Puebla,21,Acajete,21001,32283,34415,66698
2017,Puebla,21,Acateno,21002,4771,4734,9505
2017,Puebla,21,Acatlán,21003,17088,19949,37037
2017,Puebla,21,Acatzingo,21004,29381,30545,59926
2017,Puebla,21,Acteopan,21005,1451,1653,3104
2017,Puebla,21,Ahuacatlán,21006,7750,8480,16230
2017,Puebla,21,Ahuatlán,21007,1655,1779,3434
2017,Puebla,21,Ahuazotepec,21008,5740,5929,11669
2017,Puebla,21,Ahuehuetitla,21009,897,1037,1934
2017,Puebla,21,Ajalpan,21010,32922,34781,67703
2017,Puebla,21,Albino Zertuche,21011,865,1018,1883
2017,Puebla,21,Aljojuca,21012,3212,3578,6790
2017,Puebla,21,Altepexi,21013,10589,11139,21728
2017,Puebla,21,Amixtlán,21014,2467,2717,5184
2017,Puebla,21,Amozoc,21015,58257,60810,119067
2017,Puebla,21,Aquixtla,21016,4450,4465,8915
2017,Puebla,21,Atempan,21017,13749,15181,28930
2017,Puebla,21,Atexcal,21018,1893,2039,3932
2017,Puebla,21,Atlequizayan,21080,1337,1494,2831
2017,Puebla,21,Atlixco,21019,66083,74099,140182
2017,Puebla,21,Atoyatempan,21020,3491,3738,7229
2017,Puebla,21,Atzala,21021,651,716,1367
2017,Puebla,21,Atzitzihuacán,21022,5870,6785,12655
2017,Puebla,21,Atzitzintla,21023,4665,4808,9473
2017,Puebla,21,Axutla,21024,446,520,966
2017,Puebla,21,Ayotoxco de Guerrero,21025,4385,4526,8911
2017,Puebla,21,Calpan,21026,7131,7890,15021
2017,Puebla,21,Caltepec,21027,1957,2238,4195
2017,Puebla,21,Camocuautla,21028,1340,1364,2704
2017,Puebla,21,Caxhuacan,21029,1881,2033,3914
2017,Puebla,21,Cañada Morelos,21099,9712,10367,20079
2017,Puebla,21,Chalchicomula de Sesma,21045,23320,25281,48601
2017,Puebla,21,Chapulco,21046,3823,4105,7928
2017,Puebla,21,Chiautla,21047,10051,10739,20790
2017,Puebla,21,Chiautzingo,21048,9938,10943,20881
2017,Puebla,21,Chichiquila,21050,13007,13666,26673
2017,Puebla,21,Chiconcuautla,21049,8354,8671,17025
2017,Puebla,21,Chietla,21051,17334,18686,36020
2017,Puebla,21,Chigmecatitlán,21052,569,675,1244
2017,Puebla,21,Chignahuapan,21053,31448,32624,64072
2017,Puebla,21,Chignautla,21054,16890,17842,34732
2017,Puebla,21,Chila,21055,2252,2559,4811
2017,Puebla,21,Chila de la Sal,21056,707,759,1466
2017,Puebla,21,Chilchotla,21058,10329,10267,20596
2017,Puebla,21,Chinantla,21059,1126,1279,2405
2017,Puebla,21,Coatepec,21030,371,415,786
2017,Puebla,21,Coatzingo,21031,1483,1637,3120
2017,Puebla,21,Cohetzala,21032,706,702,1408
2017,Puebla,21,Cohuecan,21033,2429,2658,5087
2017,Puebla,21,Coronango,21034,20154,21021,41175
2017,Puebla,21,Coxcatlán,21035,10246,11190,21436
2017,Puebla,21,Coyomeapan,21036,7003,7600,14603
2017,Puebla,21,Coyotepec,21037,1115,1294,2409
2017,Puebla,21,Cuapiaxtla de Madero,21038,5049,5128,10177
2017,Puebla,21,Cuautempan,21039,4695,5026,9721
2017,Puebla,21,Cuautinchán,21040,5204,5282,10486
2017,Puebla,21,Cuautlancingo,21041,56713,60209,116922
2017,Puebla,21,Cuayuca de Andrade,21042,1579,1706,3285
2017,Puebla,21,Cuetzalan del Progreso,21043,24723,25765,50488
2017,Puebla,21,Cuyoaco,21044,7883,8489,16372
2017,Puebla,21,Domingo Arenas,21060,3613,4001,7614
2017,Puebla,21,Eloxochitlán,21061,6461,6711,13172
2017,Puebla,21,Epatlán,21062,2426,2569,4995
2017,Puebla,21,Esperanza,21063,7445,7971,15416
2017,Puebla,21,Francisco Z. Mena,21064,8832,8734,17566
2017,Puebla,21,General Felipe Ángeles,21065,10148,11004,21152
2017,Puebla,21,Guadalupe,21066,2859,3319,6178
2017,Puebla,21,Guadalupe Victoria,21067,8572,9051,17623
2017,Puebla,21,Hermenegildo Galeana,21068,4010,4042,8052
2017,Puebla,21,Honey,21057,3858,4245,8103
2017,Puebla,21,Huaquechula,21069,12228,13984,26212
2017,Puebla,21,Huatlatlauca,21070,3070,3689,6759
2017,Puebla,21,Huauchinango,21071,51369,56593,107962
2017,Puebla,21,Huehuetla,21072,9368,9578,18946
2017,Puebla,21,Huehuetlán el Chico,21073,4330,4599,8929
2017,Puebla,21,Huehuetlán el Grande,21150,3614,3851,7465
2017,Puebla,21,Huejotzingo,21074,36622,38504,75126
2017,Puebla,21,Hueyapan,21075,6433,6786,13219
2017,Puebla,21,Hueytamalco,21076,13665,13927,27592
2017,Puebla,21,Hueytlalpan,21077,2777,2903,5680
2017,Puebla,21,Huitzilan de Serdán,21078,7787,7613,15400
2017,Puebla,21,Huitziltepec,21079,2719,2942,5661
2017,Puebla,21,Ixcamilpa de Guerrero,21081,1793,1998,3791
2017,Puebla,21,Ixcaquixtla,21082,4337,4742,9079
2017,Puebla,21,Ixtacamaxtitlán,21083,12714,13028,25742
2017,Puebla,21,Ixtepec,21084,3585,3788,7373
2017,Puebla,21,Izúcar de Matamoros,21085,38033,42389,80422
2017,Puebla,21,Jalpan,21086,6170,6607,12777
2017,Puebla,21,Jolalpan,21087,6483,7089,13572
2017,Puebla,21,Jonotla,21088,2359,2446,4805
2017,Puebla,21,Jopala,21089,6641,6950,13591
2017,Puebla,21,Juan C. Bonilla,21090,10248,11203,21451
2017,Puebla,21,Juan Galindo,21091,5235,5956,11191
2017,Puebla,21,Juan N. Méndez,21092,2705,2780,5485
2017,Puebla,21,La Magdalena Tlatlauquitepec,21095,294,288,582
2017,Puebla,21,Lafragua,21093,4000,4098,8098
2017,Puebla,21,Libres,21094,16968,17878,34846
2017,Puebla,21,Los Reyes de Juárez,21118,13903,14454,28357
2017,Puebla,21,Mazapiltepec de Juárez,21096,1442,1475,2917
2017,Puebla,21,Mixtla,21097,1155,1288,2443
2017,Puebla,21,Molcaxac,21098,3068,3483,6551
2017,Puebla,21,Naupan,21100,4956,5407,10363
2017,Puebla,21,Nauzontla,21101,1697,1902,3599
2017,Puebla,21,Nealtican,21102,6159,6690,12849
2017,Puebla,21,Nicolás Bravo,21103,3152,3347,6499
2017,Puebla,21,Nopalucan,21104,15559,16006,31565
2017,Puebla,21,Ocotepec,21105,2391,2602,4993
2017,Puebla,21,Ocoyucan,21106,13554,15418,28972
2017,Puebla,21,Olintla,21107,5998,6271,12269
2017,Puebla,21,Oriental,21108,9052,9565,18617
2017,Puebla,21,Pahuatlán,21109,10697,11858,22555
2017,Puebla,21,Palmar de Bravo,21110,23415,24054,47469
2017,Puebla,21,Pantepec,21111,9364,9929,19293
2017,Puebla,21,Petlalcingo,21112,4673,5370,10043
2017,Puebla,21,Piaxtla,21113,2205,2383,4588
2017,Puebla,21,Puebla,21114,796600,863992,1660592
2017,Puebla,21,Quecholac,21115,25632,26682,52314
2017,Puebla,21,Quimixtlán,21116,11289,11512,22801
2017,Puebla,21,Rafael Lara Grajales,21117,7053,7613,14666
2017,Puebla,21,San Andrés Cholula,21119,70316,72211,142527
2017,Puebla,21,San Antonio Cañada,21120,2682,3011,5693
2017,Puebla,21,San Diego la Mesa Tochimiltzingo,21121,618,634,1252
2017,Puebla,21,San Felipe Teotlalcingo,21122,5149,5496,10645
2017,Puebla,21,San Felipe Tepatlán,21123,2040,2105,4145
2017,Puebla,21,San Gabriel Chilac,21124,7730,8507,16237
2017,Puebla,21,San Gregorio Atzompa,21125,4465,4764,9229
2017,Puebla,21,San Jerónimo Tecuanipan,21126,3059,3373,6432
2017,Puebla,21,San Jerónimo Xayacatlán,21127,1735,1996,3731
2017,Puebla,21,San José Chiapa,21128,4446,4554,9000
2017,Puebla,21,San José Miahuatlán,21129,6573,7215,13788
2017,Puebla,21,San Juan Atenco,21130,1637,1893,3530
2017,Puebla,21,San Juan Atzompa,21131,470,450,920
2017,Puebla,21,San Martín Texmelucan,21132,76107,81513,157620
2017,Puebla,21,San Martín Totoltepec,21133,338,365,703
2017,Puebla,21,San Matías Tlalancaleca,21134,10302,10695,20997
2017,Puebla,21,San Miguel Ixitlán,21135,253,288,541
2017,Puebla,21,San Miguel Xoxtla,21136,6271,6607,12878
2017,Puebla,21,San Nicolás Buenos Aires,21137,4984,5203,10187
2017,Puebla,21,San Nicolás de los Ranchos,21138,5846,6161,12007
2017,Puebla,21,San Pablo Anicano,21139,1768,1950,3718
2017,Puebla,21,San Pedro Cholula,21140,64928,70249,135177
2017,Puebla,21,San Pedro Yeloixtlahuaca,21141,1676,1823,3499
2017,Puebla,21,San Salvador Huixcolotla,21144,7567,7738,15305
2017,Puebla,21,San Salvador el Seco,21142,15180,15942,31122
2017,Puebla,21,San Salvador el Verde,21143,15726,16328,32054
2017,Puebla,21,San Sebastián Tlacotepec,21145,7204,7302,14506
2017,Puebla,21,Santa Catarina Tlaltempan,21146,427,422,849
2017,Puebla,21,Santa Inés Ahuatempan,21147,3129,3411,6540
2017,Puebla,21,Santa Isabel Cholula,21148,4480,4877,9357
2017,Puebla,21,Santiago Miahuatlán,21149,12534,13227,25761
2017,Puebla,21,Santo Tomás Hueyotlipan,21151,4246,4597,8843
2017,Puebla,21,Soltepec,21152,6195,6519,12714
2017,Puebla,21,Tecali de Herrera,21153,11033,11653,22686
2017,Puebla,21,Tecamachalco,21154,38488,40920,79408
2017,Puebla,21,Tecomatlán,21155,2954,3064,6018
2017,Puebla,21,Tehuacán,21156,154636,171566,326202
2017,Puebla,21,Tehuitzingo,21157,5534,6159,11693
2017,Puebla,21,Tenampulco,21158,3614,3732,7346
2017,Puebla,21,Teopantlán,21159,1770,2213,3983
2017,Puebla,21,Teotlalco,21160,1607,1687,3294
2017,Puebla,21,Tepanco de López,21161,10024,11114,21138
2017,Puebla,21,Tepango de Rodríguez,21162,2040,2260,4300
2017,Puebla,21,Tepatlaxco de Hidalgo,21163,8712,9229,17941
2017,Puebla,21,Tepeaca,21164,39767,43106,82873
2017,Puebla,21,Tepemaxalco,21165,565,606,1171
2017,Puebla,21,Tepeojuma,21166,4030,4731,8761
2017,Puebla,21,Tepetzintla,21167,5628,6042,11670
2017,Puebla,21,Tepexco,21168,3424,3654,7078
2017,Puebla,21,Tepexi de Rodríguez,21169,10952,10886,21838
2017,Puebla,21,Tepeyahualco,21170,8745,8898,17643
2017,Puebla,21,Tepeyahualco de Cuauhtémoc,21171,1749,1926,3675
2017,Puebla,21,Tetela de Ocampo,21172,13928,14951,28879
2017,Puebla,21,Teteles de Ávila Castillo,21173,2858,3347,6205
2017,Puebla,21,Teziutlán,21174,48481,53795,102276
2017,Puebla,21,Tianguismanalco,21175,6129,6675,12804
2017,Puebla,21,Tilapa,21176,4313,4647,8960
2017,Puebla,21,Tlachichuca,21179,14832,15418,30250
2017,Puebla,21,Tlacotepec de Benito Juárez,21177,25701,27965,53666
2017,Puebla,21,Tlacuilotepec,21178,8644,8903,17547
2017,Puebla,21,Tlahuapan,21180,20453,20728,41181
2017,Puebla,21,Tlaltenango,21181,3575,3641,7216
2017,Puebla,21,Tlanepantla,21182,2501,2695,5196
2017,Puebla,21,Tlaola,21183,10212,10753,20965
2017,Puebla,21,Tlapacoya,21184,3300,3449,6749
2017,Puebla,21,Tlapanalá,21185,4169,4669,8838
2017,Puebla,21,Tlatlauquitepec,21186,26598,29068,55666
2017,Puebla,21,Tlaxco,21187,2797,2829,5626
2017,Puebla,21,Tochimilco,21188,8686,9750,18436
2017,Puebla,21,Tochtepec,21189,10497,11353,21850
2017,Puebla,21,Totoltepec de Guerrero,21190,567,680,1247
2017,Puebla,21,Tulcingo,21191,4630,5304,9934
2017,Puebla,21,Tuzamapan de Galeana,21192,3220,3382,6602
2017,Puebla,21,Tzicatlacoyan,21193,3548,3634,7182
2017,Puebla,21,Venustiano Carranza,21194,14605,15749,30354
2017,Puebla,21,Vicente Guerrero,21195,12160,13177,25337
2017,Puebla,21,Xayacatlán de Bravo,21196,743,892,1635
2017,Puebla,21,Xicotepec,21197,40514,43385,83899
2017,Puebla,21,Xicotlán,21198,603,665,1268
2017,Puebla,21,Xiutetelco,21199,20032,21385,41417
2017,Puebla,21,Xochiapulco,21200,1763,1920,3683
2017,Puebla,21,Xochiltepec,21201,1557,1866,3423
2017,Puebla,21,Xochitlán Todos Santos,21203,3117,3473,6590
2017,Puebla,21,Xochitlán de Vicente Suárez,21202,6400,6768,13168
2017,Puebla,21,Yaonáhuac,21204,3964,4296,8260
2017,Puebla,21,Yehualtepec,21205,12460,13177,25637
2017,Puebla,21,Zacapala,21206,2142,2415,4557
2017,Puebla,21,Zacapoaxtla,21207,27512,30034,57546
2017,Puebla,21,Zacatlán,21208,40477,44493,84970
2017,Puebla,21,Zapotitlán,21209,4023,4788,8811
2017,Puebla,21,Zapotitlán de Méndez,21210,2886,2941,5827
2017,Puebla,21,Zaragoza,21211,7824,9050,16874
2017,Puebla,21,Zautla,21212,9435,10586,20021
2017,Puebla,21,Zihuateutla,21213,6724,7078,13802
2017,Puebla,21,Zinacatepec,21214,8338,9184,17522
2017,Puebla,21,Zongozotla,21215,2526,2589,5115
2017,Puebla,21,Zoquiapan,21216,1223,1382,2605
2017,Puebla,21,Zoquitlán,21217,9576,10137,19713
2017,Querétaro,22,Amealco de Bonfil,22001,32222,34038,66260
2017,Querétaro,22,Arroyo Seco,22003,6833,7414,14247
2017,Querétaro,22,Cadereyta de Montes,22004,35059,38149,73208
2017,Querétaro,22,Colón,22005,33353,32723,66076
2017,Querétaro,22,Corregidora,22006,92017,97684,189701
2017,Querétaro,22,El Marqués,22011,82008,81079,163087
2017,Querétaro,22,Ezequiel Montes,22007,21085,22530,43615
2017,Querétaro,22,Huimilpan,22008,19519,20949,40468
2017,Querétaro,22,Jalpan de Serra,22009,13574,14794,28368
2017,Querétaro,22,Landa de Matamoros,22010,9593,10406,19999
2017,Querétaro,22,Pedro Escobedo,22012,36160,36623,72783
2017,Querétaro,22,Peñamiller,22013,10368,10671,21039
2017,Querétaro,22,Pinal de Amoles,22002,13409,14277,27686
2017,Querétaro,22,Querétaro,22014,461683,468728,930411
2017,Querétaro,22,San Joaquín,22015,4625,5270,9895
2017,Querétaro,22,San Juan del Río,22016,139960,144833,284793
2017,Querétaro,22,Tequisquiapan,22017,36595,37907,74502
2017,Querétaro,22,Tolimán,22018,14722,15307,30029
2017,Quintana Roo,23,Bacalar,23010,20757,20814,41571
2017,Quintana Roo,23,Benito Juárez,23005,394986,390778,785764
2017,Quintana Roo,23,Cozumel,23001,47098,46889,93987
2017,Quintana Roo,23,Felipe Carrillo Puerto,23002,43696,43272,86968
2017,Quintana Roo,23,Isla Mujeres,23003,10754,10003,20757
2017,Quintana Roo,23,José María Morelos,23006,20690,19740,40430
2017,Quintana Roo,23,Lázaro Cárdenas,23007,14964,14353,29317
2017,Quintana Roo,23,Othón P. Blanco,23004,124480,129033,253513
2017,Quintana Roo,23,Solidaridad,23008,114069,104787,218856
2017,Quintana Roo,23,Tulum,23009,17884,16315,34199
2017,San Luis Potosí,24,Ahualulco,24001,8928,10019,18947
2017,San Luis Potosí,24,Alaquines,24002,4222,4347,8569
2017,San Luis Potosí,24,Aquismón,24003,25379,24773,50152
2017,San Luis Potosí,24,Armadillo de los Infante,24004,2131,2207,4338
2017,San Luis Potosí,24,Axtla de Terrazas,24053,18803,19109,37912
2017,San Luis Potosí,24,Catorce,24006,5109,4933,10042
2017,San Luis Potosí,24,Cedral,24007,9646,10033,19679
2017,San Luis Potosí,24,Cerritos,24008,10817,11520,22337
2017,San Luis Potosí,24,Cerro de San Pedro,24009,2318,2285,4603
2017,San Luis Potosí,24,Charcas,24015,10688,11074,21762
2017,San Luis Potosí,24,Ciudad Fernández,24011,22745,23988,46733
2017,San Luis Potosí,24,Ciudad Valles,24013,88789,94601,183390
2017,San Luis Potosí,24,Ciudad del Maíz,24010,16978,17178,34156
2017,San Luis Potosí,24,Coxcatlán,24014,8279,8157,16436
2017,San Luis Potosí,24,Cárdenas,24005,9330,10154,19484
2017,San Luis Potosí,24,Ebano,24016,21967,22801,44768
2017,San Luis Potosí,24,El Naranjo,24058,11302,11163,22465
2017,San Luis Potosí,24,Guadalcázar,24017,13771,13511,27282
2017,San Luis Potosí,24,Huehuetlán,24018,8117,8324,16441
2017,San Luis Potosí,24,Lagunillas,24019,2813,2942,5755
2017,San Luis Potosí,24,Matehuala,24020,49160,52019,101179
2017,San Luis Potosí,24,Matlapa,24057,15969,15959,31928
2017,San Luis Potosí,24,Mexquitic de Carmona,24021,27735,30282,58017
2017,San Luis Potosí,24,Moctezuma,24022,9660,10481,20141
2017,San Luis Potosí,24,Rayón,24023,7793,8233,16026
2017,San Luis Potosí,24,Rioverde,24024,47143,50235,97378
2017,San Luis Potosí,24,Salinas,24025,15601,16849,32450
2017,San Luis Potosí,24,San Antonio,24026,4982,4760,9742
2017,San Luis Potosí,24,San Ciro de Acosta,24027,5131,5529,10660
2017,San Luis Potosí,24,San Luis Potosí,24028,412240,440371,852611
2017,San Luis Potosí,24,San Martín Chalchicuautla,24029,11013,11072,22085
2017,San Luis Potosí,24,San Nicolás Tolentino,24030,2569,2865,5434
2017,San Luis Potosí,24,San Vicente Tancuayalab,24034,7672,7665,15337
2017,San Luis Potosí,24,Santa Catarina,24031,5917,6221,12138
2017,San Luis Potosí,24,Santa María del Río,24032,19738,21652,41390
2017,San Luis Potosí,24,Santo Domingo,24033,6224,6302,12526
2017,San Luis Potosí,24,Soledad de Graciano Sánchez,24035,152566,160444,313010
2017,San Luis Potosí,24,Tamasopo,24036,15623,15360,30983
2017,San Luis Potosí,24,Tamazunchale,24037,48903,49588,98491
2017,San Luis Potosí,24,Tampacán,24038,8168,7998,16166
2017,San Luis Potosí,24,Tampamolón Corona,24039,7845,7941,15786
2017,San Luis Potosí,24,Tamuín,24040,19797,20268,40065
2017,San Luis Potosí,24,Tancanhuitz,24012,10662,10891,21553
2017,San Luis Potosí,24,Tanlajás,24041,10346,10075,20421
2017,San Luis Potosí,24,Tanquián de Escobedo,24042,7630,7924,15554
2017,San Luis Potosí,24,Tierra Nueva,24043,4475,5086,9561
2017,San Luis Potosí,24,Vanegas,24044,4005,3931,7936
2017,San Luis Potosí,24,Venado,24045,7417,7664,15081
2017,San Luis Potosí,24,Villa Hidalgo,24051,7633,7767,15400
2017,San Luis Potosí,24,Villa Juárez,24052,5156,5334,10490
2017,San Luis Potosí,24,Villa de Arista,24056,7901,7962,15863
2017,San Luis Potosí,24,Villa de Arriaga,24046,8975,9103,18078
2017,San Luis Potosí,24,Villa de Guadalupe,24047,5045,5016,10061
2017,San Luis Potosí,24,Villa de Ramos,24049,18803,19867,38670
2017,San Luis Potosí,24,Villa de Reyes,24050,25027,25338,50365
2017,San Luis Potosí,24,Villa de la Paz,24048,2766,2740,5506
2017,San Luis Potosí,24,Xilitla,24054,26564,27215,53779
2017,San Luis Potosí,24,Zaragoza,24055,13098,13482,26580
2017,Sinaloa,25,Ahome,25001,229818,236917,466735
2017,Sinaloa,25,Angostura,25002,24694,24539,49233
2017,Sinaloa,25,Badiraguato,25003,16734,15535,32269
2017,Sinaloa,25,Choix,25007,17662,16704,34366
2017,Sinaloa,25,Concordia,25004,14805,14310,29115
2017,Sinaloa,25,Cosalá,25005,8846,8421,17267
2017,Sinaloa,25,Culiacán,25006,461713,477193,938906
2017,Sinaloa,25,El Fuerte,25010,53522,52199,105721
2017,Sinaloa,25,Elota,25008,30119,28008,58127
2017,Sinaloa,25,Escuinapa,25009,30852,30022,60874
2017,Sinaloa,25,Guasave,25011,153797,155847,309644
2017,Sinaloa,25,Mazatlán,25012,253926,259995,513921
2017,Sinaloa,25,Mocorito,25013,24642,23204,47846
2017,Sinaloa,25,Navolato,25018,79758,76832,156590
2017,Sinaloa,25,Rosario,25014,28244,27224,55468
2017,Sinaloa,25,Salvador Alvarado,25015,41722,43641,85363
2017,Sinaloa,25,San Ignacio,25016,11778,10911,22689
2017,Sinaloa,25,Sinaloa,25017,47301,45995,93296
2017,Sonora,26,Aconchi,26001,1529,1384,2913
2017,Sonora,26,Agua Prieta,26002,43347,42710,86057
2017,Sonora,26,Alamos,26003,14103,13153,27256
2017,Sonora,26,Altar,26004,4983,4973,9956
2017,Sonora,26,Arivechi,26005,649,622,1271
2017,Sonora,26,Arizpe,26006,1509,1440,2949
2017,Sonora,26,Atil,26007,330,312,642
2017,Sonora,26,Bacadéhuachi,26008,641,576,1217
2017,Sonora,26,Bacanora,26009,432,399,831
2017,Sonora,26,Bacerac,26010,767,721,1488
2017,Sonora,26,Bacoachi,26011,844,840,1684
2017,Sonora,26,Banámichi,26013,871,855,1726
2017,Sonora,26,Bavispe,26015,816,735,1551
2017,Sonora,26,Baviácora,26014,1856,1755,3611
2017,Sonora,26,Benito Juárez,26071,11629,11623,23252
2017,Sonora,26,Benjamín Hill,26016,2718,2804,5522
2017,Sonora,26,Bácum,26012,12204,12062,24266
2017,Sonora,26,Caborca,26017,44716,44126,88842
2017,Sonora,26,Cajeme,26018,221555,231421,452976
2017,Sonora,26,Cananea,26019,18367,18751,37118
2017,Sonora,26,Carbó,26020,2726,2508,5234
2017,Sonora,26,Cucurpe,26022,564,457,1021
2017,Sonora,26,Cumpas,26023,3309,3255,6564
2017,Sonora,26,Divisaderos,26024,403,392,795
2017,Sonora,26,Empalme,26025,29242,29650,58892
2017,Sonora,26,Etchojoa,26026,32814,31790,64604
2017,Sonora,26,Fronteras,26027,4646,4464,9110
2017,Sonora,26,General Plutarco Elías Calles,26070,8882,8651,17533
2017,Sonora,26,Granados,26028,580,561,1141
2017,Sonora,26,Guaymas,26029,81587,82921,164508
2017,Sonora,26,Hermosillo,26030,447161,457835,904996
2017,Sonora,26,Huachinera,26031,696,662,1358
2017,Sonora,26,Huatabampo,26033,42549,42336,84885
2017,Sonora,26,Huásabas,26032,511,457,968
2017,Sonora,26,Huépac,26034,551,522,1073
2017,Sonora,26,Imuris,26035,6708,6657,13365
2017,Sonora,26,La Colorada,26021,1137,921,2058
2017,Sonora,26,Magdalena,26036,16146,16419,32565
2017,Sonora,26,Mazatán,26037,708,625,1333
2017,Sonora,26,Moctezuma,26038,2578,2626,5204
2017,Sonora,26,Naco,26039,3331,3287,6618
2017,Sonora,26,Nacozari de García,26041,7030,6976,14006
2017,Sonora,26,Navojoa,26042,84133,87553,171686
2017,Sonora,26,Nogales,26043,121758,121960,243718
2017,Sonora,26,Nácori Chico,26040,1103,1009,2112
2017,Sonora,26,Onavas,26044,260,217,477
2017,Sonora,26,Opodepe,26045,1524,1355,2879
2017,Sonora,26,Oquitoa,26046,200,223,423
2017,Sonora,26,Pitiquito,26047,5172,4844,10016
2017,Sonora,26,Puerto Peñasco,26048,34461,33291,67752
2017,Sonora,26,Quiriego,26049,1673,1458,3131
2017,Sonora,26,Rayón,26050,849,764,1613
2017,Sonora,26,Rosario,26051,2814,2580,5394
2017,Sonora,26,Sahuaripa,26052,3107,2947,6054
2017,Sonora,26,San Felipe de Jesús,26053,215,211,426
2017,Sonora,26,San Ignacio Río Muerto,26072,7828,7427,15255
2017,Sonora,26,San Javier,26054,349,270,619
2017,Sonora,26,San Luis Río Colorado,26055,100073,99150,199223
2017,Sonora,26,San Miguel de Horcasitas,26056,5164,4457,9621
2017,Sonora,26,San Pedro de la Cueva,26057,858,752,1610
2017,Sonora,26,Santa Ana,26058,8494,8723,17217
2017,Sonora,26,Santa Cruz,26059,983,1003,1986
2017,Sonora,26,Soyopa,26061,783,647,1430
2017,Sonora,26,Suaqui Grande,26062,645,552,1197
2017,Sonora,26,Sáric,26060,940,884,1824
2017,Sonora,26,Tepache,26063,729,675,1404
2017,Sonora,26,Trincheras,26064,937,787,1724
2017,Sonora,26,Tubutama,26065,709,675,1384
2017,Sonora,26,Ures,26066,4793,4588,9381
2017,Sonora,26,Villa Hidalgo,26067,865,806,1671
2017,Sonora,26,Villa Pesqueira,26068,693,581,1274
2017,Sonora,26,Yécora,26069,3207,3143,6350
2017,Tabasco,27,Balancán,27001,31270,31359,62629
2017,Tabasco,27,Centla,27003,57092,56974,114066
2017,Tabasco,27,Centro,27004,349055,364077,713132
2017,Tabasco,27,Comalcalco,27005,104022,106731,210753
2017,Tabasco,27,Cunduacán,27006,70312,72308,142620
2017,Tabasco,27,Cárdenas,27002,132037,136569,268606
2017,Tabasco,27,Emiliano Zapata,27007,15437,16683,32120
2017,Tabasco,27,Huimanguillo,27008,96508,98735,195243
2017,Tabasco,27,Jalapa,27009,20101,19974,40075
2017,Tabasco,27,Jalpa de Méndez,27010,45424,45635,91059
2017,Tabasco,27,Jonuta,27011,16199,15956,32155
2017,Tabasco,27,Macuspana,27012,84516,87299,171815
2017,Tabasco,27,Nacajuca,27013,69021,71578,140599
2017,Tabasco,27,Paraíso,27014,48862,49234,98096
2017,Tabasco,27,Tacotalpa,27015,25424,25300,50724
2017,Tabasco,27,Teapa,27016,29754,30710,60464
2017,Tabasco,27,Tenosique,27017,30634,32142,62776
2017,Tamaulipas,28,Abasolo,28001,6308,6300,12608
2017,Tamaulipas,28,Aldama,28002,15405,15136,30541
2017,Tamaulipas,28,Altamira,28003,120812,121990,242802
2017,Tamaulipas,28,Antiguo Morelos,28004,5022,5053,10075
2017,Tamaulipas,28,Burgos,28005,2442,2270,4712
2017,Tamaulipas,28,Bustamante,28006,4304,3958,8262
2017,Tamaulipas,28,Camargo,28007,8349,8098,16447
2017,Tamaulipas,28,Casas,28008,2316,2076,4392
2017,Tamaulipas,28,Ciudad Madero,28009,104426,113900,218326
2017,Tamaulipas,28,Cruillas,28010,1046,1011,2057
2017,Tamaulipas,28,El Mante,28021,60035,63316,123351
2017,Tamaulipas,28,González,28012,22650,22909,45559
2017,Tamaulipas,28,Guerrero,28014,2413,2241,4654
2017,Tamaulipas,28,Gustavo Díaz Ordaz,28015,8280,8068,16348
2017,Tamaulipas,28,Gómez Farías,28011,4873,4625,9498
2017,Tamaulipas,28,Güémez,28013,8430,7800,16230
2017,Tamaulipas,28,Hidalgo,28016,12461,11819,24280
2017,Tamaulipas,28,Jaumave,28017,8128,7860,15988
2017,Tamaulipas,28,Jiménez,28018,4299,4259,8558
2017,Tamaulipas,28,Llera,28019,9021,8725,17746
2017,Tamaulipas,28,Mainero,28020,1344,1303,2647
2017,Tamaulipas,28,Matamoros,28022,264245,270895,535140
2017,Tamaulipas,28,Mier,28024,2338,2404,4742
2017,Tamaulipas,28,Miguel Alemán,28025,14228,14266,28494
2017,Tamaulipas,28,Miquihuana,28026,1955,1775,3730
2017,Tamaulipas,28,Méndez,28023,2270,2084,4354
2017,Tamaulipas,28,Nuevo Laredo,28027,206819,206201,413020
2017,Tamaulipas,28,Nuevo Morelos,28028,1904,1740,3644
2017,Tamaulipas,28,Ocampo,28029,7234,6968,14202
2017,Tamaulipas,28,Padilla,28030,7335,7192,14527
2017,Tamaulipas,28,Palmillas,28031,917,892,1809
2017,Tamaulipas,28,Reynosa,28032,331221,330748,661969
2017,Tamaulipas,28,Río Bravo,28033,65004,64528,129532
2017,Tamaulipas,28,San Carlos,28034,4929,4464,9393
2017,Tamaulipas,28,San Fernando,28035,29728,29325,59053
2017,Tamaulipas,28,San Nicolás,28036,571,515,1086
2017,Tamaulipas,28,Soto la Marina,28037,13416,12717,26133
2017,Tamaulipas,28,Tampico,28038,157845,170850,328695
2017,Tamaulipas,28,Tula,28039,15035,15084,30119
2017,Tamaulipas,28,Valle Hermoso,28040,33096,34036,67132
2017,Tamaulipas,28,Victoria,28041,174426,181784,356210
2017,Tamaulipas,28,Villagrán,28042,3385,3149,6534
2017,Tamaulipas,28,Xicoténcatl,28043,12354,12315,24669
2017,Tlaxcala,29,Acuamanala de Miguel Hidalgo,29022,3256,3249,6505
2017,Tlaxcala,29,Altzayanca,29004,8975,8944,17919
2017,Tlaxcala,29,Amaxac de Guerrero,29001,5644,5808,11452
2017,Tlaxcala,29,Apetatitlán de Antonio Carvajal,29002,7625,8101,15726
2017,Tlaxcala,29,Apizaco,29005,40007,43734,83741
2017,Tlaxcala,29,Atlangatepec,29003,3344,3480,6824
2017,Tlaxcala,29,Benito Juárez,29045,3100,3188,6288
2017,Tlaxcala,29,Calpulalpan,29006,24593,25854,50447
2017,Tlaxcala,29,Chiautempan,29010,36048,38536,74584
2017,Tlaxcala,29,Contla de Juan Cuamatzi,29018,19740,20248,39988
2017,Tlaxcala,29,Cuapiaxtla,29008,7917,7885,15802
2017,Tlaxcala,29,Cuaxomulco,29009,2763,2781,5544
2017,Tlaxcala,29,El Carmen Tequexquitla,29007,8727,8946,17673
2017,Tlaxcala,29,Emiliano Zapata,29046,2296,2403,4699
2017,Tlaxcala,29,Españita,29012,4564,4625,9189
2017,Tlaxcala,29,Huamantla,29013,47472,49266,96738
2017,Tlaxcala,29,Hueyotlipan,29014,7538,7681,15219
2017,Tlaxcala,29,Ixtacuixtla de Mariano Matamoros,29015,19525,20659,40184
2017,Tlaxcala,29,Ixtenco,29016,3623,3901,7524
2017,Tlaxcala,29,La Magdalena Tlaltelulco,29048,9331,9992,19323
2017,Tlaxcala,29,Lázaro Cárdenas,29047,1578,1606,3184
2017,Tlaxcala,29,Mazatecochco de José María Morelos,29017,5558,5655,11213
2017,Tlaxcala,29,Muñoz de Domingo Arenas,29011,2429,2390,4819
2017,Tlaxcala,29,Nanacamilpa de Mariano Arista,29021,9218,9635,18853
2017,Tlaxcala,29,Natívitas,29023,12732,13637,26369
2017,Tlaxcala,29,Panotla,29024,13690,14552,28242
2017,Tlaxcala,29,Papalotla de Xicohténcatl,29041,15198,16231,31429
2017,Tlaxcala,29,San Damián Texóloc,29049,2889,2913,5802
2017,Tlaxcala,29,San Francisco Tetlanohcan,29050,5523,5782,11305
2017,Tlaxcala,29,San Jerónimo Zacualpan,29051,1877,2086,3963
2017,Tlaxcala,29,San José Teacalco,29052,3040,3191,6231
2017,Tlaxcala,29,San Juan Huactzinco,29053,3735,4083,7818
2017,Tlaxcala,29,San Lorenzo Axocomanitla,29054,2814,3030,5844
2017,Tlaxcala,29,San Lucas Tecopilco,29055,1563,1668,3231
2017,Tlaxcala,29,San Pablo del Monte,29025,39803,40050,79853
2017,Tlaxcala,29,Sanctórum de Lázaro Cárdenas,29020,4925,5011,9936
2017,Tlaxcala,29,Santa Ana Nopalucan,29056,3947,4072,8019
2017,Tlaxcala,29,Santa Apolonia Teacalco,29057,2263,2524,4787
2017,Tlaxcala,29,Santa Catarina Ayometla,29058,4402,4755,9157
2017,Tlaxcala,29,Santa Cruz Quilehtla,29059,3654,3677,7331
2017,Tlaxcala,29,Santa Cruz Tlaxcala,29026,10323,10657,20980
2017,Tlaxcala,29,Santa Isabel Xiloxoxtla,29060,2518,2646,5164
2017,Tlaxcala,29,Tenancingo,29027,6577,6832,13409
2017,Tlaxcala,29,Teolocholco,29028,12178,12911,25089
2017,Tlaxcala,29,Tepetitla de Lardizábal,29019,10500,11272,21772
2017,Tlaxcala,29,Tepeyanco,29029,6314,6896,13210
2017,Tlaxcala,29,Terrenate,29030,7811,7739,15550
2017,Tlaxcala,29,Tetla de la Solidaridad,29031,16509,16960,33469
2017,Tlaxcala,29,Tetlatlahuca,29032,6962,7359,14321
2017,Tlaxcala,29,Tlaxcala,29033,48042,52547,100589
2017,Tlaxcala,29,Tlaxco,29034,21853,22606,44459
2017,Tlaxcala,29,Tocatlán,29035,3036,3104,6140
2017,Tlaxcala,29,Totolac,29036,11193,12118,23311
2017,Tlaxcala,29,Tzompantepec,29038,8415,8972,17387
2017,Tlaxcala,29,Xaloztoc,29039,12464,12384,24848
2017,Tlaxcala,29,Xaltocan,29040,5322,5678,11000
2017,Tlaxcala,29,Xicohtzinco,29042,6760,7417,14177
2017,Tlaxcala,29,Yauhquemehcan,29043,19215,20424,39639
2017,Tlaxcala,29,Zacatelco,29044,21506,23323,44829
2017,Tlaxcala,29,Ziltlaltépec de Trinidad Sánchez Santos,29037,4448,4826,9274
2017,Veracruz,30,Acajete,30001,4620,4367,8987
2017,Veracruz,30,Acatlán,30002,1613,1669,3282
2017,Veracruz,30,Acayucan,30003,43481,46698,90179
2017,Veracruz,30,Actopan,30004,22061,22813,44874
2017,Veracruz,30,Acula,30005,2795,2783,5578
2017,Veracruz,30,Acultzingo,30006,11471,11859,23330
2017,Veracruz,30,Agua Dulce,30204,24227,25612,49839
2017,Veracruz,30,Alpatláhuac,30008,5176,5204,10380
2017,Veracruz,30,Alto Lucero de Gutiérrez Barrios,30009,15125,15058,30183
2017,Veracruz,30,Altotonga,30010,32360,34515,66875
2017,Veracruz,30,Alvarado,30011,27649,28011,55660
2017,Veracruz,30,Amatitlán,30012,4068,4232,8300
2017,Veracruz,30,Amatlán de los Reyes,30014,22634,24177,46811
2017,Veracruz,30,Angel R. Cabada,30015,17302,18233,35535
2017,Veracruz,30,Apazapan,30017,2095,2115,4210
2017,Veracruz,30,Aquila,30018,935,1006,1941
2017,Veracruz,30,Astacinga,30019,3063,3476,6539
2017,Veracruz,30,Atlahuilco,30020,5395,5660,11055
2017,Veracruz,30,Atoyac,30021,11990,12723,24713
2017,Veracruz,30,Atzacan,30022,10826,11090,21916
2017,Veracruz,30,Atzalan,30023,25927,25992,51919
2017,Veracruz,30,Ayahualulco,30025,13667,13729,27396
2017,Veracruz,30,Banderilla,30026,11475,12707,24182
2017,Veracruz,30,Benito Juárez,30027,8898,9285,18183
2017,Veracruz,30,Boca del Río,30028,71095,79761,150856
2017,Veracruz,30,Calcahualco,30029,6759,6662,13421
2017,Veracruz,30,Camarón de Tejeda,30007,3354,3341,6695
2017,Veracruz,30,Camerino Z. Mendoza,30030,20970,23398,44368
2017,Veracruz,30,Carlos A. Carrillo,30208,12239,13250,25489
2017,Veracruz,30,Carrillo Puerto,30031,8572,8922,17494
2017,Veracruz,30,Castillo de Teayo,30157,10352,10170,20522
2017,Veracruz,30,Catemaco,30032,25040,26613,51653
2017,Veracruz,30,Cazones de Herrera,30033,12043,12704,24747
2017,Veracruz,30,Cerro Azul,30034,13289,14695,27984
2017,Veracruz,30,Chacaltianguis,30054,6276,6627,12903
2017,Veracruz,30,Chalma,30055,6881,7070,13951
2017,Veracruz,30,Chiconamel,30056,3423,3600,7023
2017,Veracruz,30,Chiconquiaco,30057,7253,7300,14553
2017,Veracruz,30,Chicontepec,30058,28511,29827,58338
2017,Veracruz,30,Chinameca,30059,8168,8557,16725
2017,Veracruz,30,Chinampa de Gorostiza,30060,8409,8637,17046
2017,Veracruz,30,Chocamán,30062,10624,10712,21336
2017,Veracruz,30,Chontla,30063,7599,7626,15225
2017,Veracruz,30,Chumatlán,30064,1966,2066,4032
2017,Veracruz,30,Citlaltépetl,30035,6029,6274,12303
2017,Veracruz,30,Coacoatzintla,30036,5198,5436,10634
2017,Veracruz,30,Coahuitlán,30037,4281,4390,8671
2017,Veracruz,30,Coatepec,30038,46322,49465,95787
2017,Veracruz,30,Coatzacoalcos,30039,161493,171162,332655
2017,Veracruz,30,Coatzintla,30040,28027,29448,57475
2017,Veracruz,30,Coetzala,30041,1145,1177,2322
2017,Veracruz,30,Colipa,30042,2921,3026,5947
2017,Veracruz,30,Comapa,30043,10538,10113,20651
2017,Veracruz,30,Cosamaloapan de Carpio,30045,28364,30746,59110
2017,Veracruz,30,Cosautlán de Carvajal,30046,8402,8490,16892
2017,Veracruz,30,Coscomatepec,30047,29115,29979,59094
2017,Veracruz,30,Cosoleacaque,30048,68863,73668,142531
2017,Veracruz,30,Cotaxtla,30049,10804,10858,21662
2017,Veracruz,30,Coxquihui,30050,8421,8740,17161
2017,Veracruz,30,Coyutla,30051,11252,12032,23284
2017,Veracruz,30,Cuichapa,30052,6003,6619,12622
2017,Veracruz,30,Cuitláhuac,30053,13744,15044,28788
2017,Veracruz,30,Córdoba,30044,105284,118344,223628
2017,Veracruz,30,El Higo,30205,10130,10169,20299
2017,Veracruz,30,Emiliano Zapata,30065,38442,41079,79521
2017,Veracruz,30,Espinal,30066,13727,14309,28036
2017,Veracruz,30,Filomeno Mata,30067,9382,9316,18698
2017,Veracruz,30,Fortín,30068,32335,35768,68103
2017,Veracruz,30,Gutiérrez Zamora,30069,12157,13649,25806
2017,Veracruz,30,Hidalgotitlán,30070,9868,9598,19466
2017,Veracruz,30,Huatusco,30071,29914,31887,61801
2017,Veracruz,30,Huayacocotla,30072,10752,11403,22155
2017,Veracruz,30,Hueyapan de Ocampo,30073,21743,22858,44601
2017,Veracruz,30,Huiloapan de Cuauhtémoc,30074,3618,3853,7471
2017,Veracruz,30,Ignacio de la Llave,30075,8719,9392,18111
2017,Veracruz,30,Ilamatlán,30076,6769,7363,14132
2017,Veracruz,30,Isla,30077,21993,22933,44926
2017,Veracruz,30,Ixcatepec,30078,6995,6972,13967
2017,Veracruz,30,Ixhuacán de los Reyes,30079,5942,5809,11751
2017,Veracruz,30,Ixhuatlancillo,30081,12404,13422,25826
2017,Veracruz,30,Ixhuatlán de Madero,30083,27172,28278,55450
2017,Veracruz,30,Ixhuatlán del Café,30080,11720,11766,23486
2017,Veracruz,30,Ixhuatlán del Sureste,30082,8148,8110,16258
2017,Veracruz,30,Ixmatlahuacan,30084,3004,3046,6050
2017,Veracruz,30,Ixtaczoquitlán,30085,34700,36694,71394
2017,Veracruz,30,Jalacingo,30086,22293,23087,45380
2017,Veracruz,30,Jalcomulco,30088,2682,2617,5299
2017,Veracruz,30,Jamapa,30090,5750,5946,11696
2017,Veracruz,30,Jesús Carranza,30091,14753,14861,29614
2017,Veracruz,30,Jilotepec,30093,8328,8759,17087
2017,Veracruz,30,José Azueta,30169,11872,12310,24182
2017,Veracruz,30,Juan Rodríguez Clara,30094,19894,20360,40254
2017,Veracruz,30,Juchique de Ferrer,30095,8302,8453,16755
2017,Veracruz,30,Jáltipan,30089,20614,22434,43048
2017,Veracruz,30,La Antigua,30016,13588,14503,28091
2017,Veracruz,30,La Perla,30127,13711,14148,27859
2017,Veracruz,30,Landero y Coss,30096,795,847,1642
2017,Veracruz,30,Las Choapas,30061,40926,42420,83346
2017,Veracruz,30,Las Minas,30107,1571,1498,3069
2017,Veracruz,30,Las Vigas de Ramírez,30132,9979,10024,20003
2017,Veracruz,30,Lerdo de Tejada,30097,9748,11063,20811
2017,Veracruz,30,Los Reyes,30137,2998,3030,6028
2017,Veracruz,30,Magdalena,30098,1580,1582,3162
2017,Veracruz,30,Maltrata,30099,8898,9519,18417
2017,Veracruz,30,Manlio Fabio Altamirano,30100,12027,12333,24360
2017,Veracruz,30,Mariano Escobedo,30101,18226,19550,37776
2017,Veracruz,30,Martínez de la Torre,30102,53472,57713,111185
2017,Veracruz,30,Mecatlán,30103,6302,6447,12749
2017,Veracruz,30,Mecayapan,30104,8453,8813,17266
2017,Veracruz,30,Medellín,30105,37276,40269,77545
2017,Veracruz,30,Miahuatlán,30106,2376,2451,4827
2017,Veracruz,30,Minatitlán,30108,78987,84022,163009
2017,Veracruz,30,Misantla,30109,32749,34228,66977
2017,Veracruz,30,Mixtla de Altamirano,30110,5975,5846,11821
2017,Veracruz,30,Moloacán,30111,8691,9142,17833
2017,Veracruz,30,Nanchital de Lázaro Cárdenas del Rio,30206,14926,15764,30690
2017,Veracruz,30,Naolinco,30112,11012,11467,22479
2017,Veracruz,30,Naranjal,30113,2326,2452,4778
2017,Veracruz,30,Naranjos Amatlán,30013,14078,15544,29622
2017,Veracruz,30,Nautla,30114,5532,5731,11263
2017,Veracruz,30,Nogales,30115,18600,20239,38839
2017,Veracruz,30,Oluta,30116,8128,8740,16868
2017,Veracruz,30,Omealca,30117,11950,12778,24728
2017,Veracruz,30,Orizaba,30118,61217,71159,132376
2017,Veracruz,30,Otatitlán,30119,2825,3072,5897
2017,Veracruz,30,Oteapan,30120,8135,8429,16564
2017,Veracruz,30,Ozuluama de Mascareñas,30121,12505,11889,24394
2017,Veracruz,30,Pajapan,30122,8924,8839,17763
2017,Veracruz,30,Papantla,30124,82305,84292,166597
2017,Veracruz,30,Paso de Ovejas,30126,17412,17485,34897
2017,Veracruz,30,Paso del Macho,30125,16160,16483,32643
2017,Veracruz,30,Perote,30128,37451,37652,75103
2017,Veracruz,30,Platón Sánchez,30129,9322,9631,18953
2017,Veracruz,30,Playa Vicente,30130,19346,20985,40331
2017,Veracruz,30,Poza Rica de Hidalgo,30131,100595,111330,211925
2017,Veracruz,30,Pueblo Viejo,30133,30142,29907,60049
2017,Veracruz,30,Puente Nacional,30134,11554,11881,23435
2017,Veracruz,30,Pánuco,30123,52072,52308,104380
2017,Veracruz,30,Rafael Delgado,30135,11583,11905,23488
2017,Veracruz,30,Rafael Lucio,30136,3980,4190,8170
2017,Veracruz,30,Río Blanco,30138,20767,23291,44058
2017,Veracruz,30,Saltabarranca,30139,3113,3308,6421
2017,Veracruz,30,San Andrés Tenejapan,30140,1478,1533,3011
2017,Veracruz,30,San Andrés Tuxtla,30141,82212,88306,170518
2017,Veracruz,30,San Juan Evangelista,30142,17292,17849,35141
2017,Veracruz,30,San Rafael,30211,15309,15860,31169
2017,Veracruz,30,Santiago Sochiapan,30212,7056,7508,14564
2017,Veracruz,30,Santiago Tuxtla,30143,28984,31034,60018
2017,Veracruz,30,Sayula de Alemán,30144,16634,17169,33803
2017,Veracruz,30,Sochiapa,30146,1894,1874,3768
2017,Veracruz,30,Soconusco,30145,8049,8449,16498
2017,Veracruz,30,Soledad Atzompa,30147,11780,11850,23630
2017,Veracruz,30,Soledad de Doblado,30148,14357,14594,28951
2017,Veracruz,30,Soteapan,30149,17376,17896,35272
2017,Veracruz,30,Tamalín,30150,6097,6042,12139
2017,Veracruz,30,Tamiahua,30151,12295,12140,24435
2017,Veracruz,30,Tampico Alto,30152,6710,6243,12953
2017,Veracruz,30,Tancoco,30153,2962,3108,6070
2017,Veracruz,30,Tantima,30154,6927,6685,13612
2017,Veracruz,30,Tantoyuca,30155,53601,54309,107910
2017,Veracruz,30,Tatahuicapan de Juárez,30209,7756,8099,15855
2017,Veracruz,30,Tatatila,30156,3154,2876,6030
2017,Veracruz,30,Tecolutla,30158,12535,12860,25395
2017,Veracruz,30,Tehuipango,30159,12854,13577,26431
2017,Veracruz,30,Tempoal,30161,18327,18748,37075
2017,Veracruz,30,Tenampa,30162,3388,3539,6927
2017,Veracruz,30,Tenochtitlán,30163,2599,2799,5398
2017,Veracruz,30,Teocelo,30164,8438,8883,17321
2017,Veracruz,30,Tepatlaxco,30165,4500,4266,8766
2017,Veracruz,30,Tepetlán,30166,5080,4893,9973
2017,Veracruz,30,Tepetzintla,30167,7531,7690,15221
2017,Veracruz,30,Tequila,30168,7691,7903,15594
2017,Veracruz,30,Texcatepec,30170,5549,5765,11314
2017,Veracruz,30,Texhuacán,30171,2633,2914,5547
2017,Veracruz,30,Texistepec,30172,10738,10715,21453
2017,Veracruz,30,Tezonapa,30173,28668,29276,57944
2017,Veracruz,30,Tierra Blanca,30174,51889,55845,107734
2017,Veracruz,30,Tihuatlán,30175,48414,50207,98621
2017,Veracruz,30,Tlachichilco,30180,5913,6102,12015
2017,Veracruz,30,Tlacojalpan,30176,2520,2576,5096
2017,Veracruz,30,Tlacolulan,30177,5865,5671,11536
2017,Veracruz,30,Tlacotalpan,30178,6818,7314,14132
2017,Veracruz,30,Tlacotepec de Mejía,30179,2027,2065,4092
2017,Veracruz,30,Tlalixcoyan,30181,19508,20107,39615
2017,Veracruz,30,Tlalnelhuayocan,30182,9359,9672,19031
2017,Veracruz,30,Tlaltetela,30024,8184,7962,16146
2017,Veracruz,30,Tlapacoyan,30183,31060,32768,63828
2017,Veracruz,30,Tlaquilpa,30184,3686,4186,7872
2017,Veracruz,30,Tlilapan,30185,2665,2771,5436
2017,Veracruz,30,Tomatlán,30186,3552,3655,7207
2017,Veracruz,30,Tonayán,30187,2903,3033,5936
2017,Veracruz,30,Totutla,30188,8941,8996,17937
2017,Veracruz,30,Tres Valles,30207,23498,24721,48219
2017,Veracruz,30,Tuxpan,30189,80565,84420,164985
2017,Veracruz,30,Tuxtilla,30190,1153,1177,2330
2017,Veracruz,30,Ursulo Galván,30191,15466,16351,31817
2017,Veracruz,30,Uxpanapa,30210,15105,14780,29885
2017,Veracruz,30,Vega de Alatorre,30192,10184,10852,21036
2017,Veracruz,30,Veracruz,30193,294002,317444,611446
2017,Veracruz,30,Villa Aldama,30194,5967,6057,12024
2017,Veracruz,30,Xalapa,30087,236999,265933,502932
2017,Veracruz,30,Xico,30092,19460,19875,39335
2017,Veracruz,30,Xoxocotla,30195,2857,2712,5569
2017,Veracruz,30,Yanga,30196,8729,9875,18604
2017,Veracruz,30,Yecuatla,30197,6102,6315,12417
2017,Veracruz,30,Zacualpan,30198,3585,3817,7402
2017,Veracruz,30,Zaragoza,30199,5712,5958,11670
2017,Veracruz,30,Zentla,30200,6975,6823,13798
2017,Veracruz,30,Zongolica,30201,22442,22740,45182
2017,Veracruz,30,Zontecomatlán de López y Fuentes,30202,7447,7561,15008
2017,Veracruz,30,Zozocolco de Hidalgo,30203,7494,7760,15254
2017,Veracruz,30,Álamo Temapache,30160,54455,55108,109563
2017,Yucatán,31,Abalá,31001,3504,3329,6833
2017,Yucatán,31,Acanceh,31002,8434,8411,16845
2017,Yucatán,31,Akil,31003,5678,5873,11551
2017,Yucatán,31,Baca,31004,3066,3116,6182
2017,Yucatán,31,Bokobá,31005,1163,1113,2276
2017,Yucatán,31,Buctzotz,31006,4687,4648,9335
2017,Yucatán,31,Cacalchén,31007,3855,3664,7519
2017,Yucatán,31,Calotmul,31008,2136,2102,4238
2017,Yucatán,31,Cansahcab,31009,2447,2468,4915
2017,Yucatán,31,Cantamayec,31010,1361,1248,2609
2017,Yucatán,31,Celestún,31011,4076,3880,7956
2017,Yucatán,31,Cenotillo,31012,1954,2103,4057
2017,Yucatán,31,Chacsinkín,31016,1568,1529,3097
2017,Yucatán,31,Chankom,31017,2434,2346,4780
2017,Yucatán,31,Chapab,31018,1659,1638,3297
2017,Yucatán,31,Chemax,31019,18953,18618,37571
2017,Yucatán,31,Chichimilá,31021,4373,4315,8688
2017,Yucatán,31,Chicxulub Pueblo,31020,2386,2246,4632
2017,Yucatán,31,Chikindzonot,31022,2225,2149,4374
2017,Yucatán,31,Chocholá,31023,2517,2418,4935
2017,Yucatán,31,Chumayel,31024,1681,1738,3419
2017,Yucatán,31,Conkal,31013,5656,5615,11271
2017,Yucatán,31,Cuncunul,31014,858,824,1682
2017,Yucatán,31,Cuzamá,31015,2753,2666,5419
2017,Yucatán,31,Dzemul,31026,1941,1899,3840
2017,Yucatán,31,Dzidzantún,31027,4418,4292,8710
2017,Yucatán,31,Dzilam González,31029,3303,3116,6419
2017,Yucatán,31,Dzilam de Bravo,31028,1443,1359,2802
2017,Yucatán,31,Dzitás,31030,2003,1905,3908
2017,Yucatán,31,Dzoncauich,31031,1406,1413,2819
2017,Yucatán,31,Dzán,31025,2693,2816,5509
2017,Yucatán,31,Espita,31032,8520,8253,16773
2017,Yucatán,31,Halachó,31033,10614,10353,20967
2017,Yucatán,31,Hocabá,31034,3236,3202,6438
2017,Yucatán,31,Hoctún,31035,3073,3139,6212
2017,Yucatán,31,Homún,31036,4075,3923,7998
2017,Yucatán,31,Huhí,31037,2750,2638,5388
2017,Yucatán,31,Hunucmá,31038,16874,16865,33739
2017,Yucatán,31,Ixil,31039,2171,2074,4245
2017,Yucatán,31,Izamal,31040,13921,14111,28032
2017,Yucatán,31,Kanasín,31041,49993,50627,100620
2017,Yucatán,31,Kantunil,31042,2829,2906,5735
2017,Yucatán,31,Kaua,31043,1629,1549,3178
2017,Yucatán,31,Kinchil,31044,3731,3646,7377
2017,Yucatán,31,Kopomá,31045,1366,1276,2642
2017,Yucatán,31,Mama,31046,1552,1710,3262
2017,Yucatán,31,Maní,31047,2840,2970,5810
2017,Yucatán,31,Maxcanú,31048,11926,11711,23637
2017,Yucatán,31,Mayapán,31049,1929,1812,3741
2017,Yucatán,31,Mocochá,31051,1716,1679,3395
2017,Yucatán,31,Motul,31052,18717,18944,37661
2017,Yucatán,31,Muna,31053,6530,6747,13277
2017,Yucatán,31,Muxupip,31054,1465,1521,2986
2017,Yucatán,31,Mérida,31050,449678,480791,930469
2017,Yucatán,31,Opichén,31055,3560,3427,6987
2017,Yucatán,31,Oxkutzcab,31056,15386,16791,32177
2017,Yucatán,31,Panabá,31057,4072,4050,8122
2017,Yucatán,31,Peto,31058,12988,13138,26126
2017,Yucatán,31,Progreso,31059,30424,30527,60951
2017,Yucatán,31,Quintana Roo,31060,505,502,1007
2017,Yucatán,31,Río Lagartos,31061,1909,1805,3714
2017,Yucatán,31,Sacalum,31062,2588,2422,5010
2017,Yucatán,31,Samahil,31063,2709,2682,5391
2017,Yucatán,31,San Felipe,31065,1054,981,2035
2017,Yucatán,31,Sanahcat,31064,880,885,1765
2017,Yucatán,31,Santa Elena,31066,2045,2136,4181
2017,Yucatán,31,Seyé,31067,5197,4938,10135
2017,Yucatán,31,Sinanché,31068,1719,1576,3295
2017,Yucatán,31,Sotuta,31069,4697,4515,9212
2017,Yucatán,31,Sucilá,31070,2107,2024,4131
2017,Yucatán,31,Sudzal,31071,939,849,1788
2017,Yucatán,31,Suma,31072,978,937,1915
2017,Yucatán,31,Tahdziú,31073,2643,2488,5131
2017,Yucatán,31,Tahmek,31074,1972,1895,3867
2017,Yucatán,31,Teabo,31075,3364,3419,6783
2017,Yucatán,31,Tecoh,31076,9157,9028,18185
2017,Yucatán,31,Tekal de Venegas,31077,1402,1364,2766
2017,Yucatán,31,Tekantó,31078,1983,1993,3976
2017,Yucatán,31,Tekax,31079,21795,22323,44118
2017,Yucatán,31,Tekit,31080,5432,5250,10682
2017,Yucatán,31,Tekom,31081,1678,1671,3349
2017,Yucatán,31,Telchac Pueblo,31082,1976,1937,3913
2017,Yucatán,31,Telchac Puerto,31083,979,889,1868
2017,Yucatán,31,Temax,31084,3779,3738,7517
2017,Yucatán,31,Temozón,31085,8199,7937,16136
2017,Yucatán,31,Tepakán,31086,1178,1123,2301
2017,Yucatán,31,Tetiz,31087,2610,2651,5261
2017,Yucatán,31,Teya,31088,1014,1036,2050
2017,Yucatán,31,Ticul,31089,20637,21068,41705
2017,Yucatán,31,Timucuy,31090,3910,3709,7619
2017,Yucatán,31,Tinum,31091,6314,6058,12372
2017,Yucatán,31,Tixcacalcupul,31092,3721,3643,7364
2017,Yucatán,31,Tixkokob,31093,9314,9436,18750
2017,Yucatán,31,Tixmehuac,31094,2549,2497,5046
2017,Yucatán,31,Tixpéhual,31095,2852,2906,5758
2017,Yucatán,31,Tizimín,31096,39895,40490,80385
2017,Yucatán,31,Tunkás,31097,1873,1809,3682
2017,Yucatán,31,Tzucacab,31098,7747,7542,15289
2017,Yucatán,31,Uayma,31099,2141,2032,4173
2017,Yucatán,31,Ucú,31100,1928,1890,3818
2017,Yucatán,31,Umán,31101,28672,28519,57191
2017,Yucatán,31,Valladolid,31102,41276,41869,83145
2017,Yucatán,31,Xocchel,31103,1833,1752,3585
2017,Yucatán,31,Yaxcabá,31104,8185,7689,15874
2017,Yucatán,31,Yaxkukul,31105,1617,1623,3240
2017,Yucatán,31,Yobaín,31106,1201,1143,2344
2017,Zacatecas,32,Apozol,32001,3080,3270,6350
2017,Zacatecas,32,Apulco,32002,2399,2662,5061
2017,Zacatecas,32,Atolinga,32003,1273,1356,2629
2017,Zacatecas,32,Benito Juárez,32004,2172,2110,4282
2017,Zacatecas,32,Calera,32005,23085,22941,46026
2017,Zacatecas,32,Cañitas de Felipe Pescador,32006,4291,4396,8687
2017,Zacatecas,32,Chalchihuites,32009,5651,5976,11627
2017,Zacatecas,32,Concepción del Oro,32007,6910,6712,13622
2017,Zacatecas,32,Cuauhtémoc,32008,6374,6634,13008
2017,Zacatecas,32,El Plateado de Joaquín Amaro,32015,671,685,1356
2017,Zacatecas,32,El Salvador,32041,1333,1275,2608
2017,Zacatecas,32,Fresnillo,32010,117259,119489,236748
2017,Zacatecas,32,Genaro Codina,32012,4126,4318,8444
2017,Zacatecas,32,General Enrique Estrada,32013,3228,3282,6510
2017,Zacatecas,32,General Francisco R. Murguía,32014,10962,11699,22661
2017,Zacatecas,32,General Pánfilo Natera,32016,11768,12213,23981
2017,Zacatecas,32,Guadalupe,32017,93127,97087,190214
2017,Zacatecas,32,Huanusco,32018,2087,2197,4284
2017,Zacatecas,32,Jalpa,32019,12272,12832,25104
2017,Zacatecas,32,Jerez,32020,29971,31678,61649
2017,Zacatecas,32,Jiménez del Teul,32021,2261,2293,4554
2017,Zacatecas,32,Juan Aldama,32022,10862,11453,22315
2017,Zacatecas,32,Juchipila,32023,6254,6881,13135
2017,Zacatecas,32,Loreto,32024,27198,27507,54705
2017,Zacatecas,32,Luis Moya,32025,6749,6818,13567
2017,Zacatecas,32,Mazapil,32026,9552,8595,18147
2017,Zacatecas,32,Melchor Ocampo,32027,1599,1405,3004
2017,Zacatecas,32,Mezquital del Oro,32028,1245,1357,2602
2017,Zacatecas,32,Miguel Auza,32029,11985,12398,24383
2017,Zacatecas,32,Momax,32030,1237,1324,2561
2017,Zacatecas,32,Monte Escobedo,32031,4725,4832,9557
2017,Zacatecas,32,Morelos,32032,6413,6390,12803
2017,Zacatecas,32,Moyahua de Estrada,32033,2024,2274,4298
2017,Zacatecas,32,Nochistlán de Mejía,32034,13775,15230,29005
2017,Zacatecas,32,Noria de Ángeles,32035,8455,8684,17139
2017,Zacatecas,32,Ojocaliente,32036,21783,22715,44498
2017,Zacatecas,32,Pinos,32038,37127,38471,75598
2017,Zacatecas,32,Pánuco,32037,9183,9118,18301
2017,Zacatecas,32,Río Grande,32039,32230,34237,66467
2017,Zacatecas,32,Sain Alto,32040,11142,11728,22870
2017,Zacatecas,32,Santa María de la Paz,32058,1412,1431,2843
2017,Zacatecas,32,Sombrerete,32042,31967,32713,64680
2017,Zacatecas,32,Susticacán,32043,671,727,1398
2017,Zacatecas,32,Tabasco,32044,7931,8306,16237
2017,Zacatecas,32,Tepechitlán,32045,4329,4703,9032
2017,Zacatecas,32,Tepetongo,32046,3585,3813,7398
2017,Zacatecas,32,Teúl de González Ortega,32047,2630,2745,5375
2017,Zacatecas,32,Tlaltenango de Sánchez Román,32048,13491,13899,27390
2017,Zacatecas,32,Trancoso,32057,9787,9929,19716
2017,Zacatecas,32,Trinidad García de la Cadena,32011,1492,1543,3035
2017,Zacatecas,32,Valparaíso,32049,16959,17434,34393
2017,Zacatecas,32,Vetagrande,32050,5062,5168,10230
2017,Zacatecas,32,Villa García,32052,9763,9897,19660
2017,Zacatecas,32,Villa González Ortega,32053,6613,7049,13662
2017,Zacatecas,32,Villa Hidalgo,32054,9866,9968,19834
2017,Zacatecas,32,Villa de Cos,32051,18386,18086,36472
2017,Zacatecas,32,Villanueva,32055,15368,16043,31411
2017,Zacatecas,32,Zacatecas,32056,74421,78242,152663
2018,Aguascalientes,01,Aguascalientes,01001,459492,476881,936373
2018,Aguascalientes,01,Asientos,01002,24800,25051,49851
2018,Aguascalientes,01,Calvillo,01003,29173,30486,59659
2018,Aguascalientes,01,Cosío,01004,8150,8465,16615
2018,Aguascalientes,01,El Llano,01010,10886,10584,21470
2018,Aguascalientes,01,Jesús María,01005,62865,62453,125318
2018,Aguascalientes,01,Pabellón de Arteaga,01006,23922,24997,48919
2018,Aguascalientes,01,Rincón de Romos,01007,28153,28585,56738
2018,Aguascalientes,01,San Francisco de los Romo,01011,24469,24742,49211
2018,Aguascalientes,01,San José de Gracia,01008,4575,4871,9446
2018,Aguascalientes,01,Tepezalá,01009,10912,11282,22194
2018,Baja California,02,Ensenada,02001,259324,259576,518900
2018,Baja California,02,Mexicali,02002,525402,526468,1051870
2018,Baja California,02,Playas de Rosarito,02005,52091,51880,103971
2018,Baja California,02,Tecate,02003,56994,53408,110402
2018,Baja California,02,Tijuana,02004,866306,869793,1736099
2018,Baja California Sur,03,Comondú,03001,40709,39588,80297
2018,Baja California Sur,03,La Paz,03003,145648,146037,291685
2018,Baja California Sur,03,Loreto,03009,10755,9855,20610
2018,Baja California Sur,03,Los Cabos,03008,160962,151716,312678
2018,Baja California Sur,03,Mulegé,03002,34250,31774,66024
2018,Campeche,04,Calakmul,04010,15620,15164,30784
2018,Campeche,04,Calkiní,04001,30211,31165,61376
2018,Campeche,04,Campeche,04002,147948,158667,306615
2018,Campeche,04,Candelaria,04011,23851,23354,47205
2018,Campeche,04,Carmen,04003,132216,133452,265668
2018,Campeche,04,Champotón,04004,48372,48127,96499
2018,Campeche,04,Escárcega,04009,30475,31308,61783
2018,Campeche,04,Hecelchakán,04005,16751,16845,33596
2018,Campeche,04,Hopelchén,04006,21757,20873,42630
2018,Campeche,04,Palizada,04007,4871,4754,9625
2018,Campeche,04,Tenabo,04008,5915,5623,11538
2018,Chiapas,07,Acacoyagua,07001,9668,9609,19277
2018,Chiapas,07,Acala,07002,16645,16864,33509
2018,Chiapas,07,Acapetahua,07003,15169,15144,30313
2018,Chiapas,07,Aldama,07113,3324,3591,6915
2018,Chiapas,07,Altamirano,07004,17498,17271,34769
2018,Chiapas,07,Amatenango de la Frontera,07006,16006,16930,32936
2018,Chiapas,07,Amatenango del Valle,07007,5043,5429,10472
2018,Chiapas,07,Amatán,07005,10937,10638,21575
2018,Chiapas,07,Angel Albino Corzo,07008,15144,15192,30336
2018,Chiapas,07,Arriaga,07009,21085,22405,43490
2018,Chiapas,07,Bejucal de Ocampo,07010,4086,4044,8130
2018,Chiapas,07,Bella Vista,07011,10657,10840,21497
2018,Chiapas,07,Benemérito de las Américas,07114,10546,10360,20906
2018,Chiapas,07,Berriozábal,07012,27205,27251,54456
2018,Chiapas,07,Bochil,07013,18259,18577,36836
2018,Chiapas,07,Cacahoatán,07015,24011,25203,49214
2018,Chiapas,07,Catazajá,07016,9413,9195,18608
2018,Chiapas,07,Chalchihuitán,07022,8677,8821,17498
2018,Chiapas,07,Chamula,07023,42672,49369,92041
2018,Chiapas,07,Chanal,07024,6391,6445,12836
2018,Chiapas,07,Chapultenango,07025,4058,4056,8114
2018,Chiapas,07,Chenalhó,07026,20752,21191,41943
2018,Chiapas,07,Chiapa de Corzo,07027,52638,54341,106979
2018,Chiapas,07,Chiapilla,07028,3191,3057,6248
2018,Chiapas,07,Chicoasén,07029,2761,2752,5513
2018,Chiapas,07,Chicomuselo,07030,18312,18549,36861
2018,Chiapas,07,Chilón,07031,66676,68077,134753
2018,Chiapas,07,Cintalapa,07017,45394,45435,90829
2018,Chiapas,07,Coapilla,07018,4834,4937,9771
2018,Chiapas,07,Comitán de Domínguez,07019,78833,86138,164971
2018,Chiapas,07,Copainalá,07021,11531,12005,23536
2018,Chiapas,07,El Bosque,07014,11300,12094,23394
2018,Chiapas,07,El Porvenir,07070,7548,7567,15115
2018,Chiapas,07,Escuintla,07032,16629,17183,33812
2018,Chiapas,07,Francisco León,07033,4072,3968,8040
2018,Chiapas,07,Frontera Comalapa,07034,37869,40278,78147
2018,Chiapas,07,Frontera Hidalgo,07035,7432,7772,15204
2018,Chiapas,07,Huehuetán,07037,18159,19160,37319
2018,Chiapas,07,Huitiupán,07039,12409,12248,24657
2018,Chiapas,07,Huixtla,07040,27952,29922,57874
2018,Chiapas,07,Huixtán,07038,12233,12622,24855
2018,Chiapas,07,Ixhuatán,07042,5893,6052,11945
2018,Chiapas,07,Ixtacomitán,07043,5719,5807,11526
2018,Chiapas,07,Ixtapa,07044,14357,14520,28877
2018,Chiapas,07,Ixtapangajoya,07045,2968,2892,5860
2018,Chiapas,07,Jiquipilas,07046,20834,21418,42252
2018,Chiapas,07,Jitotol,07047,11070,10755,21825
2018,Chiapas,07,Juárez,07048,11396,11629,23025
2018,Chiapas,07,La Concordia,07020,24861,24541,49402
2018,Chiapas,07,La Grandeza,07036,3829,3898,7727
2018,Chiapas,07,La Independencia,07041,23555,24520,48075
2018,Chiapas,07,La Libertad,07050,2647,2725,5372
2018,Chiapas,07,La Trinitaria,07099,40219,42282,82501
2018,Chiapas,07,Larráinzar,07049,12196,12598,24794
2018,Chiapas,07,Las Margaritas,07052,64493,65727,130220
2018,Chiapas,07,Las Rosas,07075,14901,15190,30091
2018,Chiapas,07,Mapastepec,07051,24792,25607,50399
2018,Chiapas,07,Maravilla Tenejapa,07115,6825,6581,13406
2018,Chiapas,07,Marqués de Comillas,07116,5998,5829,11827
2018,Chiapas,07,Mazapa de Madero,07053,4109,4241,8350
2018,Chiapas,07,Mazatán,07054,15283,15674,30957
2018,Chiapas,07,Metapa,07055,2910,3120,6030
2018,Chiapas,07,Mitontic,07056,6382,6473,12855
2018,Chiapas,07,Montecristo de Guerrero,07117,4141,4015,8156
2018,Chiapas,07,Motozintla,07057,38116,39442,77558
2018,Chiapas,07,Nicolás Ruíz,07058,2381,2254,4635
2018,Chiapas,07,Ocosingo,07059,115381,116164,231545
2018,Chiapas,07,Ocotepec,07060,6595,6826,13421
2018,Chiapas,07,Ocozocoautla de Espinosa,07061,48110,49183,97293
2018,Chiapas,07,Ostuacán,07062,9805,9675,19480
2018,Chiapas,07,Osumacinta,07063,2019,2012,4031
2018,Chiapas,07,Oxchuc,07064,25347,25091,50438
2018,Chiapas,07,Palenque,07065,62943,64828,127771
2018,Chiapas,07,Pantelhó,07066,11666,11834,23500
2018,Chiapas,07,Pantepec,07067,6428,6499,12927
2018,Chiapas,07,Pichucalco,07068,16659,16972,33631
2018,Chiapas,07,Pijijiapan,07069,28027,28752,56779
2018,Chiapas,07,Pueblo Nuevo Solistahuacán,07072,16539,17817,34356
2018,Chiapas,07,Rayón,07073,5101,5163,10264
2018,Chiapas,07,Reforma,07074,23726,24148,47874
2018,Chiapas,07,Sabanilla,07076,14409,14243,28652
2018,Chiapas,07,Salto de Agua,07077,33308,33624,66932
2018,Chiapas,07,San Andrés Duraznal,07118,2736,2883,5619
2018,Chiapas,07,San Cristóbal de las Casas,07078,106618,117159,223777
2018,Chiapas,07,San Fernando,07079,20854,20473,41327
2018,Chiapas,07,San Juan Cancuc,07112,17746,18514,36260
2018,Chiapas,07,San Lucas,07110,3846,3841,7687
2018,Chiapas,07,Santiago el Pinar,07119,1947,1919,3866
2018,Chiapas,07,Siltepec,07080,19790,19189,38979
2018,Chiapas,07,Simojovel,07081,23042,23400,46442
2018,Chiapas,07,Sitalá,07082,7405,7476,14881
2018,Chiapas,07,Socoltenango,07083,9800,9898,19698
2018,Chiapas,07,Solosuchiapa,07084,4359,4340,8699
2018,Chiapas,07,Soyaló,07085,5737,5667,11404
2018,Chiapas,07,Suchiapa,07086,12812,12756,25568
2018,Chiapas,07,Suchiate,07087,20121,20963,41084
2018,Chiapas,07,Sunuapa,07088,1286,1241,2527
2018,Chiapas,07,Tapachula,07089,178759,194070,372829
2018,Chiapas,07,Tapalapa,07090,2080,2198,4278
2018,Chiapas,07,Tapilula,07091,6728,7033,13761
2018,Chiapas,07,Tecpatán,07092,22087,22433,44520
2018,Chiapas,07,Tenejapa,07093,22668,23821,46489
2018,Chiapas,07,Teopisca,07094,22165,23409,45574
2018,Chiapas,07,Tila,07096,41525,41338,82863
2018,Chiapas,07,Tonalá,07097,47206,48386,95592
2018,Chiapas,07,Totolapa,07098,3848,3816,7664
2018,Chiapas,07,Tumbalá,07100,17821,18586,36407
2018,Chiapas,07,Tuxtla Chico,07102,21620,22817,44437
2018,Chiapas,07,Tuxtla Gutiérrez,07101,307426,337004,644430
2018,Chiapas,07,Tuzantán,07103,16543,17048,33591
2018,Chiapas,07,Tzimol,07104,8011,8373,16384
2018,Chiapas,07,Unión Juárez,07105,7951,8383,16334
2018,Chiapas,07,Venustiano Carranza,07106,34614,34770,69384
2018,Chiapas,07,Villa Comaltitlán,07071,15274,15626,30900
2018,Chiapas,07,Villa Corzo,07107,41291,42636,83927
2018,Chiapas,07,Villaflores,07108,55317,57490,112807
2018,Chiapas,07,Yajalón,07109,19764,20591,40355
2018,Chiapas,07,Zinacantán,07111,20364,23053,43417
2018,Chihuahua,08,Ahumada,08001,6464,6291,12755
2018,Chihuahua,08,Aldama,08002,12667,12794,25461
2018,Chihuahua,08,Allende,08003,4669,4559,9228
2018,Chihuahua,08,Aquiles Serdán,08004,9298,8690,17988
2018,Chihuahua,08,Ascensión,08005,13170,12804,25974
2018,Chihuahua,08,Bachíniva,08006,3340,3202,6542
2018,Chihuahua,08,Balleza,08007,8973,8685,17658
2018,Chihuahua,08,Batopilas,08008,6517,6501,13018
2018,Chihuahua,08,Bocoyna,08009,14557,15124,29681
2018,Chihuahua,08,Buenaventura,08010,12334,12111,24445
2018,Chihuahua,08,Camargo,08011,26509,27458,53967
2018,Chihuahua,08,Carichí,08012,4913,4850,9763
2018,Chihuahua,08,Casas Grandes,08013,6003,5745,11748
2018,Chihuahua,08,Chihuahua,08019,450674,473781,924455
2018,Chihuahua,08,Chínipas,08020,4406,3987,8393
2018,Chihuahua,08,Coronado,08014,1195,1104,2299
2018,Chihuahua,08,Coyame del Sotol,08015,965,803,1768
2018,Chihuahua,08,Cuauhtémoc,08017,85345,90414,175759
2018,Chihuahua,08,Cusihuiriachi,08018,2610,2441,5051
2018,Chihuahua,08,Delicias,08021,76195,79530,155725
2018,Chihuahua,08,Dr. Belisario Domínguez,08022,1379,1340,2719
2018,Chihuahua,08,El Tule,08064,925,888,1813
2018,Chihuahua,08,Galeana,08023,3403,3401,6804
2018,Chihuahua,08,Gran Morelos,08026,1420,1361,2781
2018,Chihuahua,08,Guachochi,08027,24186,25155,49341
2018,Chihuahua,08,Guadalupe,08028,2700,2731,5431
2018,Chihuahua,08,Guadalupe y Calvo,08029,29233,28620,57853
2018,Chihuahua,08,Guazapares,08030,4340,4145,8485
2018,Chihuahua,08,Guerrero,08031,20911,20644,41555
2018,Chihuahua,08,Gómez Farías,08025,4659,4668,9327
2018,Chihuahua,08,Hidalgo del Parral,08032,56024,59477,115501
2018,Chihuahua,08,Huejotitán,08033,524,520,1044
2018,Chihuahua,08,Ignacio Zaragoza,08034,3694,3627,7321
2018,Chihuahua,08,Janos,08035,5977,5465,11442
2018,Chihuahua,08,Jiménez,08036,22295,22544,44839
2018,Chihuahua,08,Julimes,08038,2470,2368,4838
2018,Chihuahua,08,Juárez,08037,723744,722561,1446305
2018,Chihuahua,08,La Cruz,08016,2109,2009,4118
2018,Chihuahua,08,López,08039,2203,2049,4252
2018,Chihuahua,08,Madera,08040,15492,15254,30746
2018,Chihuahua,08,Maguarichi,08041,906,850,1756
2018,Chihuahua,08,Manuel Benavides,08042,831,703,1534
2018,Chihuahua,08,Matachí,08043,1628,1604,3232
2018,Chihuahua,08,Matamoros,08044,2410,2316,4726
2018,Chihuahua,08,Meoqui,08045,23441,23833,47274
2018,Chihuahua,08,Morelos,08046,4212,4124,8336
2018,Chihuahua,08,Moris,08047,2824,2625,5449
2018,Chihuahua,08,Namiquipa,08048,12655,12094,24749
2018,Chihuahua,08,Nonoava,08049,1436,1359,2795
2018,Chihuahua,08,Nuevo Casas Grandes,08050,32179,33557,65736
2018,Chihuahua,08,Ocampo,08051,4088,3738,7826
2018,Chihuahua,08,Ojinaga,08052,14622,14427,29049
2018,Chihuahua,08,Praxedis G. Guerrero,08053,2724,2669,5393
2018,Chihuahua,08,Riva Palacio,08054,4187,4041,8228
2018,Chihuahua,08,Rosales,08055,9090,8909,17999
2018,Chihuahua,08,Rosario,08056,1098,1061,2159
2018,Chihuahua,08,San Francisco de Borja,08057,1220,1154,2374
2018,Chihuahua,08,San Francisco de Conchos,08058,1447,1341,2788
2018,Chihuahua,08,San Francisco del Oro,08059,2672,2646,5318
2018,Chihuahua,08,Santa Bárbara,08060,5604,5668,11272
2018,Chihuahua,08,Santa Isabel,08024,2094,2125,4219
2018,Chihuahua,08,Satevó,08061,1757,1635,3392
2018,Chihuahua,08,Saucillo,08062,16726,16558,33284
2018,Chihuahua,08,Temósachic,08063,3499,3315,6814
2018,Chihuahua,08,Urique,08065,11093,10762,21855
2018,Chihuahua,08,Uruachi,08066,3460,3303,6763
2018,Chihuahua,08,Valle de Zaragoza,08067,2795,2676,5471
2018,Ciudad de México,09,Azcapotzalco,09002,193871,217632,411503
2018,Ciudad de México,09,Benito Juárez,09014,196261,230468,426729
2018,Ciudad de México,09,Coyoacán,09003,294059,331575,625634
2018,Ciudad de México,09,Cuajimalpa de Morelos,09004,95205,103442,198647
2018,Ciudad de México,09,Cuauhtémoc,09015,259430,287283,546713
2018,Ciudad de México,09,Gustavo A. Madero,09005,569313,615488,1184801
2018,Ciudad de México,09,Iztacalco,09006,187390,207763,395153
2018,Ciudad de México,09,Iztapalapa,09007,889177,941658,1830835
2018,Ciudad de México,09,La Magdalena Contreras,09008,118002,127443,245445
2018,Ciudad de México,09,Miguel Hidalgo,09016,174638,203099,377737
2018,Ciudad de México,09,Milpa Alta,09009,67689,70752,138441
2018,Ciudad de México,09,Tlalpan,09012,326142,354475,680617
2018,Ciudad de México,09,Tláhuac,09011,177274,190540,367814
2018,Ciudad de México,09,Venustiano Carranza,09017,205407,230149,435556
2018,Ciudad de México,09,Xochimilco,09013,206375,214096,420471
2018,Ciudad de México,09,Álvaro Obregón,09010,360195,395104,755299
2018,Coahuila,05,Abasolo,05001,555,551,1106
2018,Coahuila,05,Acuña,05002,80527,79344,159871
2018,Coahuila,05,Allende,05003,11986,12245,24231
2018,Coahuila,05,Arteaga,05004,12716,12103,24819
2018,Coahuila,05,Candela,05005,999,901,1900
2018,Coahuila,05,Castaños,05006,14885,14827,29712
2018,Coahuila,05,Cuatro Ciénegas,05007,7249,7063,14312
2018,Coahuila,05,Escobedo,05008,1665,1605,3270
2018,Coahuila,05,Francisco I. Madero,05009,31283,31295,62578
2018,Coahuila,05,Frontera,05010,43109,42588,85697
2018,Coahuila,05,General Cepeda,05011,6873,6299,13172
2018,Coahuila,05,Guerrero,05012,1037,912,1949
2018,Coahuila,05,Hidalgo,05013,955,909,1864
2018,Coahuila,05,Jiménez,05014,5517,5325,10842
2018,Coahuila,05,Juárez,05015,874,811,1685
2018,Coahuila,05,Lamadrid,05016,1001,942,1943
2018,Coahuila,05,Matamoros,05017,58525,58324,116849
2018,Coahuila,05,Monclova,05018,122061,122975,245036
2018,Coahuila,05,Morelos,05019,4658,4513,9171
2018,Coahuila,05,Múzquiz,05020,37349,36489,73838
2018,Coahuila,05,Nadadores,05021,3534,3464,6998
2018,Coahuila,05,Nava,05022,16571,15707,32278
2018,Coahuila,05,Ocampo,05023,6054,5596,11650
2018,Coahuila,05,Parras,05024,24603,23502,48105
2018,Coahuila,05,Piedras Negras,05025,87090,86195,173285
2018,Coahuila,05,Progreso,05026,1863,1737,3600
2018,Coahuila,05,Ramos Arizpe,05027,50074,48130,98204
2018,Coahuila,05,Sabinas,05028,33926,33724,67650
2018,Coahuila,05,Sacramento,05029,1292,1252,2544
2018,Coahuila,05,Saltillo,05030,421059,422362,843421
2018,Coahuila,05,San Buenaventura,05031,12550,12513,25063
2018,Coahuila,05,San Juan de Sabinas,05032,22784,23489,46273
2018,Coahuila,05,San Pedro,05033,57002,56949,113951
2018,Coahuila,05,Sierra Mojada,05034,3836,3542,7378
2018,Coahuila,05,Torreón,05035,354524,369360,723884
2018,Coahuila,05,Viesca,05036,11775,11369,23144
2018,Coahuila,05,Villa Unión,05037,3472,3283,6755
2018,Coahuila,05,Zaragoza,05038,7042,6947,13989
2018,Colima,06,Armería,06001,15848,15687,31535
2018,Colima,06,Colima,06002,80076,84356,164432
2018,Colima,06,Comala,06003,11728,11598,23326
2018,Colima,06,Coquimatlán,06004,10898,10731,21629
2018,Colima,06,Cuauhtémoc,06005,15990,15916,31906
2018,Colima,06,Ixtlahuacán,06006,2977,2940,5917
2018,Colima,06,Manzanillo,06007,98838,97067,195905
2018,Colima,06,Minatitlán,06008,4887,4525,9412
2018,Colima,06,Tecomán,06009,65834,64787,130621
2018,Colima,06,Villa de Álvarez,06010,71009,74641,145650
2018,Durango,10,Canatlán,10001,16953,17283,34236
2018,Durango,10,Canelas,10002,2489,2263,4752
2018,Durango,10,Coneto de Comonfort,10003,2283,2332,4615
2018,Durango,10,Cuencamé,10004,18616,18322,36938
2018,Durango,10,Durango,10005,329869,350567,680436
2018,Durango,10,El Oro,10018,6016,6075,12091
2018,Durango,10,General Simón Bolívar,10006,5301,5406,10707
2018,Durango,10,Guadalupe Victoria,10008,18449,18804,37253
2018,Durango,10,Guanaceví,10009,5408,5068,10476
2018,Durango,10,Gómez Palacio,10007,180422,183399,363821
2018,Durango,10,Hidalgo,10010,2109,2048,4157
2018,Durango,10,Indé,10011,2653,2652,5305
2018,Durango,10,Lerdo,10012,80358,81014,161372
2018,Durango,10,Mapimí,10013,13888,13874,27762
2018,Durango,10,Mezquital,10014,19584,20178,39762
2018,Durango,10,Nazas,10015,6810,6849,13659
2018,Durango,10,Nombre de Dios,10016,10213,10311,20524
2018,Durango,10,Nuevo Ideal,10039,14141,14266,28407
2018,Durango,10,Ocampo,10017,5203,4973,10176
2018,Durango,10,Otáez,10019,2841,2642,5483
2018,Durango,10,Peñón Blanco,10021,5725,5670,11395
2018,Durango,10,Poanas,10022,13115,13488,26603
2018,Durango,10,Pueblo Nuevo,10023,26256,26416,52672
2018,Durango,10,Pánuco de Coronado,10020,6307,6494,12801
2018,Durango,10,Rodeo,10024,7060,7041,14101
2018,Durango,10,San Bernardo,10025,1830,1626,3456
2018,Durango,10,San Dimas,10026,10389,9744,20133
2018,Durango,10,San Juan de Guadalupe,10027,2915,2994,5909
2018,Durango,10,San Juan del Río,10028,6454,6621,13075
2018,Durango,10,San Luis del Cordero,10029,1129,1098,2227
2018,Durango,10,San Pedro del Gallo,10030,834,783,1617
2018,Durango,10,Santa Clara,10031,3691,3723,7414
2018,Durango,10,Santiago Papasquiaro,10032,25182,25130,50312
2018,Durango,10,Súchil,10033,3257,3530,6787
2018,Durango,10,Tamazula,10034,14353,13145,27498
2018,Durango,10,Tepehuanes,10035,5741,5778,11519
2018,Durango,10,Tlahualilo,10036,12277,12043,24320
2018,Durango,10,Topia,10037,4973,4683,9656
2018,Durango,10,Vicente Guerrero,10038,11184,11849,23033
2018,Estado de México,15,Acambay de Ruíz Castañeda,15001,33049,35155,68204
2018,Estado de México,15,Acolman,15002,88819,88404,177223
2018,Estado de México,15,Aculco,15003,25114,25829,50943
2018,Estado de México,15,Almoloya de Alquisiras,15004,7429,8111,15540
2018,Estado de México,15,Almoloya de Juárez,15005,89868,91835,181703
2018,Estado de México,15,Almoloya del Río,15006,5716,6144,11860
2018,Estado de México,15,Amanalco,15007,12431,12933,25364
2018,Estado de México,15,Amatepec,15008,13653,14525,28178
2018,Estado de México,15,Amecameca,15009,25965,27782,53747
2018,Estado de México,15,Apaxco,15010,15263,15654,30917
2018,Estado de México,15,Atenco,15011,33399,34015,67414
2018,Estado de México,15,Atizapán,15012,5913,6253,12166
2018,Estado de México,15,Atizapán de Zaragoza,15013,267154,282503,549657
2018,Estado de México,15,Atlacomulco,15014,50252,54403,104655
2018,Estado de México,15,Atlautla,15015,15565,16333,31898
2018,Estado de México,15,Axapusco,15016,14494,14681,29175
2018,Estado de México,15,Ayapango,15017,5216,5423,10639
2018,Estado de México,15,Calimaya,15018,28357,29817,58174
2018,Estado de México,15,Capulhuac,15019,18222,19236,37458
2018,Estado de México,15,Chalco,15025,185228,193774,379002
2018,Estado de México,15,Chapa de Mota,15026,14525,15076,29601
2018,Estado de México,15,Chapultepec,15027,6075,6316,12391
2018,Estado de México,15,Chiautla,15028,15098,15672,30770
2018,Estado de México,15,Chicoloapan,15029,105891,112018,217909
2018,Estado de México,15,Chiconcuac,15030,13152,13560,26712
2018,Estado de México,15,Chimalhuacán,15031,346496,358820,705316
2018,Estado de México,15,Coacalco de Berriozábal,15020,148445,159204,307649
2018,Estado de México,15,Coatepec Harinas,15021,19628,21203,40831
2018,Estado de México,15,Cocotitlán,15022,7314,7645,14959
2018,Estado de México,15,Coyotepec,15023,21605,22026,43631
2018,Estado de México,15,Cuautitlán,15024,83241,85293,168534
2018,Estado de México,15,Cuautitlán Izcalli,15121,277042,291266,568308
2018,Estado de México,15,Donato Guerra,15032,17497,18030,35527
2018,Estado de México,15,Ecatepec de Morelos,15033,836228,856416,1692644
2018,Estado de México,15,Ecatzingo,15034,4883,5034,9917
2018,Estado de México,15,El Oro,15064,18803,19900,38703
2018,Estado de México,15,Huehuetoca,15035,68591,70652,139243
2018,Estado de México,15,Hueypoxtla,15036,22952,22661,45613
2018,Estado de México,15,Huixquilucan,15037,136196,146518,282714
2018,Estado de México,15,Isidro Fabela,15038,6015,6139,12154
2018,Estado de México,15,Ixtapaluca,15039,262964,273293,536257
2018,Estado de México,15,Ixtapan de la Sal,15040,17988,19419,37407
2018,Estado de México,15,Ixtapan del Oro,15041,3618,3538,7156
2018,Estado de México,15,Ixtlahuaca,15042,77016,82378,159394
2018,Estado de México,15,Jaltenco,15044,14140,14960,29100
2018,Estado de México,15,Jilotepec,15045,45519,47036,92555
2018,Estado de México,15,Jilotzingo,15046,9842,10374,20216
2018,Estado de México,15,Jiquipilco,15047,37445,39839,77284
2018,Estado de México,15,Jocotitlán,15048,33267,35557,68824
2018,Estado de México,15,Joquicingo,15049,6998,7375,14373
2018,Estado de México,15,Juchitepec,15050,13097,13489,26586
2018,Estado de México,15,La Paz,15070,148936,152990,301926
2018,Estado de México,15,Lerma,15051,76358,78430,154788
2018,Estado de México,15,Luvianos,15123,14564,14860,29424
2018,Estado de México,15,Malinalco,15052,14170,14643,28813
2018,Estado de México,15,Melchor Ocampo,15053,28887,30140,59027
2018,Estado de México,15,Metepec,15054,117183,124584,241767
2018,Estado de México,15,Mexicaltzingo,15055,6472,6895,13367
2018,Estado de México,15,Morelos,15056,14976,16283,31259
2018,Estado de México,15,Naucalpan de Juárez,15057,436486,462068,898554
2018,Estado de México,15,Nextlalpan,15059,20623,21115,41738
2018,Estado de México,15,Nezahualcóyotl,15058,545444,584728,1130172
2018,Estado de México,15,Nicolás Romero,15060,209619,217811,427430
2018,Estado de México,15,Nopaltepec,15061,4785,4801,9586
2018,Estado de México,15,Ocoyoacac,15062,34371,35491,69862
2018,Estado de México,15,Ocuilan,15063,17469,18197,35666
2018,Estado de México,15,Otumba,15065,18796,18571,37367
2018,Estado de México,15,Otzoloapan,15066,2174,2139,4313
2018,Estado de México,15,Otzolotepec,15067,43586,44772,88358
2018,Estado de México,15,Ozumba,15068,14636,15810,30446
2018,Estado de México,15,Papalotla,15069,2101,2210,4311
2018,Estado de México,15,Polotitlán,15071,7193,7507,14700
2018,Estado de México,15,Rayón,15072,6985,7210,14195
2018,Estado de México,15,San Antonio la Isla,15073,14771,15212,29983
2018,Estado de México,15,San Felipe del Progreso,15074,65751,73338,139089
2018,Estado de México,15,San José del Rincón,15124,48346,49069,97415
2018,Estado de México,15,San Martín de las Pirámides,15075,14007,14359,28366
2018,Estado de México,15,San Mateo Atenco,15076,39058,40414,79472
2018,Estado de México,15,San Simón de Guerrero,15077,3129,3329,6458
2018,Estado de México,15,Santo Tomás,15078,4972,5125,10097
2018,Estado de México,15,Soyaniquilpan de Juárez,15079,6880,7034,13914
2018,Estado de México,15,Sultepec,15080,13191,14677,27868
2018,Estado de México,15,Tecámac,15081,232398,243940,476338
2018,Estado de México,15,Tejupilco,15082,38110,41303,79413
2018,Estado de México,15,Temamatla,15083,6469,6862,13331
2018,Estado de México,15,Temascalapa,15084,20353,20404,40757
2018,Estado de México,15,Temascalcingo,15085,31926,34562,66488
2018,Estado de México,15,Temascaltepec,15086,16615,17268,33883
2018,Estado de México,15,Temoaya,15087,51678,54571,106249
2018,Estado de México,15,Tenancingo,15088,49891,52734,102625
2018,Estado de México,15,Tenango del Aire,15089,6368,6542,12910
2018,Estado de México,15,Tenango del Valle,15090,43932,45771,89703
2018,Estado de México,15,Teoloyucan,15091,34542,35156,69698
2018,Estado de México,15,Teotihuacán,15092,29375,30280,59655
2018,Estado de México,15,Tepetlaoxtoc,15093,15957,16305,32262
2018,Estado de México,15,Tepetlixpa,15094,10205,10506,20711
2018,Estado de México,15,Tepotzotlán,15095,49667,51391,101058
2018,Estado de México,15,Tequixquiac,15096,19220,19491,38711
2018,Estado de México,15,Texcaltitlán,15097,9529,10199,19728
2018,Estado de México,15,Texcalyacac,15098,2752,2834,5586
2018,Estado de México,15,Texcoco,15099,125234,131763,256997
2018,Estado de México,15,Tezoyuca,15100,22076,22382,44458
2018,Estado de México,15,Tianguistenco,15101,39181,41346,80527
2018,Estado de México,15,Timilpan,15102,7967,8592,16559
2018,Estado de México,15,Tlalmanalco,15103,24399,26146,50545
2018,Estado de México,15,Tlalnepantla de Baz,15104,360443,384304,744747
2018,Estado de México,15,Tlatlaya,15105,18026,18859,36885
2018,Estado de México,15,Toluca,15106,447566,478816,926382
2018,Estado de México,15,Tonanitla,15125,5329,5472,10801
2018,Estado de México,15,Tonatico,15107,6417,6843,13260
2018,Estado de México,15,Tultepec,15108,76565,79608,156173
2018,Estado de México,15,Tultitlán,15109,269366,279410,548776
2018,Estado de México,15,Valle de Bravo,15110,33823,35160,68983
2018,Estado de México,15,Valle de Chalco Solidaridad,15122,201844,208509,410353
2018,Estado de México,15,Villa Guerrero,15113,34256,35450,69706
2018,Estado de México,15,Villa Victoria,15114,53258,53935,107193
2018,Estado de México,15,Villa de Allende,15111,26355,27302,53657
2018,Estado de México,15,Villa del Carbón,15112,24867,24631,49498
2018,Estado de México,15,Xalatlaco,15043,15101,15936,31037
2018,Estado de México,15,Xonacatlán,15115,26782,26738,53520
2018,Estado de México,15,Zacazonapan,15116,2172,2154,4326
2018,Estado de México,15,Zacualpan,15117,7553,8298,15851
2018,Estado de México,15,Zinacantepec,15118,96350,99146,195496
2018,Estado de México,15,Zumpahuacán,15119,8492,9255,17747
2018,Estado de México,15,Zumpango,15120,100555,107602,208157
2018,Guanajuato,11,Abasolo,11001,45539,48558,94097
2018,Guanajuato,11,Acámbaro,11002,56431,61045,117476
2018,Guanajuato,11,Apaseo el Alto,11004,34728,36387,71115
2018,Guanajuato,11,Apaseo el Grande,11005,46978,49751,96729
2018,Guanajuato,11,Atarjea,11006,2708,2813,5521
2018,Guanajuato,11,Celaya,11007,253677,267623,521300
2018,Guanajuato,11,Comonfort,11009,40722,45114,85836
2018,Guanajuato,11,Coroneo,11010,6068,6722,12790
2018,Guanajuato,11,Cortazar,11011,48539,51191,99730
2018,Guanajuato,11,Cuerámaro,11012,14194,15321,29515
2018,Guanajuato,11,Doctor Mora,11013,12199,13072,25271
2018,Guanajuato,11,Dolores Hidalgo Cuna de la Independencia Nacional,11014,75446,83523,158969
2018,Guanajuato,11,Guanajuato,11015,95252,98815,194067
2018,Guanajuato,11,Huanímaro,11016,10557,11724,22281
2018,Guanajuato,11,Irapuato,11017,292178,306364,598542
2018,Guanajuato,11,Jaral del Progreso,11018,19758,20571,40329
2018,Guanajuato,11,Jerécuaro,11019,23977,27240,51217
2018,Guanajuato,11,León,11020,817841,828145,1645986
2018,Guanajuato,11,Manuel Doblado,11008,19100,21031,40131
2018,Guanajuato,11,Moroleón,11021,25624,27951,53575
2018,Guanajuato,11,Ocampo,11022,11820,12600,24420
2018,Guanajuato,11,Pueblo Nuevo,11024,5843,6516,12359
2018,Guanajuato,11,Purísima del Rincón,11025,41644,41601,83245
2018,Guanajuato,11,Pénjamo,11023,75643,82700,158343
2018,Guanajuato,11,Romita,11026,29967,31814,61781
2018,Guanajuato,11,Salamanca,11027,140646,147527,288173
2018,Guanajuato,11,Salvatierra,11028,50343,55162,105505
2018,Guanajuato,11,San Diego de la Unión,11029,19133,21822,40955
2018,Guanajuato,11,San Felipe,11030,56615,60032,116647
2018,Guanajuato,11,San Francisco del Rincón,11031,60764,63550,124314
2018,Guanajuato,11,San José Iturbide,11032,39592,42005,81597
2018,Guanajuato,11,San Luis de la Paz,11033,60022,65719,125741
2018,Guanajuato,11,San Miguel de Allende,11003,86277,93054,179331
2018,Guanajuato,11,Santa Catarina,11034,2630,2869,5499
2018,Guanajuato,11,Santa Cruz de Juventino Rosas,11035,42078,45041,87119
2018,Guanajuato,11,Santiago Maravatío,11036,3407,3783,7190
2018,Guanajuato,11,Silao de la Victoria,11037,97079,99351,196430
2018,Guanajuato,11,Tarandacuao,11038,6066,6664,12730
2018,Guanajuato,11,Tarimoro,11039,17598,18737,36335
2018,Guanajuato,11,Tierra Blanca,11040,9639,10219,19858
2018,Guanajuato,11,Uriangato,11041,31972,34003,65975
2018,Guanajuato,11,Valle de Santiago,11042,71964,78856,150820
2018,Guanajuato,11,Victoria,11043,10108,11132,21240
2018,Guanajuato,11,Villagrán,11044,30261,31539,61800
2018,Guanajuato,11,Xichú,11045,5825,6307,12132
2018,Guanajuato,11,Yuriria,11046,34787,38402,73189
2018,Guerrero,12,Acapulco de Juárez,12001,402662,432227,834889
2018,Guerrero,12,Acatepec,12076,18772,19644,38416
2018,Guerrero,12,Ahuacuotzingo,12002,12672,14407,27079
2018,Guerrero,12,Ajuchitlán del Progreso,12003,18859,20203,39062
2018,Guerrero,12,Alcozauca de Guerrero,12004,9294,10570,19864
2018,Guerrero,12,Alpoyeca,12005,3238,3658,6896
2018,Guerrero,12,Apaxtla,12006,5661,6138,11799
2018,Guerrero,12,Arcelia,12007,15833,16813,32646
2018,Guerrero,12,Atenango del Río,12008,4228,4632,8860
2018,Guerrero,12,Atlamajalcingo del Monte,12009,2552,2821,5373
2018,Guerrero,12,Atlixtac,12010,13455,14400,27855
2018,Guerrero,12,Atoyac de Álvarez,12011,30723,31864,62587
2018,Guerrero,12,Ayutla de los Libres,12012,34030,35464,69494
2018,Guerrero,12,Azoyú,12013,6699,7115,13814
2018,Guerrero,12,Benito Juárez,12014,7733,8129,15862
2018,Guerrero,12,Buenavista de Cuéllar,12015,6658,7014,13672
2018,Guerrero,12,Chilapa de Álvarez,12028,62524,69045,131569
2018,Guerrero,12,Chilpancingo de los Bravo,12029,133682,145546,279228
2018,Guerrero,12,Coahuayutla de José María Izazaga,12016,6557,6312,12869
2018,Guerrero,12,Cochoapa el Grande,12078,9179,10124,19303
2018,Guerrero,12,Cocula,12017,6795,7339,14134
2018,Guerrero,12,Copala,12018,7121,7389,14510
2018,Guerrero,12,Copalillo,12019,7161,7905,15066
2018,Guerrero,12,Copanatoyac,12020,9814,10704,20518
2018,Guerrero,12,Coyuca de Benítez,12021,38488,39968,78456
2018,Guerrero,12,Coyuca de Catalán,12022,20638,20227,40865
2018,Guerrero,12,Cuajinicuilapa,12023,13838,13846,27684
2018,Guerrero,12,Cualác,12024,3721,4016,7737
2018,Guerrero,12,Cuautepec,12025,8223,8277,16500
2018,Guerrero,12,Cuetzala del Progreso,12026,4367,4620,8987
2018,Guerrero,12,Cutzamala de Pinzón,12027,10053,10489,20542
2018,Guerrero,12,Eduardo Neri,12075,25464,26597,52061
2018,Guerrero,12,Florencio Villarreal,12030,10567,10827,21394
2018,Guerrero,12,General Canuto A. Neri,12031,2874,3121,5995
2018,Guerrero,12,General Heliodoro Castillo,12032,18920,18895,37815
2018,Guerrero,12,Huamuxtitlán,12033,7346,8299,15645
2018,Guerrero,12,Huitzuco de los Figueroa,12034,18453,20081,38534
2018,Guerrero,12,Iguala de la Independencia,12035,75352,80856,156208
2018,Guerrero,12,Igualapa,12036,5681,5892,11573
2018,Guerrero,12,Iliatenco,12081,5368,5888,11256
2018,Guerrero,12,Ixcateopan de Cuauhtémoc,12037,3061,3396,6457
2018,Guerrero,12,José Joaquín de Herrera,12079,8767,8939,17706
2018,Guerrero,12,Juan R. Escudero,12039,12445,13178,25623
2018,Guerrero,12,Juchitán,12080,3937,3890,7827
2018,Guerrero,12,La Unión de Isidoro Montes de Oca,12068,13763,13232,26995
2018,Guerrero,12,Leonardo Bravo,12040,13177,13486,26663
2018,Guerrero,12,Malinaltepec,12041,13480,15027,28507
2018,Guerrero,12,Marquelia,12077,7023,7110,14133
2018,Guerrero,12,Metlatónoc,12043,9144,10488,19632
2018,Guerrero,12,Mochitlán,12044,6357,6623,12980
2018,Guerrero,12,Mártir de Cuilapan,12042,9053,9933,18986
2018,Guerrero,12,Olinalá,12045,12566,13590,26156
2018,Guerrero,12,Ometepec,12046,33566,35245,68811
2018,Guerrero,12,Pedro Ascencio Alquisiras,12047,3265,3816,7081
2018,Guerrero,12,Petatlán,12048,22621,22998,45619
2018,Guerrero,12,Pilcaya,12049,6344,6760,13104
2018,Guerrero,12,Pungarabato,12050,18867,20037,38904
2018,Guerrero,12,Quechultenango,12051,17941,18845,36786
2018,Guerrero,12,San Luis Acatlán,12052,22194,22785,44979
2018,Guerrero,12,San Marcos,12053,24860,25781,50641
2018,Guerrero,12,San Miguel Totolapan,12054,13964,14445,28409
2018,Guerrero,12,Taxco de Alarcón,12055,53771,58137,111908
2018,Guerrero,12,Tecoanapa,12056,23386,24029,47415
2018,Guerrero,12,Teloloapan,12058,27586,30971,58557
2018,Guerrero,12,Tepecoacuilco de Trujano,12059,15614,16960,32574
2018,Guerrero,12,Tetipac,12060,7153,7584,14737
2018,Guerrero,12,Tixtla de Guerrero,12061,21133,22833,43966
2018,Guerrero,12,Tlacoachistlahuaca,12062,11180,12539,23719
2018,Guerrero,12,Tlacoapa,12063,4887,5388,10275
2018,Guerrero,12,Tlalchapa,12064,6270,6312,12582
2018,Guerrero,12,Tlalixtaquilla de Maldonado,12065,3615,3935,7550
2018,Guerrero,12,Tlapa de Comonfort,12066,43445,48082,91527
2018,Guerrero,12,Tlapehuala,12067,10956,11762,22718
2018,Guerrero,12,Técpan de Galeana,12057,32962,33471,66433
2018,Guerrero,12,Xalpatláhuac,12069,5684,6608,12292
2018,Guerrero,12,Xochihuehuetlán,12070,3453,3952,7405
2018,Guerrero,12,Xochistlahuaca,12071,14529,15386,29915
2018,Guerrero,12,Zapotitlán Tablas,12072,5717,6310,12027
2018,Guerrero,12,Zihuatanejo de Azueta,12038,63904,65459,129363
2018,Guerrero,12,Zirándaro,12073,9466,9116,18582
2018,Guerrero,12,Zitlala,12074,11131,12441,23572
2018,Hidalgo,13,Acatlán,13001,10517,11279,21796
2018,Hidalgo,13,Acaxochitlán,13002,21772,23491,45263
2018,Hidalgo,13,Actopan,13003,28464,31570,60034
2018,Hidalgo,13,Agua Blanca de Iturbide,13004,4559,5025,9584
2018,Hidalgo,13,Ajacuba,13005,9500,9951,19451
2018,Hidalgo,13,Alfajayucan,13006,10434,11072,21506
2018,Hidalgo,13,Almoloya,13007,6407,6483,12890
2018,Hidalgo,13,Apan,13008,22633,24537,47170
2018,Hidalgo,13,Atitalaquia,13010,15551,15868,31419
2018,Hidalgo,13,Atlapexco,13011,10279,11029,21308
2018,Hidalgo,13,Atotonilco de Tula,13013,19277,20379,39656
2018,Hidalgo,13,Atotonilco el Grande,13012,13644,15299,28943
2018,Hidalgo,13,Calnali,13014,8865,9500,18365
2018,Hidalgo,13,Cardonal,13015,9328,10145,19473
2018,Hidalgo,13,Chapantongo,13017,6973,7334,14307
2018,Hidalgo,13,Chapulhuacán,13018,12572,12418,24990
2018,Hidalgo,13,Chilcuautla,13019,9411,9802,19213
2018,Hidalgo,13,Cuautepec de Hinojosa,13016,29074,31830,60904
2018,Hidalgo,13,El Arenal,13009,9425,10270,19695
2018,Hidalgo,13,Eloxochitlán,13020,1362,1551,2913
2018,Hidalgo,13,Emiliano Zapata,13021,7349,8094,15443
2018,Hidalgo,13,Epazoyucan,13022,7588,8024,15612
2018,Hidalgo,13,Francisco I. Madero,13023,18135,19815,37950
2018,Hidalgo,13,Huasca de Ocampo,13024,8937,9775,18712
2018,Hidalgo,13,Huautla,13025,11097,11979,23076
2018,Hidalgo,13,Huazalingo,13026,7170,7492,14662
2018,Hidalgo,13,Huehuetla,13027,13030,13833,26863
2018,Hidalgo,13,Huejutla de Reyes,13028,67583,69701,137284
2018,Hidalgo,13,Huichapan,13029,23363,25440,48803
2018,Hidalgo,13,Ixmiquilpan,13030,45966,51448,97414
2018,Hidalgo,13,Jacala de Ledezma,13031,6719,7480,14199
2018,Hidalgo,13,Jaltocán,13032,6178,6346,12524
2018,Hidalgo,13,Juárez Hidalgo,13033,1612,1744,3356
2018,Hidalgo,13,La Misión,13040,5330,5492,10822
2018,Hidalgo,13,Lolotla,13034,4976,5208,10184
2018,Hidalgo,13,Metepec,13035,5763,6519,12282
2018,Hidalgo,13,Metztitlán,13037,10393,11563,21956
2018,Hidalgo,13,Mineral de la Reforma,13051,83975,91862,175837
2018,Hidalgo,13,Mineral del Chico,13038,4544,4817,9361
2018,Hidalgo,13,Mineral del Monte,13039,7324,8053,15377
2018,Hidalgo,13,Mixquiahuala de Juárez,13041,23381,25319,48700
2018,Hidalgo,13,Molango de Escamilla,13042,6031,6266,12297
2018,Hidalgo,13,Nicolás Flores,13043,3426,3848,7274
2018,Hidalgo,13,Nopala de Villagrán,13044,8746,9045,17791
2018,Hidalgo,13,Omitlán de Juárez,13045,4901,5369,10270
2018,Hidalgo,13,Pachuca de Soto,13048,132764,145011,277775
2018,Hidalgo,13,Pacula,13047,2462,2844,5306
2018,Hidalgo,13,Pisaflores,13049,9343,9329,18672
2018,Hidalgo,13,Progreso de Obregón,13050,11753,13059,24812
2018,Hidalgo,13,San Agustín Metzquititlán,13036,4847,5302,10149
2018,Hidalgo,13,San Agustín Tlaxiaca,13052,18543,19387,37930
2018,Hidalgo,13,San Bartolo Tutotepec,13053,9837,10004,19841
2018,Hidalgo,13,San Felipe Orizatlán,13046,20407,21011,41418
2018,Hidalgo,13,San Salvador,13054,17938,19190,37128
2018,Hidalgo,13,Santiago Tulantepec de Lugo Guerrero,13056,18676,20400,39076
2018,Hidalgo,13,Santiago de Anaya,13055,8753,9205,17958
2018,Hidalgo,13,Singuilucan,13057,8359,8601,16960
2018,Hidalgo,13,Tasquillo,13058,8017,9441,17458
2018,Hidalgo,13,Tecozautla,13059,18952,20656,39608
2018,Hidalgo,13,Tenango de Doria,13060,9202,10115,19317
2018,Hidalgo,13,Tepeapulco,13061,27964,29816,57780
2018,Hidalgo,13,Tepehuacán de Guerrero,13062,16416,15845,32261
2018,Hidalgo,13,Tepeji del Río de Ocampo,13063,45127,46434,91561
2018,Hidalgo,13,Tepetitlán,13064,5597,5897,11494
2018,Hidalgo,13,Tetepango,13065,6112,6177,12289
2018,Hidalgo,13,Tezontepec de Aldama,13067,27438,28080,55518
2018,Hidalgo,13,Tianguistengo,13068,7705,8058,15763
2018,Hidalgo,13,Tizayuca,13069,64264,65896,130160
2018,Hidalgo,13,Tlahuelilpan,13070,9943,10260,20203
2018,Hidalgo,13,Tlahuiltepa,13071,5339,5428,10767
2018,Hidalgo,13,Tlanalapa,13072,5311,5653,10964
2018,Hidalgo,13,Tlanchinol,13073,20485,20845,41330
2018,Hidalgo,13,Tlaxcoapan,13074,14859,15273,30132
2018,Hidalgo,13,Tolcayuca,13075,8334,8811,17145
2018,Hidalgo,13,Tula de Allende,13076,56572,59699,116271
2018,Hidalgo,13,Tulancingo de Bravo,13077,78476,87105,165581
2018,Hidalgo,13,Villa de Tezontepec,13066,6463,6690,13153
2018,Hidalgo,13,Xochiatipan,13078,10193,10708,20901
2018,Hidalgo,13,Xochicoatlán,13079,4002,4128,8130
2018,Hidalgo,13,Yahualica,13080,12601,13099,25700
2018,Hidalgo,13,Zacualtipán de Ángeles,13081,17458,19119,36577
2018,Hidalgo,13,Zapotlán de Juárez,13082,9637,10386,20023
2018,Hidalgo,13,Zempoala,13083,23502,24814,48316
2018,Hidalgo,13,Zimapán,13084,19398,22504,41902
2018,Jalisco,14,Acatic,14001,11096,11544,22640
2018,Jalisco,14,Acatlán de Juárez,14002,12446,11543,23989
2018,Jalisco,14,Ahualulco de Mercado,14003,12020,12389,24409
2018,Jalisco,14,Amacueca,14004,2809,2958,5767
2018,Jalisco,14,Amatitán,14005,8040,8110,16150
2018,Jalisco,14,Ameca,14006,31262,32507,63769
2018,Jalisco,14,Arandas,14008,38724,41510,80234
2018,Jalisco,14,Atemajac de Brizuela,14010,3510,3555,7065
2018,Jalisco,14,Atengo,14011,3013,2794,5807
2018,Jalisco,14,Atenguillo,14012,2076,2145,4221
2018,Jalisco,14,Atotonilco el Alto,14013,31177,32294,63471
2018,Jalisco,14,Atoyac,14014,4155,4499,8654
2018,Jalisco,14,Autlán de Navarro,14015,31611,32532,64143
2018,Jalisco,14,Ayotlán,14016,19639,20543,40182
2018,Jalisco,14,Ayutla,14017,6608,6619,13227
2018,Jalisco,14,Bolaños,14019,3938,3957,7895
2018,Jalisco,14,Cabo Corrientes,14020,5668,5218,10886
2018,Jalisco,14,Casimiro Castillo,14021,11382,11422,22804
2018,Jalisco,14,Cañadas de Obregón,14117,2132,2240,4372
2018,Jalisco,14,Chapala,14030,26298,27397,53695
2018,Jalisco,14,Chimaltitán,14031,1777,1819,3596
2018,Jalisco,14,Chiquilistlán,14032,3192,3157,6349
2018,Jalisco,14,Cihuatlán,14022,21763,21212,42975
2018,Jalisco,14,Cocula,14024,13739,14453,28192
2018,Jalisco,14,Colotlán,14025,9188,9828,19016
2018,Jalisco,14,Concepción de Buenos Aires,14026,3277,3152,6429
2018,Jalisco,14,Cuautitlán de García Barragán,14027,9592,9293,18885
2018,Jalisco,14,Cuautla,14028,1091,1173,2264
2018,Jalisco,14,Cuquío,14029,9094,9933,19027
2018,Jalisco,14,Degollado,14033,10878,11617,22495
2018,Jalisco,14,Ejutla,14034,1050,988,2038
2018,Jalisco,14,El Arenal,14009,10143,10319,20462
2018,Jalisco,14,El Grullo,14037,12628,13228,25856
2018,Jalisco,14,El Limón,14054,2908,2905,5813
2018,Jalisco,14,El Salto,14070,95686,96599,192285
2018,Jalisco,14,Encarnación de Díaz,14035,27080,29137,56217
2018,Jalisco,14,Etzatlán,14036,10179,10597,20776
2018,Jalisco,14,Guachinango,14038,2275,2199,4474
2018,Jalisco,14,Guadalajara,14039,730389,768941,1499330
2018,Jalisco,14,Gómez Farías,14079,7303,7784,15087
2018,Jalisco,14,Hostotipaquillo,14040,5765,5000,10765
2018,Jalisco,14,Huejuquilla el Alto,14042,4457,4821,9278
2018,Jalisco,14,Huejúcar,14041,2897,3193,6090
2018,Jalisco,14,Ixtlahuacán de los Membrillos,14044,28121,28749,56870
2018,Jalisco,14,Ixtlahuacán del Río,14045,9749,10377,20126
2018,Jalisco,14,Jalostotitlán,14046,17405,17920,35325
2018,Jalisco,14,Jamay,14047,12956,12965,25921
2018,Jalisco,14,Jesús María,14048,9227,10898,20125
2018,Jalisco,14,Jilotlán de los Dolores,14049,5154,4936,10090
2018,Jalisco,14,Jocotepec,14050,23971,24267,48238
2018,Jalisco,14,Juanacatlán,14051,9268,9271,18539
2018,Jalisco,14,Juchitlán,14052,2872,3059,5931
2018,Jalisco,14,La Barca,14018,33366,35532,68898
2018,Jalisco,14,La Huerta,14043,12978,12564,25542
2018,Jalisco,14,La Manzanilla de la Paz,14057,1910,2067,3977
2018,Jalisco,14,Lagos de Moreno,14053,84173,87929,172102
2018,Jalisco,14,Magdalena,14055,11789,11827,23616
2018,Jalisco,14,Mascota,14058,7548,7794,15342
2018,Jalisco,14,Mazamitla,14059,7007,7596,14603
2018,Jalisco,14,Mexticacán,14060,2556,2996,5552
2018,Jalisco,14,Mezquitic,14061,9828,10381,20209
2018,Jalisco,14,Mixtlán,14062,1872,1852,3724
2018,Jalisco,14,Ocotlán,14063,51341,52928,104269
2018,Jalisco,14,Ojuelos de Jalisco,14064,16349,17118,33467
2018,Jalisco,14,Pihuamo,14065,6021,5940,11961
2018,Jalisco,14,Poncitlán,14066,26711,27389,54100
2018,Jalisco,14,Puerto Vallarta,14067,147688,144117,291805
2018,Jalisco,14,Quitupan,14069,4137,4631,8768
2018,Jalisco,14,San Cristóbal de la Barranca,14071,1576,1601,3177
2018,Jalisco,14,San Diego de Alejandría,14072,3628,3916,7544
2018,Jalisco,14,San Gabriel,14113,8294,8642,16936
2018,Jalisco,14,San Ignacio Cerro Gordo,14125,9616,10192,19808
2018,Jalisco,14,San Juan de los Lagos,14073,36015,36588,72603
2018,Jalisco,14,San Juanito de Escobedo,14007,4928,4866,9794
2018,Jalisco,14,San Julián,14074,7901,8752,16653
2018,Jalisco,14,San Marcos,14075,2030,1970,4000
2018,Jalisco,14,San Martín Hidalgo,14077,14114,14840,28954
2018,Jalisco,14,San Martín de Bolaños,14076,1649,1631,3280
2018,Jalisco,14,San Miguel el Alto,14078,16724,17622,34346
2018,Jalisco,14,San Pedro Tlaquepaque,14098,345544,348229,693773
2018,Jalisco,14,San Sebastián del Oeste,14080,3102,2821,5923
2018,Jalisco,14,Santa María de los Ángeles,14081,1617,1800,3417
2018,Jalisco,14,Santa María del Oro,14056,1138,1126,2264
2018,Jalisco,14,Sayula,14082,18708,20059,38767
2018,Jalisco,14,Tala,14083,41092,41681,82773
2018,Jalisco,14,Talpa de Allende,14084,7948,7833,15781
2018,Jalisco,14,Tamazula de Gordiano,14085,19840,20712,40552
2018,Jalisco,14,Tapalpa,14086,9924,10306,20230
2018,Jalisco,14,Tecalitlán,14087,8584,8958,17542
2018,Jalisco,14,Techaluta de Montenegro,14089,1914,1981,3895
2018,Jalisco,14,Tecolotlán,14088,9069,9045,18114
2018,Jalisco,14,Tenamaxtlán,14090,3733,3708,7441
2018,Jalisco,14,Teocaltiche,14091,20681,22729,43410
2018,Jalisco,14,Teocuitatlán de Corona,14092,5423,5627,11050
2018,Jalisco,14,Tepatitlán de Morelos,14093,73065,75736,148801
2018,Jalisco,14,Tequila,14094,21987,22188,44175
2018,Jalisco,14,Teuchitlán,14095,4932,5142,10074
2018,Jalisco,14,Tizapán el Alto,14096,10808,11355,22163
2018,Jalisco,14,Tlajomulco de Zúñiga,14097,300801,305823,606624
2018,Jalisco,14,Tolimán,14099,5301,5397,10698
2018,Jalisco,14,Tomatlán,14100,19176,18231,37407
2018,Jalisco,14,Tonalá,14101,282242,280791,563033
2018,Jalisco,14,Tonaya,14102,3092,3217,6309
2018,Jalisco,14,Tonila,14103,4112,4149,8261
2018,Jalisco,14,Totatiche,14104,2298,2322,4620
2018,Jalisco,14,Tototlán,14105,11930,12242,24172
2018,Jalisco,14,Tuxcacuesco,14106,2311,2215,4526
2018,Jalisco,14,Tuxcueca,14107,3187,3400,6587
2018,Jalisco,14,Tuxpan,14108,17762,18857,36619
2018,Jalisco,14,Unión de San Antonio,14109,9084,9751,18835
2018,Jalisco,14,Unión de Tula,14110,6908,7384,14292
2018,Jalisco,14,Valle de Guadalupe,14111,3648,3686,7334
2018,Jalisco,14,Valle de Juárez,14112,2839,3000,5839
2018,Jalisco,14,Villa Corona,14114,9226,9480,18706
2018,Jalisco,14,Villa Guerrero,14115,2855,2945,5800
2018,Jalisco,14,Villa Hidalgo,14116,10301,10980,21281
2018,Jalisco,14,Villa Purificación,14068,5980,5594,11574
2018,Jalisco,14,Yahualica de González Gallo,14118,11385,12437,23822
2018,Jalisco,14,Zacoalco de Torres,14119,14823,15079,29902
2018,Jalisco,14,Zapopan,14120,692072,713144,1405216
2018,Jalisco,14,Zapotiltic,14121,15130,15773,30903
2018,Jalisco,14,Zapotitlán de Vadillo,14122,3686,3661,7347
2018,Jalisco,14,Zapotlanejo,14124,34987,36016,71003
2018,Jalisco,14,Zapotlán del Rey,14123,9465,9532,18997
2018,Jalisco,14,Zapotlán el Grande,14023,54597,57268,111865
2018,Michoacán,16,Acuitzio,16001,5704,6150,11854
2018,Michoacán,16,Aguililla,16002,7869,7709,15578
2018,Michoacán,16,Angamacutiro,16004,7379,8202,15581
2018,Michoacán,16,Angangueo,16005,5640,5970,11610
2018,Michoacán,16,Apatzingán,16006,65902,66933,132835
2018,Michoacán,16,Aporo,16007,1636,1743,3379
2018,Michoacán,16,Aquila,16008,13080,12626,25706
2018,Michoacán,16,Ario,16009,18509,19504,38013
2018,Michoacán,16,Arteaga,16010,11329,11410,22739
2018,Michoacán,16,Briseñas,16011,5719,6026,11745
2018,Michoacán,16,Buenavista,16012,24701,23750,48451
2018,Michoacán,16,Carácuaro,16013,4837,4819,9656
2018,Michoacán,16,Charapan,16021,6024,6818,12842
2018,Michoacán,16,Charo,16022,11943,11055,22998
2018,Michoacán,16,Chavinda,16023,5177,5476,10653
2018,Michoacán,16,Cherán,16024,9488,10205,19693
2018,Michoacán,16,Chilchota,16025,19387,20892,40279
2018,Michoacán,16,Chinicuila,16026,2655,2447,5102
2018,Michoacán,16,Chucándiro,16027,2133,2560,4693
2018,Michoacán,16,Churintzio,16028,2489,2836,5325
2018,Michoacán,16,Churumuco,16029,7859,7863,15722
2018,Michoacán,16,Coahuayana,16014,7730,7186,14916
2018,Michoacán,16,Coalcomán de Vázquez Pallares,16015,9180,9390,18570
2018,Michoacán,16,Coeneo,16016,9874,11616,21490
2018,Michoacán,16,Cojumatlán de Régules,16074,5282,5517,10799
2018,Michoacán,16,Contepec,16017,17254,18236,35490
2018,Michoacán,16,Copándaro,16018,4426,4973,9399
2018,Michoacán,16,Cotija,16019,9334,10359,19693
2018,Michoacán,16,Cuitzeo,16020,14651,16207,30858
2018,Michoacán,16,Ecuandureo,16030,6000,7150,13150
2018,Michoacán,16,Epitacio Huerta,16031,8482,8874,17356
2018,Michoacán,16,Erongarícuaro,16032,7653,8205,15858
2018,Michoacán,16,Gabriel Zamora,16033,11726,11798,23524
2018,Michoacán,16,Hidalgo,16034,62096,65494,127590
2018,Michoacán,16,Huandacareo,16036,5741,6579,12320
2018,Michoacán,16,Huaniqueo,16037,3797,4523,8320
2018,Michoacán,16,Huetamo,16038,20839,21796,42635
2018,Michoacán,16,Huiramba,16039,4455,4619,9074
2018,Michoacán,16,Indaparapeo,16040,8454,9000,17454
2018,Michoacán,16,Irimbo,16041,7458,8203,15661
2018,Michoacán,16,Ixtlán,16042,6622,6863,13485
2018,Michoacán,16,Jacona,16043,34893,36857,71750
2018,Michoacán,16,Jiménez,16044,6319,6938,13257
2018,Michoacán,16,Jiquilpan,16045,16465,18132,34597
2018,Michoacán,16,José Sixto Verduzco,16113,12862,14305,27167
2018,Michoacán,16,Jungapeo,16047,10961,11145,22106
2018,Michoacán,16,Juárez,16046,7311,7694,15005
2018,Michoacán,16,La Huacana,16035,17517,17726,35243
2018,Michoacán,16,La Piedad,16069,52009,56603,108612
2018,Michoacán,16,Lagunillas,16048,2837,2946,5783
2018,Michoacán,16,Los Reyes,16075,34992,36585,71577
2018,Michoacán,16,Lázaro Cárdenas,16052,95853,94875,190728
2018,Michoacán,16,Madero,16049,9339,9217,18556
2018,Michoacán,16,Maravatío,16050,43609,47148,90757
2018,Michoacán,16,Marcos Castellanos,16051,6865,7374,14239
2018,Michoacán,16,Morelia,16053,392134,420689,812823
2018,Michoacán,16,Morelos,16054,3581,4372,7953
2018,Michoacán,16,Múgica,16055,23447,23937,47384
2018,Michoacán,16,Nahuatzen,16056,14297,15173,29470
2018,Michoacán,16,Nocupétaro,16057,4174,4252,8426
2018,Michoacán,16,Nuevo Parangaricutiro,16058,10022,10433,20455
2018,Michoacán,16,Nuevo Urecho,16059,4212,4216,8428
2018,Michoacán,16,Numarán,16060,4854,5350,10204
2018,Michoacán,16,Ocampo,16061,12548,12554,25102
2018,Michoacán,16,Pajacuarán,16062,9756,10459,20215
2018,Michoacán,16,Panindícuaro,16063,7713,8721,16434
2018,Michoacán,16,Paracho,16065,18452,20229,38681
2018,Michoacán,16,Parácuaro,16064,13931,13672,27603
2018,Michoacán,16,Penjamillo,16067,8199,9419,17618
2018,Michoacán,16,Peribán,16068,14409,14298,28707
2018,Michoacán,16,Puruándiro,16071,33059,37032,70091
2018,Michoacán,16,Purépero,16070,7841,8215,16056
2018,Michoacán,16,Pátzcuaro,16066,46409,50248,96657
2018,Michoacán,16,Queréndaro,16072,6935,7312,14247
2018,Michoacán,16,Quiroga,16073,13684,14952,28636
2018,Michoacán,16,Sahuayo,16076,38999,40806,79805
2018,Michoacán,16,Salvador Escalante,16079,24597,26070,50667
2018,Michoacán,16,San Lucas,16077,9317,9499,18816
2018,Michoacán,16,Santa Ana Maya,16078,6069,6953,13022
2018,Michoacán,16,Senguio,16080,9525,10169,19694
2018,Michoacán,16,Susupuato,16081,4503,4581,9084
2018,Michoacán,16,Tacámbaro,16082,38743,40495,79238
2018,Michoacán,16,Tancítaro,16083,16271,15935,32206
2018,Michoacán,16,Tangamandapio,16084,14666,15834,30500
2018,Michoacán,16,Tangancícuaro,16085,16878,17997,34875
2018,Michoacán,16,Tanhuato,16086,7856,8280,16136
2018,Michoacán,16,Taretan,16087,7501,7698,15199
2018,Michoacán,16,Tarímbaro,16088,54331,58805,113136
2018,Michoacán,16,Tepalcatepec,16089,12476,12200,24676
2018,Michoacán,16,Tingambato,16090,7575,8025,15600
2018,Michoacán,16,Tingüindín,16091,7232,7832,15064
2018,Michoacán,16,Tiquicheo de Nicolás Romero,16092,7009,7130,14139
2018,Michoacán,16,Tlalpujahua,16093,14185,15725,29910
2018,Michoacán,16,Tlazazalca,16094,3196,3429,6625
2018,Michoacán,16,Tocumbo,16095,6121,6256,12377
2018,Michoacán,16,Tumbiscatío,16096,3667,3539,7206
2018,Michoacán,16,Turicato,16097,15915,16763,32678
2018,Michoacán,16,Tuxpan,16098,13608,14620,28228
2018,Michoacán,16,Tuzantla,16099,7955,8070,16025
2018,Michoacán,16,Tzintzuntzan,16100,7061,7834,14895
2018,Michoacán,16,Tzitzio,16101,4623,4505,9128
2018,Michoacán,16,Uruapan,16102,169434,179270,348704
2018,Michoacán,16,Venustiano Carranza,16103,12564,13066,25630
2018,Michoacán,16,Villamar,16104,8324,9082,17406
2018,Michoacán,16,Vista Hermosa,16105,10447,10827,21274
2018,Michoacán,16,Yurécuaro,16106,15876,16712,32588
2018,Michoacán,16,Zacapu,16107,38142,40936,79078
2018,Michoacán,16,Zamora,16108,99559,105248,204807
2018,Michoacán,16,Zinapécuaro,16110,23547,25546,49093
2018,Michoacán,16,Zináparo,16109,1521,1796,3317
2018,Michoacán,16,Ziracuaretiro,16111,8822,9020,17842
2018,Michoacán,16,Zitácuaro,16112,81408,88209,169617
2018,Michoacán,16,Álvaro Obregón,16003,10858,11676,22534
2018,Morelos,17,Amacuzac,17001,9033,9511,18544
2018,Morelos,17,Atlatlahucan,17002,11395,11887,23282
2018,Morelos,17,Axochiapan,17003,18423,18993,37416
2018,Morelos,17,Ayala,17004,43052,45962,89014
2018,Morelos,17,Coatlán del Río,17005,5048,5207,10255
2018,Morelos,17,Cuautla,17006,97925,105240,203165
2018,Morelos,17,Cuernavaca,17007,185696,207911,393607
2018,Morelos,17,Emiliano Zapata,17008,50552,52287,102839
2018,Morelos,17,Huitzilac,17009,9917,9969,19886
2018,Morelos,17,Jantetelco,17010,8742,9151,17893
2018,Morelos,17,Jiutepec,17011,108384,115302,223686
2018,Morelos,17,Jojutla,17012,29126,31212,60338
2018,Morelos,17,Jonacatepec,17013,7887,8522,16409
2018,Morelos,17,Mazatepec,17014,5131,5361,10492
2018,Morelos,17,Miacatlán,17015,13500,14246,27746
2018,Morelos,17,Ocuituco,17016,9478,9741,19219
2018,Morelos,17,Puente de Ixtla,17017,34009,35385,69394
2018,Morelos,17,Temixco,17018,59327,62035,121362
2018,Morelos,17,Temoac,17033,7999,8492,16491
2018,Morelos,17,Tepalcingo,17019,13828,14474,28302
2018,Morelos,17,Tepoztlán,17020,24380,25222,49602
2018,Morelos,17,Tetecala,17021,4061,4091,8152
2018,Morelos,17,Tetela del Volcán,17022,10433,11064,21497
2018,Morelos,17,Tlalnepantla,17023,3808,3715,7523
2018,Morelos,17,Tlaltizapán de Zapata,17024,26556,27915,54471
2018,Morelos,17,Tlaquiltenango,17025,17475,17933,35408
2018,Morelos,17,Tlayacapan,17026,9240,9428,18668
2018,Morelos,17,Totolapan,17027,6165,6332,12497
2018,Morelos,17,Xochitepec,17028,36766,35848,72614
2018,Morelos,17,Yautepec,17029,52426,55269,107695
2018,Morelos,17,Yecapixtla,17030,27010,27644,54654
2018,Morelos,17,Zacatepec,17031,18495,19968,38463
2018,Morelos,17,Zacualpan,17032,4857,5086,9943
2018,Nayarit,18,Acaponeta,18001,19940,19811,39751
2018,Nayarit,18,Ahuacatlán,18002,8467,8395,16862
2018,Nayarit,18,Amatlán de Cañas,18003,6338,6121,12459
2018,Nayarit,18,Bahía de Banderas,18020,84305,81293,165598
2018,Nayarit,18,Compostela,18004,40124,39800,79924
2018,Nayarit,18,Del Nayar,18009,21984,21859,43843
2018,Nayarit,18,Huajicori,18005,6740,6468,13208
2018,Nayarit,18,Ixtlán del Río,18006,15060,15995,31055
2018,Nayarit,18,Jala,18007,9725,9883,19608
2018,Nayarit,18,La Yesca,18019,7577,7195,14772
2018,Nayarit,18,Rosamorada,18010,18651,17851,36502
2018,Nayarit,18,Ruíz,18011,13311,12966,26277
2018,Nayarit,18,San Blas,18012,24706,22217,46923
2018,Nayarit,18,San Pedro Lagunillas,18013,4096,3984,8080
2018,Nayarit,18,Santa María del Oro,18014,12845,12207,25052
2018,Nayarit,18,Santiago Ixcuintla,18015,52683,50927,103610
2018,Nayarit,18,Tecuala,18016,21534,20802,42336
2018,Nayarit,18,Tepic,18017,212135,221599,433734
2018,Nayarit,18,Tuxpan,18018,16301,16414,32715
2018,Nayarit,18,Xalisco,18008,29450,30604,60054
2018,Nuevo León,19,Abasolo,19001,1458,1452,2910
2018,Nuevo León,19,Agualeguas,19002,1361,1298,2659
2018,Nuevo León,19,Allende,19004,18817,18478,37295
2018,Nuevo León,19,Anáhuac,19005,9846,9895,19741
2018,Nuevo León,19,Apodaca,19006,323338,318280,641618
2018,Nuevo León,19,Aramberri,19007,8793,8593,17386
2018,Nuevo León,19,Bustamante,19008,2141,2135,4276
2018,Nuevo León,19,Cadereyta Jiménez,19009,52551,49742,102293
2018,Nuevo León,19,Cerralvo,19011,4292,4032,8324
2018,Nuevo León,19,China,19013,6035,5736,11771
2018,Nuevo León,19,Ciénega de Flores,19012,24182,23310,47492
2018,Nuevo León,19,Doctor Arroyo,19014,18754,18464,37218
2018,Nuevo León,19,Doctor Coss,19015,927,882,1809
2018,Nuevo León,19,Doctor González,19016,1670,1592,3262
2018,Nuevo León,19,El Carmen,19010,22266,21846,44112
2018,Nuevo León,19,Galeana,19017,22338,21816,44154
2018,Nuevo León,19,García,19018,140614,139449,280063
2018,Nuevo León,19,General Bravo,19020,3089,2912,6001
2018,Nuevo León,19,General Escobedo,19021,226202,224936,451138
2018,Nuevo León,19,General Terán,19022,7969,8002,15971
2018,Nuevo León,19,General Treviño,19023,590,610,1200
2018,Nuevo León,19,General Zaragoza,19024,3357,3129,6486
2018,Nuevo León,19,General Zuazua,19025,43207,42515,85722
2018,Nuevo León,19,Guadalupe,19026,356660,346152,702812
2018,Nuevo León,19,Hidalgo,19047,7978,7891,15869
2018,Nuevo León,19,Higueras,19028,875,810,1685
2018,Nuevo León,19,Hualahuises,19029,3755,3833,7588
2018,Nuevo León,19,Iturbide,19030,2023,1878,3901
2018,Nuevo León,19,Juárez,19031,188783,184942,373725
2018,Nuevo León,19,Lampazos de Naranjo,19032,2869,2792,5661
2018,Nuevo León,19,Linares,19033,43269,43451,86720
2018,Nuevo León,19,Los Aldamas,19003,745,725,1470
2018,Nuevo León,19,Los Herreras,19027,981,1001,1982
2018,Nuevo León,19,Los Ramones,19042,2645,2572,5217
2018,Nuevo León,19,Marín,19034,3152,2951,6103
2018,Nuevo León,19,Melchor Ocampo,19035,532,515,1047
2018,Nuevo León,19,Mier y Noriega,19036,3798,3721,7519
2018,Nuevo León,19,Mina,19037,2977,2838,5815
2018,Nuevo León,19,Montemorelos,19038,33086,32963,66049
2018,Nuevo León,19,Monterrey,19039,543459,563358,1106817
2018,Nuevo León,19,Parás,19040,545,534,1079
2018,Nuevo León,19,Pesquería,19041,52442,52200,104642
2018,Nuevo León,19,Rayones,19043,1507,1405,2912
2018,Nuevo León,19,Sabinas Hidalgo,19044,18922,19424,38346
2018,Nuevo León,19,Salinas Victoria,19045,29992,28754,58746
2018,Nuevo León,19,San Nicolás de los Garza,19046,233466,239871,473337
2018,Nuevo León,19,San Pedro Garza García,19019,63977,71532,135509
2018,Nuevo León,19,Santa Catarina,19048,158447,156610,315057
2018,Nuevo León,19,Santiago,19049,23100,22831,45931
2018,Nuevo León,19,Vallecillo,19050,1033,875,1908
2018,Nuevo León,19,Villaldama,19051,2261,2239,4500
2018,Oaxaca,20,Abejones,20001,461,598,1059
2018,Oaxaca,20,Acatlán de Pérez Figueroa,20002,23122,24169,47291
2018,Oaxaca,20,Asunción Cacalotepec,20003,1064,1135,2199
2018,Oaxaca,20,Asunción Cuyotepeji,20004,474,543,1017
2018,Oaxaca,20,Asunción Ixtaltepec,20005,7820,7901,15721
2018,Oaxaca,20,Asunción Nochixtlán,20006,9103,10169,19272
2018,Oaxaca,20,Asunción Ocotlán,20007,1151,1428,2579
2018,Oaxaca,20,Asunción Tlacolulita,20008,390,407,797
2018,Oaxaca,20,Ayoquezco de Aldama,20398,2094,2368,4462
2018,Oaxaca,20,Ayotzintepec,20009,3648,3700,7348
2018,Oaxaca,20,Calihualá,20011,585,615,1200
2018,Oaxaca,20,Candelaria Loxicha,20012,5174,5503,10677
2018,Oaxaca,20,Capulálpam de Méndez,20247,714,879,1593
2018,Oaxaca,20,Chahuites,20025,5891,5977,11868
2018,Oaxaca,20,Chalcatongo de Hidalgo,20026,4326,4936,9262
2018,Oaxaca,20,Chiquihuitlán de Benito Juárez,20027,1107,1303,2410
2018,Oaxaca,20,Ciudad Ixtepec,20014,14271,15515,29786
2018,Oaxaca,20,Ciénega de Zimatlán,20013,1451,1596,3047
2018,Oaxaca,20,Coatecas Altas,20015,2283,2546,4829
2018,Oaxaca,20,Coicoyán de las Flores,20016,4744,5350,10094
2018,Oaxaca,20,Concepción Buenavista,20018,404,427,831
2018,Oaxaca,20,Concepción Pápalo,20019,1536,1531,3067
2018,Oaxaca,20,Constancia del Rosario,20020,1878,2181,4059
2018,Oaxaca,20,Cosolapa,20021,7770,8360,16130
2018,Oaxaca,20,Cosoltepec,20022,369,433,802
2018,Oaxaca,20,Cuilápam de Guerrero,20023,10708,11359,22067
2018,Oaxaca,20,Cuyamecalco Villa de Zaragoza,20024,1925,1884,3809
2018,Oaxaca,20,El Barrio de la Soledad,20010,7138,7663,14801
2018,Oaxaca,20,El Espinal,20030,4420,4612,9032
2018,Oaxaca,20,Eloxochitlán de Flores Magón,20029,2080,2317,4397
2018,Oaxaca,20,Fresnillo de Trujano,20032,500,543,1043
2018,Oaxaca,20,Guadalupe Etla,20033,1310,1460,2770
2018,Oaxaca,20,Guadalupe de Ramírez,20034,648,672,1320
2018,Oaxaca,20,Guelatao de Juárez,20035,287,290,577
2018,Oaxaca,20,Guevea de Humboldt,20036,2688,2802,5490
2018,Oaxaca,20,Heroica Ciudad de Ejutla de Crespo,20028,10141,11335,21476
2018,Oaxaca,20,Heroica Ciudad de Huajuapan de León,20039,37572,41841,79413
2018,Oaxaca,20,Heroica Ciudad de Juchitán de Zaragoza,20043,49727,52155,101882
2018,Oaxaca,20,Heroica Ciudad de Tlaxiaco,20397,19697,22243,41940
2018,Oaxaca,20,Huautepec,20040,3007,3425,6432
2018,Oaxaca,20,Huautla de Jiménez,20041,15147,17325,32472
2018,Oaxaca,20,Ixpantepec Nieves,20065,537,666,1203
2018,Oaxaca,20,Ixtlán de Juárez,20042,4147,4280,8427
2018,Oaxaca,20,La Compañía,20017,1615,1790,3405
2018,Oaxaca,20,La Pe,20069,1296,1398,2694
2018,Oaxaca,20,La Reforma,20076,1577,1745,3322
2018,Oaxaca,20,La Trinidad Vista Hermosa,20556,117,143,260
2018,Oaxaca,20,Loma Bonita,20044,21088,23087,44175
2018,Oaxaca,20,Magdalena Apasco,20045,4258,4729,8987
2018,Oaxaca,20,Magdalena Jaltepec,20046,1531,1789,3320
2018,Oaxaca,20,Magdalena Mixtepec,20048,682,703,1385
2018,Oaxaca,20,Magdalena Ocotlán,20049,572,626,1198
2018,Oaxaca,20,Magdalena Peñasco,20050,1692,1953,3645
2018,Oaxaca,20,Magdalena Teitipac,20051,2285,2451,4736
2018,Oaxaca,20,Magdalena Tequisistlán,20052,3086,3237,6323
2018,Oaxaca,20,Magdalena Tlacotepec,20053,616,673,1289
2018,Oaxaca,20,Magdalena Yodocono de Porfirio Díaz,20562,762,808,1570
2018,Oaxaca,20,Magdalena Zahuatlán,20054,199,228,427
2018,Oaxaca,20,Mariscala de Juárez,20055,1741,1892,3633
2018,Oaxaca,20,Matías Romero Avendaño,20057,19569,21049,40618
2018,Oaxaca,20,Mazatlán Villa de Flores,20058,6719,6805,13524
2018,Oaxaca,20,Mesones Hidalgo,20037,2071,2440,4511
2018,Oaxaca,20,Miahuatlán de Porfirio Díaz,20059,21374,23356,44730
2018,Oaxaca,20,Mixistlán de la Reforma,20060,1280,1430,2710
2018,Oaxaca,20,Monjas,20061,1275,1506,2781
2018,Oaxaca,20,Mártires de Tacubaya,20056,707,765,1472
2018,Oaxaca,20,Natividad,20062,285,323,608
2018,Oaxaca,20,Nazareno Etla,20063,1986,2193,4179
2018,Oaxaca,20,Nejapa de Madero,20064,3764,3918,7682
2018,Oaxaca,20,Nuevo Zoquiápam,20504,804,876,1680
2018,Oaxaca,20,Oaxaca de Juárez,20067,121351,137441,258792
2018,Oaxaca,20,Ocotlán de Morelos,20068,10854,11827,22681
2018,Oaxaca,20,Pinotepa de Don Luis,20070,3530,3622,7152
2018,Oaxaca,20,Pluma Hidalgo,20071,1471,1544,3015
2018,Oaxaca,20,Putla Villa de Guerrero,20073,16007,18058,34065
2018,Oaxaca,20,Reforma de Pineda,20075,1391,1478,2869
2018,Oaxaca,20,Reyes Etla,20077,1928,2060,3988
2018,Oaxaca,20,Rojas de Cuauhtémoc,20078,545,603,1148
2018,Oaxaca,20,Salina Cruz,20079,43996,47484,91480
2018,Oaxaca,20,San Agustín Amatengo,20080,686,785,1471
2018,Oaxaca,20,San Agustín Atenango,20081,841,979,1820
2018,Oaxaca,20,San Agustín Chayuco,20082,1964,2178,4142
2018,Oaxaca,20,San Agustín Etla,20084,1998,2197,4195
2018,Oaxaca,20,San Agustín Loxicha,20085,12365,12864,25229
2018,Oaxaca,20,San Agustín Tlacotepec,20086,415,551,966
2018,Oaxaca,20,San Agustín Yatareni,20087,2108,2407,4515
2018,Oaxaca,20,San Agustín de las Juntas,20083,4810,5008,9818
2018,Oaxaca,20,San Andrés Cabecera Nueva,20088,1409,1448,2857
2018,Oaxaca,20,San Andrés Dinicuiti,20089,1068,1133,2201
2018,Oaxaca,20,San Andrés Huaxpaltepec,20090,3080,3254,6334
2018,Oaxaca,20,San Andrés Huayápam,20091,2657,2910,5567
2018,Oaxaca,20,San Andrés Ixtlahuaca,20092,763,871,1634
2018,Oaxaca,20,San Andrés Lagunas,20093,235,271,506
2018,Oaxaca,20,San Andrés Nuxiño,20094,879,954,1833
2018,Oaxaca,20,San Andrés Paxtlán,20095,2217,2230,4447
2018,Oaxaca,20,San Andrés Sinaxtla,20096,361,406,767
2018,Oaxaca,20,San Andrés Solaga,20097,859,908,1767
2018,Oaxaca,20,San Andrés Teotilálpam,20098,2204,2374,4578
2018,Oaxaca,20,San Andrés Tepetlapa,20099,242,277,519
2018,Oaxaca,20,San Andrés Yaá,20100,206,251,457
2018,Oaxaca,20,San Andrés Zabache,20101,328,412,740
2018,Oaxaca,20,San Andrés Zautla,20102,2301,2438,4739
2018,Oaxaca,20,San Antonino Castillo Velasco,20103,2964,3251,6215
2018,Oaxaca,20,San Antonino Monte Verde,20105,3412,3968,7380
2018,Oaxaca,20,San Antonino el Alto,20104,1343,1390,2733
2018,Oaxaca,20,San Antonio Acutla,20106,124,150,274
2018,Oaxaca,20,San Antonio Huitepec,20108,2098,2429,4527
2018,Oaxaca,20,San Antonio Nanahuatípam,20109,634,644,1278
2018,Oaxaca,20,San Antonio Sinicahua,20110,749,867,1616
2018,Oaxaca,20,San Antonio Tepetlapa,20111,2124,2295,4419
2018,Oaxaca,20,San Antonio de la Cal,20107,11823,13147,24970
2018,Oaxaca,20,San Baltazar Chichicápam,20112,1218,1390,2608
2018,Oaxaca,20,San Baltazar Loxicha,20113,1489,1562,3051
2018,Oaxaca,20,San Baltazar Yatzachi el Bajo,20114,319,358,677
2018,Oaxaca,20,San Bartolo Coyotepec,20115,4713,5207,9920
2018,Oaxaca,20,San Bartolo Soyaltepec,20121,297,375,672
2018,Oaxaca,20,San Bartolo Yautepec,20122,334,341,675
2018,Oaxaca,20,San Bartolomé Ayautla,20116,2231,2363,4594
2018,Oaxaca,20,San Bartolomé Loxicha,20117,1208,1240,2448
2018,Oaxaca,20,San Bartolomé Quialana,20118,1059,1487,2546
2018,Oaxaca,20,San Bartolomé Yucuañe,20119,162,233,395
2018,Oaxaca,20,San Bartolomé Zoogocho,20120,139,188,327
2018,Oaxaca,20,San Bernardo Mixtepec,20123,1324,1449,2773
2018,Oaxaca,20,San Blas Atempa,20124,9470,9382,18852
2018,Oaxaca,20,San Carlos Yautepec,20125,6215,6156,12371
2018,Oaxaca,20,San Cristóbal Amatlán,20126,2499,2824,5323
2018,Oaxaca,20,San Cristóbal Amoltepec,20127,532,627,1159
2018,Oaxaca,20,San Cristóbal Lachirioag,20128,611,670,1281
2018,Oaxaca,20,San Cristóbal Suchixtlahuaca,20129,178,189,367
2018,Oaxaca,20,San Dionisio Ocotepec,20131,5150,5869,11019
2018,Oaxaca,20,San Dionisio Ocotlán,20132,587,608,1195
2018,Oaxaca,20,San Dionisio del Mar,20130,2733,2623,5356
2018,Oaxaca,20,San Esteban Atatlahuca,20133,1891,1979,3870
2018,Oaxaca,20,San Felipe Jalapa de Díaz,20134,13971,14848,28819
2018,Oaxaca,20,San Felipe Tejalápam,20135,3832,4194,8026
2018,Oaxaca,20,San Felipe Usila,20136,5770,6243,12013
2018,Oaxaca,20,San Francisco Cahuacuá,20137,1733,1759,3492
2018,Oaxaca,20,San Francisco Cajonos,20138,207,236,443
2018,Oaxaca,20,San Francisco Chapulapa,20139,1027,1105,2132
2018,Oaxaca,20,San Francisco Chindúa,20140,406,428,834
2018,Oaxaca,20,San Francisco Huehuetlán,20142,493,619,1112
2018,Oaxaca,20,San Francisco Ixhuatán,20143,4601,4694,9295
2018,Oaxaca,20,San Francisco Jaltepetongo,20144,499,518,1017
2018,Oaxaca,20,San Francisco Lachigoló,20145,2137,2225,4362
2018,Oaxaca,20,San Francisco Logueche,20146,1384,1571,2955
2018,Oaxaca,20,San Francisco Nuxaño,20147,197,186,383
2018,Oaxaca,20,San Francisco Ozolotepec,20148,957,1013,1970
2018,Oaxaca,20,San Francisco Sola,20149,823,916,1739
2018,Oaxaca,20,San Francisco Telixtlahuaca,20150,6387,6845,13232
2018,Oaxaca,20,San Francisco Teopan,20151,183,165,348
2018,Oaxaca,20,San Francisco Tlapancingo,20152,1035,1283,2318
2018,Oaxaca,20,San Francisco del Mar,20141,4039,3930,7969
2018,Oaxaca,20,San Gabriel Mixtepec,20153,2423,2584,5007
2018,Oaxaca,20,San Ildefonso Amatlán,20154,1178,1348,2526
2018,Oaxaca,20,San Ildefonso Sola,20155,501,492,993
2018,Oaxaca,20,San Ildefonso Villa Alta,20156,1704,1806,3510
2018,Oaxaca,20,San Jacinto Amilpas,20157,8431,9297,17728
2018,Oaxaca,20,San Jacinto Tlacotepec,20158,1105,1171,2276
2018,Oaxaca,20,San Jerónimo Coatlán,20159,2671,2824,5495
2018,Oaxaca,20,San Jerónimo Silacayoapilla,20160,702,740,1442
2018,Oaxaca,20,San Jerónimo Sosola,20161,1257,1408,2665
2018,Oaxaca,20,San Jerónimo Taviche,20162,946,1034,1980
2018,Oaxaca,20,San Jerónimo Tecóatl,20163,780,877,1657
2018,Oaxaca,20,San Jerónimo Tlacochahuaya,20550,2659,3001,5660
2018,Oaxaca,20,San Jorge Nuchita,20164,1357,1592,2949
2018,Oaxaca,20,San José Ayuquila,20165,726,847,1573
2018,Oaxaca,20,San José Chiltepec,20166,6001,6367,12368
2018,Oaxaca,20,San José Estancia Grande,20168,534,542,1076
2018,Oaxaca,20,San José Independencia,20169,1853,1996,3849
2018,Oaxaca,20,San José Lachiguiri,20170,1624,1996,3620
2018,Oaxaca,20,San José Tenango,20171,9122,9811,18933
2018,Oaxaca,20,San José del Peñasco,20167,1071,1109,2180
2018,Oaxaca,20,San José del Progreso,20072,3398,3611,7009
2018,Oaxaca,20,San Juan Achiutla,20172,203,212,415
2018,Oaxaca,20,San Juan Atepec,20173,715,805,1520
2018,Oaxaca,20,San Juan Bautista Atatlahuca,20175,797,847,1644
2018,Oaxaca,20,San Juan Bautista Coixtlahuaca,20176,1320,1455,2775
2018,Oaxaca,20,San Juan Bautista Cuicatlán,20177,4970,5261,10231
2018,Oaxaca,20,San Juan Bautista Guelache,20178,3582,3993,7575
2018,Oaxaca,20,San Juan Bautista Jayacatlán,20179,765,754,1519
2018,Oaxaca,20,San Juan Bautista Lo de Soto,20180,1290,1313,2603
2018,Oaxaca,20,San Juan Bautista Suchitepec,20181,206,246,452
2018,Oaxaca,20,San Juan Bautista Tlachichilco,20183,666,775,1441
2018,Oaxaca,20,San Juan Bautista Tlacoatzintepec,20182,1071,1189,2260
2018,Oaxaca,20,San Juan Bautista Tuxtepec,20184,81084,87676,168760
2018,Oaxaca,20,San Juan Bautista Valle Nacional,20559,11124,12158,23282
2018,Oaxaca,20,San Juan Cacahuatepec,20185,4473,4688,9161
2018,Oaxaca,20,San Juan Chicomezúchil,20191,156,184,340
2018,Oaxaca,20,San Juan Chilateca,20192,722,839,1561
2018,Oaxaca,20,San Juan Cieneguilla,20186,282,308,590
2018,Oaxaca,20,San Juan Coatzóspam,20187,1115,1093,2208
2018,Oaxaca,20,San Juan Colorado,20188,4954,5255,10209
2018,Oaxaca,20,San Juan Comaltepec,20189,1409,1480,2889
2018,Oaxaca,20,San Juan Cotzocón,20190,11839,12474,24313
2018,Oaxaca,20,San Juan Diuxi,20195,560,572,1132
2018,Oaxaca,20,San Juan Evangelista Analco,20196,207,220,427
2018,Oaxaca,20,San Juan Guelavía,20197,1631,1727,3358
2018,Oaxaca,20,San Juan Guichicovi,20198,14338,16157,30495
2018,Oaxaca,20,San Juan Ihualtepec,20199,297,348,645
2018,Oaxaca,20,San Juan Juquila Mixes,20200,1859,2076,3935
2018,Oaxaca,20,San Juan Juquila Vijanos,20201,961,1044,2005
2018,Oaxaca,20,San Juan Lachao,20202,2379,2533,4912
2018,Oaxaca,20,San Juan Lachigalla,20203,1652,1762,3414
2018,Oaxaca,20,San Juan Lajarcia,20204,303,370,673
2018,Oaxaca,20,San Juan Lalana,20205,8579,8990,17569
2018,Oaxaca,20,San Juan Mazatlán,20207,9443,9585,19028
2018,Oaxaca,20,San Juan Mixtepec Distrito 08,20208,3334,3824,7158
2018,Oaxaca,20,San Juan Mixtepec Distrito 26,20209,297,420,717
2018,Oaxaca,20,San Juan Ozolotepec,20211,1418,1400,2818
2018,Oaxaca,20,San Juan Petlapa,20212,1458,1557,3015
2018,Oaxaca,20,San Juan Quiahije,20213,1952,2216,4168
2018,Oaxaca,20,San Juan Quiotepec,20214,1060,1096,2156
2018,Oaxaca,20,San Juan Sayultepec,20215,380,444,824
2018,Oaxaca,20,San Juan Tabaá,20216,647,709,1356
2018,Oaxaca,20,San Juan Tamazola,20217,1517,1592,3109
2018,Oaxaca,20,San Juan Teita,20218,303,319,622
2018,Oaxaca,20,San Juan Teitipac,20219,1288,1410,2698
2018,Oaxaca,20,San Juan Tepeuxila,20220,1426,1340,2766
2018,Oaxaca,20,San Juan Teposcolula,20221,632,670,1302
2018,Oaxaca,20,San Juan Yaeé,20222,732,826,1558
2018,Oaxaca,20,San Juan Yatzona,20223,217,275,492
2018,Oaxaca,20,San Juan Yucuita,20224,283,339,622
2018,Oaxaca,20,San Juan de los Cués,20206,1237,1262,2499
2018,Oaxaca,20,San Juan del Estado,20193,1307,1415,2722
2018,Oaxaca,20,San Juan del Río,20194,592,714,1306
2018,Oaxaca,20,San Juan Ñumí,20210,2888,3296,6184
2018,Oaxaca,20,San Lorenzo,20225,3038,3273,6311
2018,Oaxaca,20,San Lorenzo Albarradas,20226,1438,1402,2840
2018,Oaxaca,20,San Lorenzo Cacaotepec,20227,7756,8431,16187
2018,Oaxaca,20,San Lorenzo Cuaunecuiltitla,20228,438,396,834
2018,Oaxaca,20,San Lorenzo Texmelúcan,20229,3868,4483,8351
2018,Oaxaca,20,San Lorenzo Victoria,20230,490,510,1000
2018,Oaxaca,20,San Lucas Camotlán,20231,1516,1610,3126
2018,Oaxaca,20,San Lucas Ojitlán,20232,10236,10875,21111
2018,Oaxaca,20,San Lucas Quiaviní,20233,746,1049,1795
2018,Oaxaca,20,San Lucas Zoquiápam,20234,3729,3938,7667
2018,Oaxaca,20,San Luis Amatlán,20235,1725,2027,3752
2018,Oaxaca,20,San Marcial Ozolotepec,20236,742,817,1559
2018,Oaxaca,20,San Marcos Arteaga,20237,683,789,1472
2018,Oaxaca,20,San Martín Huamelúlpam,20239,494,585,1079
2018,Oaxaca,20,San Martín Itunyoso,20240,1048,1318,2366
2018,Oaxaca,20,San Martín Lachilá,20241,493,617,1110
2018,Oaxaca,20,San Martín Peras,20242,6035,6459,12494
2018,Oaxaca,20,San Martín Tilcajete,20243,834,1033,1867
2018,Oaxaca,20,San Martín Toxpalan,20244,1916,2022,3938
2018,Oaxaca,20,San Martín Zacatepec,20245,642,668,1310
2018,Oaxaca,20,San Martín de los Cansecos,20238,432,443,875
2018,Oaxaca,20,San Mateo Cajonos,20246,293,350,643
2018,Oaxaca,20,San Mateo Etlatongo,20250,569,606,1175
2018,Oaxaca,20,San Mateo Nejápam,20251,561,619,1180
2018,Oaxaca,20,San Mateo Peñasco,20252,1011,1170,2181
2018,Oaxaca,20,San Mateo Piñas,20253,1018,1024,2042
2018,Oaxaca,20,San Mateo Río Hondo,20254,1583,1654,3237
2018,Oaxaca,20,San Mateo Sindihui,20255,992,1104,2096
2018,Oaxaca,20,San Mateo Tlapiltepec,20256,107,125,232
2018,Oaxaca,20,San Mateo Yoloxochitlán,20249,1774,1947,3721
2018,Oaxaca,20,San Mateo Yucutindoo,20566,1559,1595,3154
2018,Oaxaca,20,San Mateo del Mar,20248,7857,7615,15472
2018,Oaxaca,20,San Melchor Betaza,20257,493,564,1057
2018,Oaxaca,20,San Miguel Achiutla,20258,363,407,770
2018,Oaxaca,20,San Miguel Ahuehuetitlán,20259,1169,1292,2461
2018,Oaxaca,20,San Miguel Aloápam,20260,1090,1237,2327
2018,Oaxaca,20,San Miguel Amatitlán,20261,3632,4038,7670
2018,Oaxaca,20,San Miguel Amatlán,20262,498,526,1024
2018,Oaxaca,20,San Miguel Chicahua,20264,989,1219,2208
2018,Oaxaca,20,San Miguel Chimalapa,20265,3623,3436,7059
2018,Oaxaca,20,San Miguel Coatlán,20263,1568,1833,3401
2018,Oaxaca,20,San Miguel Ejutla,20268,469,548,1017
2018,Oaxaca,20,San Miguel Huautla,20270,545,633,1178
2018,Oaxaca,20,San Miguel Mixtepec,20271,1618,1675,3293
2018,Oaxaca,20,San Miguel Panixtlahuaca,20272,3089,3717,6806
2018,Oaxaca,20,San Miguel Peras,20273,1652,1786,3438
2018,Oaxaca,20,San Miguel Piedras,20274,651,683,1334
2018,Oaxaca,20,San Miguel Quetzaltepec,20275,4171,4122,8293
2018,Oaxaca,20,San Miguel Santa Flor,20276,370,368,738
2018,Oaxaca,20,San Miguel Soyaltepec,20278,19504,20627,40131
2018,Oaxaca,20,San Miguel Suchixtepec,20279,1347,1483,2830
2018,Oaxaca,20,San Miguel Tecomatlán,20281,166,144,310
2018,Oaxaca,20,San Miguel Tenango,20282,383,371,754
2018,Oaxaca,20,San Miguel Tequixtepec,20283,510,539,1049
2018,Oaxaca,20,San Miguel Tilquiápam,20284,1439,1794,3233
2018,Oaxaca,20,San Miguel Tlacamama,20285,1835,1897,3732
2018,Oaxaca,20,San Miguel Tlacotepec,20286,1523,1753,3276
2018,Oaxaca,20,San Miguel Tulancingo,20287,125,190,315
2018,Oaxaca,20,San Miguel Yotao,20288,299,326,625
2018,Oaxaca,20,San Miguel del Puerto,20266,4243,4335,8578
2018,Oaxaca,20,San Miguel del Río,20267,138,133,271
2018,Oaxaca,20,San Miguel el Grande,20269,2018,2275,4293
2018,Oaxaca,20,San Nicolás,20289,533,646,1179
2018,Oaxaca,20,San Nicolás Hidalgo,20290,474,555,1029
2018,Oaxaca,20,San Pablo Coatlán,20291,2120,2222,4342
2018,Oaxaca,20,San Pablo Cuatro Venados,20292,669,766,1435
2018,Oaxaca,20,San Pablo Etla,20293,8839,9762,18601
2018,Oaxaca,20,San Pablo Huitzo,20294,3429,3846,7275
2018,Oaxaca,20,San Pablo Huixtepec,20295,4599,5066,9665
2018,Oaxaca,20,San Pablo Macuiltianguis,20296,447,477,924
2018,Oaxaca,20,San Pablo Tijaltepec,20297,1129,1352,2481
2018,Oaxaca,20,San Pablo Villa de Mitla,20298,6224,6791,13015
2018,Oaxaca,20,San Pablo Yaganiza,20299,523,585,1108
2018,Oaxaca,20,San Pedro Amuzgos,20300,3210,3666,6876
2018,Oaxaca,20,San Pedro Apóstol,20301,727,854,1581
2018,Oaxaca,20,San Pedro Atoyac,20302,2137,2391,4528
2018,Oaxaca,20,San Pedro Cajonos,20303,513,626,1139
2018,Oaxaca,20,San Pedro Comitancillo,20305,2085,2292,4377
2018,Oaxaca,20,San Pedro Coxcaltepec Cántaros,20304,374,410,784
2018,Oaxaca,20,San Pedro Huamelula,20307,5099,5114,10213
2018,Oaxaca,20,San Pedro Huilotepec,20308,1596,1625,3221
2018,Oaxaca,20,San Pedro Ixcatlán,20309,5748,5979,11727
2018,Oaxaca,20,San Pedro Ixtlahuaca,20310,4348,4617,8965
2018,Oaxaca,20,San Pedro Jaltepetongo,20311,256,296,552
2018,Oaxaca,20,San Pedro Jicayán,20312,6011,6542,12553
2018,Oaxaca,20,San Pedro Jocotipac,20313,367,442,809
2018,Oaxaca,20,San Pedro Juchatengo,20314,792,874,1666
2018,Oaxaca,20,San Pedro Mixtepec Distrito 22,20318,24348,25608,49956
2018,Oaxaca,20,San Pedro Mixtepec Distrito 26,20319,530,581,1111
2018,Oaxaca,20,San Pedro Molinos,20320,334,373,707
2018,Oaxaca,20,San Pedro Mártir,20315,767,975,1742
2018,Oaxaca,20,San Pedro Mártir Quiechapa,20316,339,387,726
2018,Oaxaca,20,San Pedro Mártir Yucuxaco,20317,605,708,1313
2018,Oaxaca,20,San Pedro Nopala,20321,363,402,765
2018,Oaxaca,20,San Pedro Ocopetatillo,20322,396,456,852
2018,Oaxaca,20,San Pedro Ocotepec,20323,1070,1126,2196
2018,Oaxaca,20,San Pedro Pochutla,20324,23927,24697,48624
2018,Oaxaca,20,San Pedro Quiatoni,20325,5453,5772,11225
2018,Oaxaca,20,San Pedro Sochiápam,20326,2576,2637,5213
2018,Oaxaca,20,San Pedro Tapanatepec,20327,7571,7737,15308
2018,Oaxaca,20,San Pedro Taviche,20328,610,629,1239
2018,Oaxaca,20,San Pedro Teozacoalco,20329,620,667,1287
2018,Oaxaca,20,San Pedro Teutila,20330,2172,2238,4410
2018,Oaxaca,20,San Pedro Tidaá,20331,422,486,908
2018,Oaxaca,20,San Pedro Topiltepec,20332,180,196,376
2018,Oaxaca,20,San Pedro Totolápam,20333,1294,1432,2726
2018,Oaxaca,20,San Pedro Yaneri,20335,468,493,961
2018,Oaxaca,20,San Pedro Yucunama,20341,103,137,240
2018,Oaxaca,20,San Pedro Yólox,20336,913,974,1887
2018,Oaxaca,20,San Pedro el Alto,20306,1876,1973,3849
2018,Oaxaca,20,San Pedro y San Pablo Ayutla,20337,2464,2914,5378
2018,Oaxaca,20,San Pedro y San Pablo Teposcolula,20339,2016,2219,4235
2018,Oaxaca,20,San Pedro y San Pablo Tequixtepec,20340,795,976,1771
2018,Oaxaca,20,San Raymundo Jalpan,20342,1613,1941,3554
2018,Oaxaca,20,San Sebastián Abasolo,20343,939,1022,1961
2018,Oaxaca,20,San Sebastián Coatlán,20344,1345,1427,2772
2018,Oaxaca,20,San Sebastián Ixcapa,20345,2049,2110,4159
2018,Oaxaca,20,San Sebastián Nicananduta,20346,644,853,1497
2018,Oaxaca,20,San Sebastián Río Hondo,20347,1853,1894,3747
2018,Oaxaca,20,San Sebastián Tecomaxtlahuaca,20348,4016,4438,8454
2018,Oaxaca,20,San Sebastián Teitipac,20349,927,1105,2032
2018,Oaxaca,20,San Sebastián Tutla,20350,8995,10334,19329
2018,Oaxaca,20,San Simón Almolongas,20351,1304,1499,2803
2018,Oaxaca,20,San Simón Zahuatlán,20352,2111,2160,4271
2018,Oaxaca,20,San Vicente Coatlán,20534,1844,2212,4056
2018,Oaxaca,20,San Vicente Lachixío,20535,1404,1591,2995
2018,Oaxaca,20,San Vicente Nuñú,20536,207,243,450
2018,Oaxaca,20,Santa Ana,20353,1059,1158,2217
2018,Oaxaca,20,Santa Ana Ateixtlahuaca,20354,269,265,534
2018,Oaxaca,20,Santa Ana Cuauhtémoc,20355,358,388,746
2018,Oaxaca,20,Santa Ana Tavela,20357,410,435,845
2018,Oaxaca,20,Santa Ana Tlapacoyan,20358,957,1053,2010
2018,Oaxaca,20,Santa Ana Yareni,20359,426,503,929
2018,Oaxaca,20,Santa Ana Zegache,20360,1812,2049,3861
2018,Oaxaca,20,Santa Ana del Valle,20356,1032,1103,2135
2018,Oaxaca,20,Santa Catalina Quierí,20361,421,517,938
2018,Oaxaca,20,Santa Catarina Cuixtla,20362,664,829,1493
2018,Oaxaca,20,Santa Catarina Ixtepeji,20363,1304,1402,2706
2018,Oaxaca,20,Santa Catarina Juquila,20364,7865,8331,16196
2018,Oaxaca,20,Santa Catarina Lachatao,20365,553,596,1149
2018,Oaxaca,20,Santa Catarina Loxicha,20366,1976,2023,3999
2018,Oaxaca,20,Santa Catarina Mechoacán,20367,2313,2352,4665
2018,Oaxaca,20,Santa Catarina Minas,20368,977,1011,1988
2018,Oaxaca,20,Santa Catarina Quiané,20369,953,1024,1977
2018,Oaxaca,20,Santa Catarina Quioquitani,20074,258,282,540
2018,Oaxaca,20,Santa Catarina Tayata,20370,311,369,680
2018,Oaxaca,20,Santa Catarina Ticuá,20371,477,592,1069
2018,Oaxaca,20,Santa Catarina Yosonotú,20372,789,956,1745
2018,Oaxaca,20,Santa Catarina Zapoquila,20373,179,206,385
2018,Oaxaca,20,Santa Cruz Acatepec,20374,766,833,1599
2018,Oaxaca,20,Santa Cruz Amilpas,20375,6141,7092,13233
2018,Oaxaca,20,Santa Cruz Itundujia,20377,5688,6147,11835
2018,Oaxaca,20,Santa Cruz Mixtepec,20378,1715,1894,3609
2018,Oaxaca,20,Santa Cruz Nundaco,20379,1396,1635,3031
2018,Oaxaca,20,Santa Cruz Papalutla,20380,1070,1130,2200
2018,Oaxaca,20,Santa Cruz Tacache de Mina,20381,1310,1448,2758
2018,Oaxaca,20,Santa Cruz Tacahua,20382,544,613,1157
2018,Oaxaca,20,Santa Cruz Tayata,20383,304,314,618
2018,Oaxaca,20,Santa Cruz Xitla,20384,2312,2581,4893
2018,Oaxaca,20,Santa Cruz Xoxocotlán,20385,45309,50789,96098
2018,Oaxaca,20,Santa Cruz Zenzontepec,20386,9228,9661,18889
2018,Oaxaca,20,Santa Cruz de Bravo,20376,179,193,372
2018,Oaxaca,20,Santa Gertrudis,20387,1411,1526,2937
2018,Oaxaca,20,Santa Inés Yatzeche,20389,404,548,952
2018,Oaxaca,20,Santa Inés de Zaragoza,20569,785,889,1674
2018,Oaxaca,20,Santa Inés del Monte,20388,1212,1269,2481
2018,Oaxaca,20,Santa Lucía Miahuatlán,20391,1714,1792,3506
2018,Oaxaca,20,Santa Lucía Monteverde,20392,3188,3476,6664
2018,Oaxaca,20,Santa Lucía Ocotlán,20393,1816,2142,3958
2018,Oaxaca,20,Santa Lucía del Camino,20390,24977,26899,51876
2018,Oaxaca,20,Santa Magdalena Jicotlán,20047,42,52,94
2018,Oaxaca,20,Santa María Alotepec,20394,1422,1455,2877
2018,Oaxaca,20,Santa María Apazco,20395,800,980,1780
2018,Oaxaca,20,Santa María Atzompa,20399,17275,18596,35871
2018,Oaxaca,20,Santa María Camotlán,20400,766,889,1655
2018,Oaxaca,20,Santa María Chachoápam,20404,358,408,766
2018,Oaxaca,20,Santa María Chilchotla,20406,10349,10706,21055
2018,Oaxaca,20,Santa María Chimalapa,20407,4724,4585,9309
2018,Oaxaca,20,Santa María Colotepec,20401,12296,12458,24754
2018,Oaxaca,20,Santa María Cortijo,20402,527,569,1096
2018,Oaxaca,20,Santa María Coyotepec,20403,1506,1665,3171
2018,Oaxaca,20,Santa María Ecatepec,20410,1739,1776,3515
2018,Oaxaca,20,Santa María Guelacé,20411,379,466,845
2018,Oaxaca,20,Santa María Guienagati,20412,1637,1638,3275
2018,Oaxaca,20,Santa María Huatulco,20413,22457,23441,45898
2018,Oaxaca,20,Santa María Huazolotitlán,20414,5753,5968,11721
2018,Oaxaca,20,Santa María Ipalapa,20415,2401,2683,5084
2018,Oaxaca,20,Santa María Ixcatlán,20416,241,270,511
2018,Oaxaca,20,Santa María Jacatepec,20417,4557,5076,9633
2018,Oaxaca,20,Santa María Jalapa del Marqués,20418,6489,6905,13394
2018,Oaxaca,20,Santa María Jaltianguis,20419,247,293,540
2018,Oaxaca,20,Santa María Lachixío,20420,901,1047,1948
2018,Oaxaca,20,Santa María Mixtequilla,20421,2327,2456,4783
2018,Oaxaca,20,Santa María Nativitas,20422,283,337,620
2018,Oaxaca,20,Santa María Nduayaco,20423,259,254,513
2018,Oaxaca,20,Santa María Ozolotepec,20424,1936,2055,3991
2018,Oaxaca,20,Santa María Petapa,20427,8162,8739,16901
2018,Oaxaca,20,Santa María Peñoles,20426,4231,4440,8671
2018,Oaxaca,20,Santa María Pápalo,20425,1107,1099,2206
2018,Oaxaca,20,Santa María Quiegolani,20428,985,969,1954
2018,Oaxaca,20,Santa María Sola,20429,730,791,1521
2018,Oaxaca,20,Santa María Tataltepec,20430,174,193,367
2018,Oaxaca,20,Santa María Tecomavaca,20431,844,907,1751
2018,Oaxaca,20,Santa María Temaxcalapa,20432,466,495,961
2018,Oaxaca,20,Santa María Temaxcaltepec,20433,1274,1419,2693
2018,Oaxaca,20,Santa María Teopoxco,20434,2095,2350,4445
2018,Oaxaca,20,Santa María Tepantlali,20435,1872,1946,3818
2018,Oaxaca,20,Santa María Texcatitlán,20436,493,537,1030
2018,Oaxaca,20,Santa María Tlahuitoltepec,20437,4659,4934,9593
2018,Oaxaca,20,Santa María Tlalixtac,20438,848,901,1749
2018,Oaxaca,20,Santa María Tonameca,20439,12857,13147,26004
2018,Oaxaca,20,Santa María Totolapilla,20440,409,457,866
2018,Oaxaca,20,Santa María Xadani,20441,4506,4437,8943
2018,Oaxaca,20,Santa María Yalina,20442,134,157,291
2018,Oaxaca,20,Santa María Yavesía,20443,224,273,497
2018,Oaxaca,20,Santa María Yolotepec,20444,207,224,431
2018,Oaxaca,20,Santa María Yosoyúa,20445,842,835,1677
2018,Oaxaca,20,Santa María Yucuhiti,20446,3105,3367,6472
2018,Oaxaca,20,Santa María Zacatepec,20447,7675,8672,16347
2018,Oaxaca,20,Santa María Zaniza,20448,1095,1162,2257
2018,Oaxaca,20,Santa María Zoquitlán,20449,1542,1595,3137
2018,Oaxaca,20,Santa María del Rosario,20408,262,246,508
2018,Oaxaca,20,Santa María del Tule,20409,4335,4965,9300
2018,Oaxaca,20,Santa María la Asunción,20396,1495,1872,3367
2018,Oaxaca,20,Santiago Amoltepec,20450,6289,6681,12970
2018,Oaxaca,20,Santiago Apoala,20451,433,498,931
2018,Oaxaca,20,Santiago Apóstol,20452,1839,2281,4120
2018,Oaxaca,20,Santiago Astata,20453,2018,2045,4063
2018,Oaxaca,20,Santiago Atitlán,20454,1599,1540,3139
2018,Oaxaca,20,Santiago Ayuquililla,20455,1314,1452,2766
2018,Oaxaca,20,Santiago Cacaloxtepec,20456,794,864,1658
2018,Oaxaca,20,Santiago Camotlán,20457,1629,1648,3277
2018,Oaxaca,20,Santiago Chazumba,20459,2052,2539,4591
2018,Oaxaca,20,Santiago Choápam,20460,2568,2747,5315
2018,Oaxaca,20,Santiago Comaltepec,20458,484,541,1025
2018,Oaxaca,20,Santiago Huajolotitlán,20462,1956,2343,4299
2018,Oaxaca,20,Santiago Huauclilla,20463,263,291,554
2018,Oaxaca,20,Santiago Ihuitlán Plumas,20464,172,209,381
2018,Oaxaca,20,Santiago Ixcuintepec,20465,819,841,1660
2018,Oaxaca,20,Santiago Ixtayutla,20466,6414,6765,13179
2018,Oaxaca,20,Santiago Jamiltepec,20467,9417,10170,19587
2018,Oaxaca,20,Santiago Jocotepec,20468,7063,7286,14349
2018,Oaxaca,20,Santiago Juxtlahuaca,20469,17492,19365,36857
2018,Oaxaca,20,Santiago Lachiguiri,20470,2427,2477,4904
2018,Oaxaca,20,Santiago Lalopa,20471,244,266,510
2018,Oaxaca,20,Santiago Laollaga,20472,1718,1737,3455
2018,Oaxaca,20,Santiago Laxopa,20473,640,715,1355
2018,Oaxaca,20,Santiago Llano Grande,20474,1673,1700,3373
2018,Oaxaca,20,Santiago Matatlán,20475,4769,5399,10168
2018,Oaxaca,20,Santiago Miltepec,20476,208,212,420
2018,Oaxaca,20,Santiago Minas,20477,716,737,1453
2018,Oaxaca,20,Santiago Nacaltepec,20478,872,968,1840
2018,Oaxaca,20,Santiago Nejapilla,20479,111,102,213
2018,Oaxaca,20,Santiago Niltepec,20066,2751,2788,5539
2018,Oaxaca,20,Santiago Nundiche,20480,448,489,937
2018,Oaxaca,20,Santiago Nuyoó,20481,883,972,1855
2018,Oaxaca,20,Santiago Pinotepa Nacional,20482,26607,27870,54477
2018,Oaxaca,20,Santiago Suchilquitongo,20483,5178,5576,10754
2018,Oaxaca,20,Santiago Tamazola,20484,2123,2453,4576
2018,Oaxaca,20,Santiago Tapextla,20485,1607,1564,3171
2018,Oaxaca,20,Santiago Tenango,20487,1045,1036,2081
2018,Oaxaca,20,Santiago Tepetlapa,20488,58,66,124
2018,Oaxaca,20,Santiago Tetepec,20489,2510,2573,5083
2018,Oaxaca,20,Santiago Texcalcingo,20490,1540,1650,3190
2018,Oaxaca,20,Santiago Textitlán,20491,2247,2266,4513
2018,Oaxaca,20,Santiago Tilantongo,20492,1415,1649,3064
2018,Oaxaca,20,Santiago Tillo,20493,260,296,556
2018,Oaxaca,20,Santiago Tlazoyaltepec,20494,2215,2653,4868
2018,Oaxaca,20,Santiago Xanica,20495,1544,1547,3091
2018,Oaxaca,20,Santiago Xiacuí,20496,1011,1116,2127
2018,Oaxaca,20,Santiago Yaitepec,20497,2037,2376,4413
2018,Oaxaca,20,Santiago Yaveo,20498,3503,3491,6994
2018,Oaxaca,20,Santiago Yolomécatl,20499,1001,1183,2184
2018,Oaxaca,20,Santiago Yosondúa,20500,4024,4508,8532
2018,Oaxaca,20,Santiago Yucuyachi,20501,445,490,935
2018,Oaxaca,20,Santiago Zacatepec,20502,2684,2751,5435
2018,Oaxaca,20,Santiago Zoochila,20503,192,216,408
2018,Oaxaca,20,Santiago del Río,20461,268,285,553
2018,Oaxaca,20,Santo Domingo Albarradas,20506,368,424,792
2018,Oaxaca,20,Santo Domingo Armenta,20507,1735,1754,3489
2018,Oaxaca,20,Santo Domingo Chihuitán,20508,775,792,1567
2018,Oaxaca,20,Santo Domingo Ingenio,20505,4112,4111,8223
2018,Oaxaca,20,Santo Domingo Ixcatlán,20510,342,394,736
2018,Oaxaca,20,Santo Domingo Nuxaá,20511,1623,1732,3355
2018,Oaxaca,20,Santo Domingo Ozolotepec,20512,415,459,874
2018,Oaxaca,20,Santo Domingo Petapa,20513,4686,4633,9319
2018,Oaxaca,20,Santo Domingo Roayaga,20514,500,545,1045
2018,Oaxaca,20,Santo Domingo Tehuantepec,20515,32734,34459,67193
2018,Oaxaca,20,Santo Domingo Teojomulco,20516,2465,2625,5090
2018,Oaxaca,20,Santo Domingo Tepuxtepec,20517,2685,3036,5721
2018,Oaxaca,20,Santo Domingo Tlatayápam,20518,66,76,142
2018,Oaxaca,20,Santo Domingo Tomaltepec,20519,1497,1544,3041
2018,Oaxaca,20,Santo Domingo Tonaltepec,20521,111,143,254
2018,Oaxaca,20,Santo Domingo Tonalá,20520,3420,3777,7197
2018,Oaxaca,20,Santo Domingo Xagacía,20522,554,636,1190
2018,Oaxaca,20,Santo Domingo Yanhuitlán,20523,758,849,1607
2018,Oaxaca,20,Santo Domingo Yodohino,20524,157,174,331
2018,Oaxaca,20,Santo Domingo Zanatepec,20525,6214,6259,12473
2018,Oaxaca,20,Santo Domingo de Morelos,20509,5390,5999,11389
2018,Oaxaca,20,Santo Tomás Jalieza,20530,1745,1923,3668
2018,Oaxaca,20,Santo Tomás Mazaltepec,20531,1272,1400,2672
2018,Oaxaca,20,Santo Tomás Ocotepec,20532,1831,2093,3924
2018,Oaxaca,20,Santo Tomás Tamazulapan,20533,1107,1180,2287
2018,Oaxaca,20,Santos Reyes Nopala,20526,8718,9237,17955
2018,Oaxaca,20,Santos Reyes Pápalo,20527,1326,1422,2748
2018,Oaxaca,20,Santos Reyes Tepejillo,20528,440,606,1046
2018,Oaxaca,20,Santos Reyes Yucuná,20529,676,685,1361
2018,Oaxaca,20,Silacayoápam,20537,3173,3623,6796
2018,Oaxaca,20,Sitio de Xitlapehua,20538,337,375,712
2018,Oaxaca,20,Soledad Etla,20539,2821,2960,5781
2018,Oaxaca,20,Tamazulápam del Espíritu Santo,20031,3467,4125,7592
2018,Oaxaca,20,Tanetze de Zaragoza,20541,818,884,1702
2018,Oaxaca,20,Taniche,20542,369,454,823
2018,Oaxaca,20,Tataltepec de Valdés,20543,2918,3042,5960
2018,Oaxaca,20,Teococuilco de Marcos Pérez,20544,469,552,1021
2018,Oaxaca,20,Teotitlán de Flores Magón,20545,4835,5331,10166
2018,Oaxaca,20,Teotitlán del Valle,20546,2869,3180,6049
2018,Oaxaca,20,Teotongo,20547,446,530,976
2018,Oaxaca,20,Tepelmeme Villa de Morelos,20548,768,916,1684
2018,Oaxaca,20,Tlacolula de Matamoros,20551,10951,12340,23291
2018,Oaxaca,20,Tlacotepec Plumas,20552,223,246,469
2018,Oaxaca,20,Tlalixtac de Cabrera,20553,5072,5607,10679
2018,Oaxaca,20,Totontepec Villa de Morelos,20554,2661,2886,5547
2018,Oaxaca,20,Trinidad Zaachila,20555,1454,1612,3066
2018,Oaxaca,20,Unión Hidalgo,20557,7650,8126,15776
2018,Oaxaca,20,Valerio Trujano,20558,662,806,1468
2018,Oaxaca,20,Villa Díaz Ordaz,20560,3136,3731,6867
2018,Oaxaca,20,Villa Hidalgo,20038,962,1063,2025
2018,Oaxaca,20,Villa Sola de Vega,20277,6273,6430,12703
2018,Oaxaca,20,Villa Talea de Castro,20280,1129,1241,2370
2018,Oaxaca,20,Villa Tejúpam de la Unión,20486,1224,1308,2532
2018,Oaxaca,20,Villa Tezoatlán de Segura y Luna,20549,5233,6176,11409
2018,Oaxaca,20,Villa de Chilapa de Díaz,20405,948,1213,2161
2018,Oaxaca,20,Villa de Etla,20338,5327,5809,11136
2018,Oaxaca,20,Villa de Tamazulápam del Progreso,20540,3729,4174,7903
2018,Oaxaca,20,Villa de Tututepec de Melchor Ocampo,20334,22968,23997,46965
2018,Oaxaca,20,Villa de Zaachila,20565,21547,23568,45115
2018,Oaxaca,20,Yaxe,20561,1392,1502,2894
2018,Oaxaca,20,Yogana,20563,584,697,1281
2018,Oaxaca,20,Yutanduchi de Guerrero,20564,572,634,1206
2018,Oaxaca,20,Zapotitlán Lagunas,20567,1532,1725,3257
2018,Oaxaca,20,Zapotitlán Palmas,20568,668,823,1491
2018,Oaxaca,20,Zimatlán de Álvarez,20570,9676,10996,20672
2018,Oaxaca,20,Ánimas Trujano,20174,1961,2164,4125
2018,Puebla,21,Acajete,21001,32705,34834,67539
2018,Puebla,21,Acateno,21002,4802,4761,9563
2018,Puebla,21,Acatlán,21003,17197,20051,37248
2018,Puebla,21,Acatzingo,21004,29839,31005,60844
2018,Puebla,21,Acteopan,21005,1456,1655,3111
2018,Puebla,21,Ahuacatlán,21006,7827,8581,16408
2018,Puebla,21,Ahuatlán,21007,1652,1775,3427
2018,Puebla,21,Ahuazotepec,21008,5815,6001,11816
2018,Puebla,21,Ahuehuetitla,21009,890,1025,1915
2018,Puebla,21,Ajalpan,21010,33351,35212,68563
2018,Puebla,21,Albino Zertuche,21011,870,1021,1891
2018,Puebla,21,Aljojuca,21012,3233,3594,6827
2018,Puebla,21,Altepexi,21013,10738,11285,22023
2018,Puebla,21,Amixtlán,21014,2476,2727,5203
2018,Puebla,21,Amozoc,21015,59509,62076,121585
2018,Puebla,21,Aquixtla,21016,4499,4509,9008
2018,Puebla,21,Atempan,21017,13925,15410,29335
2018,Puebla,21,Atexcal,21018,1906,2051,3957
2018,Puebla,21,Atlequizayan,21080,1332,1493,2825
2018,Puebla,21,Atlixco,21019,66708,74696,141404
2018,Puebla,21,Atoyatempan,21020,3526,3770,7296
2018,Puebla,21,Atzala,21021,652,721,1373
2018,Puebla,21,Atzitzihuacán,21022,5918,6829,12747
2018,Puebla,21,Atzitzintla,21023,4711,4850,9561
2018,Puebla,21,Axutla,21024,449,524,973
2018,Puebla,21,Ayotoxco de Guerrero,21025,4414,4561,8975
2018,Puebla,21,Calpan,21026,7179,7944,15123
2018,Puebla,21,Caltepec,21027,1947,2224,4171
2018,Puebla,21,Camocuautla,21028,1352,1379,2731
2018,Puebla,21,Caxhuacan,21029,1877,2038,3915
2018,Puebla,21,Cañada Morelos,21099,9768,10425,20193
2018,Puebla,21,Chalchicomula de Sesma,21045,23571,25556,49127
2018,Puebla,21,Chapulco,21046,3883,4161,8044
2018,Puebla,21,Chiautla,21047,10102,10782,20884
2018,Puebla,21,Chiautzingo,21048,10035,11048,21083
2018,Puebla,21,Chichiquila,21050,13120,13815,26935
2018,Puebla,21,Chiconcuautla,21049,8456,8780,17236
2018,Puebla,21,Chietla,21051,17406,18741,36147
2018,Puebla,21,Chigmecatitlán,21052,569,675,1244
2018,Puebla,21,Chignahuapan,21053,31837,33019,64856
2018,Puebla,21,Chignautla,21054,17149,18136,35285
2018,Puebla,21,Chila,21055,2259,2566,4825
2018,Puebla,21,Chila de la Sal,21056,710,760,1470
2018,Puebla,21,Chilchotla,21058,10390,10339,20729
2018,Puebla,21,Chinantla,21059,1125,1278,2403
2018,Puebla,21,Coatepec,21030,374,415,789
2018,Puebla,21,Coatzingo,21031,1480,1633,3113
2018,Puebla,21,Cohetzala,21032,709,699,1408
2018,Puebla,21,Cohuecan,21033,2440,2671,5111
2018,Puebla,21,Coronango,21034,20514,21367,41881
2018,Puebla,21,Coxcatlán,21035,10296,11265,21561
2018,Puebla,21,Coyomeapan,21036,7035,7647,14682
2018,Puebla,21,Coyotepec,21037,1121,1300,2421
2018,Puebla,21,Cuapiaxtla de Madero,21038,5145,5215,10360
2018,Puebla,21,Cuautempan,21039,4716,5052,9768
2018,Puebla,21,Cuautinchán,21040,5284,5358,10642
2018,Puebla,21,Cuautlancingo,21041,58490,61998,120488
2018,Puebla,21,Cuayuca de Andrade,21042,1580,1702,3282
2018,Puebla,21,Cuetzalan del Progreso,21043,24819,25910,50729
2018,Puebla,21,Cuyoaco,21044,7925,8549,16474
2018,Puebla,21,Domingo Arenas,21060,3664,4065,7729
2018,Puebla,21,Eloxochitlán,21061,6499,6778,13277
2018,Puebla,21,Epatlán,21062,2445,2582,5027
2018,Puebla,21,Esperanza,21063,7510,8032,15542
2018,Puebla,21,Francisco Z. Mena,21064,8902,8790,17692
2018,Puebla,21,General Felipe Ángeles,21065,10277,11132,21409
2018,Puebla,21,Guadalupe,21066,2847,3299,6146
2018,Puebla,21,Guadalupe Victoria,21067,8644,9122,17766
2018,Puebla,21,Hermenegildo Galeana,21068,4021,4059,8080
2018,Puebla,21,Honey,21057,3901,4287,8188
2018,Puebla,21,Huaquechula,21069,12242,13973,26215
2018,Puebla,21,Huatlatlauca,21070,3082,3696,6778
2018,Puebla,21,Huauchinango,21071,51921,57228,109149
2018,Puebla,21,Huehuetla,21072,9484,9706,19190
2018,Puebla,21,Huehuetlán el Chico,21073,4338,4600,8938
2018,Puebla,21,Huehuetlán el Grande,21150,3644,3878,7522
2018,Puebla,21,Huejotzingo,21074,37207,39079,76286
2018,Puebla,21,Hueyapan,21075,6487,6854,13341
2018,Puebla,21,Hueytamalco,21076,13673,13963,27636
2018,Puebla,21,Hueytlalpan,21077,2789,2922,5711
2018,Puebla,21,Huitzilan de Serdán,21078,7884,7704,15588
2018,Puebla,21,Huitziltepec,21079,2745,2969,5714
2018,Puebla,21,Ixcamilpa de Guerrero,21081,1795,1997,3792
2018,Puebla,21,Ixcaquixtla,21082,4390,4802,9192
2018,Puebla,21,Ixtacamaxtitlán,21083,12693,13020,25713
2018,Puebla,21,Ixtepec,21084,3606,3810,7416
2018,Puebla,21,Izúcar de Matamoros,21085,38363,42720,81083
2018,Puebla,21,Jalpan,21086,6163,6618,12781
2018,Puebla,21,Jolalpan,21087,6526,7123,13649
2018,Puebla,21,Jonotla,21088,2361,2450,4811
2018,Puebla,21,Jopala,21089,6669,6983,13652
2018,Puebla,21,Juan C. Bonilla,21090,10438,11405,21843
2018,Puebla,21,Juan Galindo,21091,5273,5995,11268
2018,Puebla,21,Juan N. Méndez,21092,2721,2791,5512
2018,Puebla,21,La Magdalena Tlatlauquitepec,21095,294,291,585
2018,Puebla,21,Lafragua,21093,4011,4118,8129
2018,Puebla,21,Libres,21094,17168,18085,35253
2018,Puebla,21,Los Reyes de Juárez,21118,14055,14591,28646
2018,Puebla,21,Mazapiltepec de Juárez,21096,1459,1489,2948
2018,Puebla,21,Mixtla,21097,1166,1296,2462
2018,Puebla,21,Molcaxac,21098,3072,3482,6554
2018,Puebla,21,Naupan,21100,4976,5430,10406
2018,Puebla,21,Nauzontla,21101,1700,1909,3609
2018,Puebla,21,Nealtican,21102,6217,6750,12967
2018,Puebla,21,Nicolás Bravo,21103,3179,3378,6557
2018,Puebla,21,Nopalucan,21104,15826,16265,32091
2018,Puebla,21,Ocotepec,21105,2401,2611,5012
2018,Puebla,21,Ocoyucan,21106,13731,15591,29322
2018,Puebla,21,Olintla,21107,6007,6286,12293
2018,Puebla,21,Oriental,21108,9177,9698,18875
2018,Puebla,21,Pahuatlán,21109,10816,11991,22807
2018,Puebla,21,Palmar de Bravo,21110,23693,24299,47992
2018,Puebla,21,Pantepec,21111,9387,9958,19345
2018,Puebla,21,Petlalcingo,21112,4703,5396,10099
2018,Puebla,21,Piaxtla,21113,2207,2384,4591
2018,Puebla,21,Puebla,21114,802687,870478,1673165
2018,Puebla,21,Quecholac,21115,25946,26977,52923
2018,Puebla,21,Quimixtlán,21116,11369,11611,22980
2018,Puebla,21,Rafael Lara Grajales,21117,7070,7622,14692
2018,Puebla,21,San Andrés Cholula,21119,72449,74301,146750
2018,Puebla,21,San Antonio Cañada,21120,2713,3043,5756
2018,Puebla,21,San Diego la Mesa Tochimiltzingo,21121,619,636,1255
2018,Puebla,21,San Felipe Teotlalcingo,21122,5211,5565,10776
2018,Puebla,21,San Felipe Tepatlán,21123,2033,2102,4135
2018,Puebla,21,San Gabriel Chilac,21124,7800,8594,16394
2018,Puebla,21,San Gregorio Atzompa,21125,4533,4829,9362
2018,Puebla,21,San Jerónimo Tecuanipan,21126,3090,3411,6501
2018,Puebla,21,San Jerónimo Xayacatlán,21127,1723,1978,3701
2018,Puebla,21,San José Chiapa,21128,4498,4610,9108
2018,Puebla,21,San José Miahuatlán,21129,6634,7273,13907
2018,Puebla,21,San Juan Atenco,21130,1638,1897,3535
2018,Puebla,21,San Juan Atzompa,21131,474,450,924
2018,Puebla,21,San Martín Texmelucan,21132,76931,82360,159291
2018,Puebla,21,San Martín Totoltepec,21133,333,360,693
2018,Puebla,21,San Matías Tlalancaleca,21134,10416,10803,21219
2018,Puebla,21,San Miguel Ixitlán,21135,252,284,536
2018,Puebla,21,San Miguel Xoxtla,21136,6344,6684,13028
2018,Puebla,21,San Nicolás Buenos Aires,21137,5035,5257,10292
2018,Puebla,21,San Nicolás de los Ranchos,21138,5920,6226,12146
2018,Puebla,21,San Pablo Anicano,21139,1778,1956,3734
2018,Puebla,21,San Pedro Cholula,21140,65675,71048,136723
2018,Puebla,21,San Pedro Yeloixtlahuaca,21141,1678,1821,3499
2018,Puebla,21,San Salvador Huixcolotla,21144,7674,7832,15506
2018,Puebla,21,San Salvador el Seco,21142,15366,16143,31509
2018,Puebla,21,San Salvador el Verde,21143,15973,16570,32543
2018,Puebla,21,San Sebastián Tlacotepec,21145,7243,7338,14581
2018,Puebla,21,Santa Catarina Tlaltempan,21146,427,422,849
2018,Puebla,21,Santa Inés Ahuatempan,21147,3153,3437,6590
2018,Puebla,21,Santa Isabel Cholula,21148,4491,4884,9375
2018,Puebla,21,Santiago Miahuatlán,21149,12792,13484,26276
2018,Puebla,21,Santo Tomás Hueyotlipan,21151,4294,4641,8935
2018,Puebla,21,Soltepec,21152,6253,6576,12829
2018,Puebla,21,Tecali de Herrera,21153,11179,11796,22975
2018,Puebla,21,Tecamachalco,21154,38940,41367,80307
2018,Puebla,21,Tecomatlán,21155,2957,3067,6024
2018,Puebla,21,Tehuacán,21156,156800,173990,330790
2018,Puebla,21,Tehuitzingo,21157,5554,6179,11733
2018,Puebla,21,Tenampulco,21158,3637,3763,7400
2018,Puebla,21,Teopantlán,21159,1759,2197,3956
2018,Puebla,21,Teotlalco,21160,1611,1694,3305
2018,Puebla,21,Tepanco de López,21161,10140,11235,21375
2018,Puebla,21,Tepango de Rodríguez,21162,2045,2270,4315
2018,Puebla,21,Tepatlaxco de Hidalgo,21163,8810,9313,18123
2018,Puebla,21,Tepeaca,21164,40230,43602,83832
2018,Puebla,21,Tepemaxalco,21165,567,601,1168
2018,Puebla,21,Tepeojuma,21166,4069,4768,8837
2018,Puebla,21,Tepetzintla,21167,5697,6109,11806
2018,Puebla,21,Tepexco,21168,3450,3668,7118
2018,Puebla,21,Tepexi de Rodríguez,21169,11050,10976,22026
2018,Puebla,21,Tepeyahualco,21170,8803,8960,17763
2018,Puebla,21,Tepeyahualco de Cuauhtémoc,21171,1772,1948,3720
2018,Puebla,21,Tetela de Ocampo,21172,14069,15101,29170
2018,Puebla,21,Teteles de Ávila Castillo,21173,2868,3359,6227
2018,Puebla,21,Teziutlán,21174,48899,54275,103174
2018,Puebla,21,Tianguismanalco,21175,6234,6774,13008
2018,Puebla,21,Tilapa,21176,4337,4666,9003
2018,Puebla,21,Tlachichuca,21179,14946,15538,30484
2018,Puebla,21,Tlacotepec de Benito Juárez,21177,25963,28249,54212
2018,Puebla,21,Tlacuilotepec,21178,8651,8925,17576
2018,Puebla,21,Tlahuapan,21180,20673,20946,41619
2018,Puebla,21,Tlaltenango,21181,3623,3687,7310
2018,Puebla,21,Tlanepantla,21182,2520,2714,5234
2018,Puebla,21,Tlaola,21183,10263,10827,21090
2018,Puebla,21,Tlapacoya,21184,3316,3465,6781
2018,Puebla,21,Tlapanalá,21185,4194,4678,8872
2018,Puebla,21,Tlatlauquitepec,21186,26827,29350,56177
2018,Puebla,21,Tlaxco,21187,2800,2831,5631
2018,Puebla,21,Tochimilco,21188,8777,9838,18615
2018,Puebla,21,Tochtepec,21189,10601,11458,22059
2018,Puebla,21,Totoltepec de Guerrero,21190,572,687,1259
2018,Puebla,21,Tulcingo,21191,4637,5304,9941
2018,Puebla,21,Tuzamapan de Galeana,21192,3248,3407,6655
2018,Puebla,21,Tzicatlacoyan,21193,3589,3674,7263
2018,Puebla,21,Venustiano Carranza,21194,14746,15882,30628
2018,Puebla,21,Vicente Guerrero,21195,12249,13285,25534
2018,Puebla,21,Xayacatlán de Bravo,21196,750,895,1645
2018,Puebla,21,Xicotepec,21197,40861,43774,84635
2018,Puebla,21,Xicotlán,21198,604,664,1268
2018,Puebla,21,Xiutetelco,21199,20234,21633,41867
2018,Puebla,21,Xochiapulco,21200,1746,1910,3656
2018,Puebla,21,Xochiltepec,21201,1564,1881,3445
2018,Puebla,21,Xochitlán Todos Santos,21203,3157,3513,6670
2018,Puebla,21,Xochitlán de Vicente Suárez,21202,6426,6815,13241
2018,Puebla,21,Yaonáhuac,21204,3992,4340,8332
2018,Puebla,21,Yehualtepec,21205,12605,13320,25925
2018,Puebla,21,Zacapala,21206,2162,2429,4591
2018,Puebla,21,Zacapoaxtla,21207,27689,30277,57966
2018,Puebla,21,Zacatlán,21208,40907,44994,85901
2018,Puebla,21,Zapotitlán,21209,4041,4816,8857
2018,Puebla,21,Zapotitlán de Méndez,21210,2903,2958,5861
2018,Puebla,21,Zaragoza,21211,7877,9137,17014
2018,Puebla,21,Zautla,21212,9452,10625,20077
2018,Puebla,21,Zihuateutla,21213,6763,7129,13892
2018,Puebla,21,Zinacatepec,21214,8438,9277,17715
2018,Puebla,21,Zongozotla,21215,2548,2607,5155
2018,Puebla,21,Zoquiapan,21216,1215,1379,2594
2018,Puebla,21,Zoquitlán,21217,9569,10124,19693
2018,Querétaro,22,Amealco de Bonfil,22001,32545,34398,66943
2018,Querétaro,22,Arroyo Seco,22003,6911,7495,14406
2018,Querétaro,22,Cadereyta de Montes,22004,35638,38769,74407
2018,Querétaro,22,Colón,22005,33878,33219,67097
2018,Querétaro,22,Corregidora,22006,95172,100962,196134
2018,Querétaro,22,El Marqués,22011,84813,83746,168559
2018,Querétaro,22,Ezequiel Montes,22007,21467,22911,44378
2018,Querétaro,22,Huimilpan,22008,19791,21292,41083
2018,Querétaro,22,Jalpan de Serra,22009,13756,15018,28774
2018,Querétaro,22,Landa de Matamoros,22010,9614,10454,20068
2018,Querétaro,22,Pedro Escobedo,22012,36763,37240,74003
2018,Querétaro,22,Peñamiller,22013,10521,10821,21342
2018,Querétaro,22,Pinal de Amoles,22002,13467,14344,27811
2018,Querétaro,22,Querétaro,22014,469592,476382,945974
2018,Querétaro,22,San Joaquín,22015,4688,5345,10033
2018,Querétaro,22,San Juan del Río,22016,142742,147753,290495
2018,Querétaro,22,Tequisquiapan,22017,37289,38635,75924
2018,Querétaro,22,Tolimán,22018,14962,15545,30507
2018,Quintana Roo,23,Bacalar,23010,21373,21381,42754
2018,Quintana Roo,23,Benito Juárez,23005,405238,400759,805997
2018,Quintana Roo,23,Cozumel,23001,48251,48087,96338
2018,Quintana Roo,23,Felipe Carrillo Puerto,23002,44698,44269,88967
2018,Quintana Roo,23,Isla Mujeres,23003,11169,10366,21535
2018,Quintana Roo,23,José María Morelos,23006,21089,20086,41175
2018,Quintana Roo,23,Lázaro Cárdenas,23007,15315,14674,29989
2018,Quintana Roo,23,Othón P. Blanco,23004,126153,130877,257030
2018,Quintana Roo,23,Solidaridad,23008,118076,108257,226333
2018,Quintana Roo,23,Tulum,23009,18395,16724,35119
2018,San Luis Potosí,24,Ahualulco,24001,8932,10026,18958
2018,San Luis Potosí,24,Alaquines,24002,4234,4362,8596
2018,San Luis Potosí,24,Aquismón,24003,25497,24914,50411
2018,San Luis Potosí,24,Armadillo de los Infante,24004,2121,2200,4321
2018,San Luis Potosí,24,Axtla de Terrazas,24053,18946,19294,38240
2018,San Luis Potosí,24,Catorce,24006,5133,4956,10089
2018,San Luis Potosí,24,Cedral,24007,9708,10113,19821
2018,San Luis Potosí,24,Cerritos,24008,10880,11574,22454
2018,San Luis Potosí,24,Cerro de San Pedro,24009,2347,2312,4659
2018,San Luis Potosí,24,Charcas,24015,10707,11097,21804
2018,San Luis Potosí,24,Ciudad Fernández,24011,22872,24128,47000
2018,San Luis Potosí,24,Ciudad Valles,24013,89475,95412,184887
2018,San Luis Potosí,24,Ciudad del Maíz,24010,17233,17438,34671
2018,San Luis Potosí,24,Coxcatlán,24014,8231,8112,16343
2018,San Luis Potosí,24,Cárdenas,24005,9363,10184,19547
2018,San Luis Potosí,24,Ebano,24016,22115,22968,45083
2018,San Luis Potosí,24,El Naranjo,24058,11414,11273,22687
2018,San Luis Potosí,24,Guadalcázar,24017,13835,13573,27408
2018,San Luis Potosí,24,Huehuetlán,24018,8158,8377,16535
2018,San Luis Potosí,24,Lagunillas,24019,2811,2940,5751
2018,San Luis Potosí,24,Matehuala,24020,49685,52561,102246
2018,San Luis Potosí,24,Matlapa,24057,15984,16013,31997
2018,San Luis Potosí,24,Mexquitic de Carmona,24021,27962,30527,58489
2018,San Luis Potosí,24,Moctezuma,24022,9684,10511,20195
2018,San Luis Potosí,24,Rayón,24023,7831,8270,16101
2018,San Luis Potosí,24,Rioverde,24024,47398,50485,97883
2018,San Luis Potosí,24,Salinas,24025,15734,16989,32723
2018,San Luis Potosí,24,San Antonio,24026,4983,4763,9746
2018,San Luis Potosí,24,San Ciro de Acosta,24027,5152,5542,10694
2018,San Luis Potosí,24,San Luis Potosí,24028,415376,443553,858929
2018,San Luis Potosí,24,San Martín Chalchicuautla,24029,10987,11074,22061
2018,San Luis Potosí,24,San Nicolás Tolentino,24030,2554,2849,5403
2018,San Luis Potosí,24,San Vicente Tancuayalab,24034,7692,7698,15390
2018,San Luis Potosí,24,Santa Catarina,24031,5935,6254,12189
2018,San Luis Potosí,24,Santa María del Río,24032,19791,21721,41512
2018,San Luis Potosí,24,Santo Domingo,24033,6228,6307,12535
2018,San Luis Potosí,24,Soledad de Graciano Sánchez,24035,155453,163389,318842
2018,San Luis Potosí,24,Tamasopo,24036,15724,15458,31182
2018,San Luis Potosí,24,Tamazunchale,24037,49144,49888,99032
2018,San Luis Potosí,24,Tampacán,24038,8154,7997,16151
2018,San Luis Potosí,24,Tampamolón Corona,24039,7883,8000,15883
2018,San Luis Potosí,24,Tamuín,24040,19900,20380,40280
2018,San Luis Potosí,24,Tancanhuitz,24012,10668,10918,21586
2018,San Luis Potosí,24,Tanlajás,24041,10366,10113,20479
2018,San Luis Potosí,24,Tanquián de Escobedo,24042,7675,7985,15660
2018,San Luis Potosí,24,Tierra Nueva,24043,4479,5091,9570
2018,San Luis Potosí,24,Vanegas,24044,4019,3945,7964
2018,San Luis Potosí,24,Venado,24045,7431,7690,15121
2018,San Luis Potosí,24,Villa Hidalgo,24051,7648,7789,15437
2018,San Luis Potosí,24,Villa Juárez,24052,5171,5340,10511
2018,San Luis Potosí,24,Villa de Arista,24056,7930,8000,15930
2018,San Luis Potosí,24,Villa de Arriaga,24046,9063,9198,18261
2018,San Luis Potosí,24,Villa de Guadalupe,24047,5058,5034,10092
2018,San Luis Potosí,24,Villa de Ramos,24049,18857,19930,38787
2018,San Luis Potosí,24,Villa de Reyes,24050,25243,25539,50782
2018,San Luis Potosí,24,Villa de la Paz,24048,2781,2754,5535
2018,San Luis Potosí,24,Xilitla,24054,26593,27332,53925
2018,San Luis Potosí,24,Zaragoza,24055,13203,13586,26789
2018,Sinaloa,25,Ahome,25001,232118,239484,471602
2018,Sinaloa,25,Angostura,25002,24911,24751,49662
2018,Sinaloa,25,Badiraguato,25003,16667,15469,32136
2018,Sinaloa,25,Choix,25007,17678,16728,34406
2018,Sinaloa,25,Concordia,25004,14828,14354,29182
2018,Sinaloa,25,Cosalá,25005,8831,8404,17235
2018,Sinaloa,25,Culiacán,25006,465758,481587,947345
2018,Sinaloa,25,El Fuerte,25010,53929,52624,106553
2018,Sinaloa,25,Elota,25008,30299,28166,58465
2018,Sinaloa,25,Escuinapa,25009,31180,30319,61499
2018,Sinaloa,25,Guasave,25011,154842,156950,311792
2018,Sinaloa,25,Mazatlán,25012,257409,263490,520899
2018,Sinaloa,25,Mocorito,25013,24689,23256,47945
2018,Sinaloa,25,Navolato,25018,80362,77387,157749
2018,Sinaloa,25,Rosario,25014,28492,27477,55969
2018,Sinaloa,25,Salvador Alvarado,25015,41967,43911,85878
2018,Sinaloa,25,San Ignacio,25016,11673,10835,22508
2018,Sinaloa,25,Sinaloa,25017,47542,46243,93785
2018,Sonora,26,Aconchi,26001,1549,1399,2948
2018,Sonora,26,Agua Prieta,26002,43782,43147,86929
2018,Sonora,26,Alamos,26003,14202,13250,27452
2018,Sonora,26,Altar,26004,5039,5041,10080
2018,Sonora,26,Arivechi,26005,650,622,1272
2018,Sonora,26,Arizpe,26006,1508,1437,2945
2018,Sonora,26,Atil,26007,327,310,637
2018,Sonora,26,Bacadéhuachi,26008,642,575,1217
2018,Sonora,26,Bacanora,26009,439,402,841
2018,Sonora,26,Bacerac,26010,774,727,1501
2018,Sonora,26,Bacoachi,26011,849,846,1695
2018,Sonora,26,Banámichi,26013,883,866,1749
2018,Sonora,26,Bavispe,26015,829,746,1575
2018,Sonora,26,Baviácora,26014,1866,1764,3630
2018,Sonora,26,Benito Juárez,26071,11720,11711,23431
2018,Sonora,26,Benjamín Hill,26016,2718,2813,5531
2018,Sonora,26,Bácum,26012,12305,12156,24461
2018,Sonora,26,Caborca,26017,45295,44683,89978
2018,Sonora,26,Cajeme,26018,224118,234171,458289
2018,Sonora,26,Cananea,26019,18522,18915,37437
2018,Sonora,26,Carbó,26020,2736,2517,5253
2018,Sonora,26,Cucurpe,26022,572,463,1035
2018,Sonora,26,Cumpas,26023,3331,3286,6617
2018,Sonora,26,Divisaderos,26024,408,392,800
2018,Sonora,26,Empalme,26025,29534,29916,59450
2018,Sonora,26,Etchojoa,26026,33130,32076,65206
2018,Sonora,26,Fronteras,26027,4684,4509,9193
2018,Sonora,26,General Plutarco Elías Calles,26070,9045,8822,17867
2018,Sonora,26,Granados,26028,584,564,1148
2018,Sonora,26,Guaymas,26029,82672,83987,166659
2018,Sonora,26,Hermosillo,26030,454149,465183,919332
2018,Sonora,26,Huachinera,26031,704,669,1373
2018,Sonora,26,Huatabampo,26033,42850,42655,85505
2018,Sonora,26,Huásabas,26032,514,458,972
2018,Sonora,26,Huépac,26034,553,524,1077
2018,Sonora,26,Imuris,26035,6792,6737,13529
2018,Sonora,26,La Colorada,26021,1147,929,2076
2018,Sonora,26,Magdalena,26036,16379,16642,33021
2018,Sonora,26,Mazatán,26037,704,623,1327
2018,Sonora,26,Moctezuma,26038,2606,2659,5265
2018,Sonora,26,Naco,26039,3353,3309,6662
2018,Sonora,26,Nacozari de García,26041,7054,7015,14069
2018,Sonora,26,Navojoa,26042,84974,88464,173438
2018,Sonora,26,Nogales,26043,123460,123740,247200
2018,Sonora,26,Nácori Chico,26040,1110,1019,2129
2018,Sonora,26,Onavas,26044,261,217,478
2018,Sonora,26,Opodepe,26045,1533,1362,2895
2018,Sonora,26,Oquitoa,26046,200,224,424
2018,Sonora,26,Pitiquito,26047,5189,4866,10055
2018,Sonora,26,Puerto Peñasco,26048,35292,34077,69369
2018,Sonora,26,Quiriego,26049,1669,1452,3121
2018,Sonora,26,Rayón,26050,852,770,1622
2018,Sonora,26,Rosario,26051,2823,2591,5414
2018,Sonora,26,Sahuaripa,26052,3115,2949,6064
2018,Sonora,26,San Felipe de Jesús,26053,219,215,434
2018,Sonora,26,San Ignacio Río Muerto,26072,7898,7490,15388
2018,Sonora,26,San Javier,26054,362,278,640
2018,Sonora,26,San Luis Río Colorado,26055,101442,100456,201898
2018,Sonora,26,San Miguel de Horcasitas,26056,5259,4525,9784
2018,Sonora,26,San Pedro de la Cueva,26057,864,753,1617
2018,Sonora,26,Santa Ana,26058,8590,8822,17412
2018,Sonora,26,Santa Cruz,26059,991,1015,2006
2018,Sonora,26,Soyopa,26061,788,655,1443
2018,Sonora,26,Suaqui Grande,26062,651,555,1206
2018,Sonora,26,Sáric,26060,920,869,1789
2018,Sonora,26,Tepache,26063,748,689,1437
2018,Sonora,26,Trincheras,26064,947,791,1738
2018,Sonora,26,Tubutama,26065,700,664,1364
2018,Sonora,26,Ures,26066,4820,4611,9431
2018,Sonora,26,Villa Hidalgo,26067,869,807,1676
2018,Sonora,26,Villa Pesqueira,26068,691,577,1268
2018,Sonora,26,Yécora,26069,3204,3149,6353
2018,Tabasco,27,Balancán,27001,31535,31636,63171
2018,Tabasco,27,Centla,27003,57730,57646,115376
2018,Tabasco,27,Centro,27004,353508,368707,722215
2018,Tabasco,27,Comalcalco,27005,105107,107922,213029
2018,Tabasco,27,Cunduacán,27006,71224,73304,144528
2018,Tabasco,27,Cárdenas,27002,133214,137899,271113
2018,Tabasco,27,Emiliano Zapata,27007,15551,16846,32397
2018,Tabasco,27,Huimanguillo,27008,97355,99689,197044
2018,Tabasco,27,Jalapa,27009,20290,20173,40463
2018,Tabasco,27,Jalpa de Méndez,27010,45960,46189,92149
2018,Tabasco,27,Jonuta,27011,16290,16077,32367
2018,Tabasco,27,Macuspana,27012,85325,88247,173572
2018,Tabasco,27,Nacajuca,27013,70518,73178,143696
2018,Tabasco,27,Paraíso,27014,49517,49884,99401
2018,Tabasco,27,Tacotalpa,27015,25649,25528,51177
2018,Tabasco,27,Teapa,27016,30064,31070,61134
2018,Tabasco,27,Tenosique,27017,30758,32336,63094
2018,Tamaulipas,28,Abasolo,28001,6320,6325,12645
2018,Tamaulipas,28,Aldama,28002,15444,15190,30634
2018,Tamaulipas,28,Altamira,28003,123097,124360,247457
2018,Tamaulipas,28,Antiguo Morelos,28004,5070,5099,10169
2018,Tamaulipas,28,Burgos,28005,2441,2266,4707
2018,Tamaulipas,28,Bustamante,28006,4332,3985,8317
2018,Tamaulipas,28,Camargo,28007,8319,8073,16392
2018,Tamaulipas,28,Casas,28008,2312,2079,4391
2018,Tamaulipas,28,Ciudad Madero,28009,105148,114806,219954
2018,Tamaulipas,28,Cruillas,28010,1033,1000,2033
2018,Tamaulipas,28,El Mante,28021,60318,63690,124008
2018,Tamaulipas,28,González,28012,22764,23040,45804
2018,Tamaulipas,28,Guerrero,28014,2432,2262,4694
2018,Tamaulipas,28,Gustavo Díaz Ordaz,28015,8318,8108,16426
2018,Tamaulipas,28,Gómez Farías,28011,4899,4655,9554
2018,Tamaulipas,28,Güémez,28013,8472,7843,16315
2018,Tamaulipas,28,Hidalgo,28016,12472,11846,24318
2018,Tamaulipas,28,Jaumave,28017,8185,7916,16101
2018,Tamaulipas,28,Jiménez,28018,4285,4257,8542
2018,Tamaulipas,28,Llera,28019,9025,8740,17765
2018,Tamaulipas,28,Mainero,28020,1345,1307,2652
2018,Tamaulipas,28,Matamoros,28022,265982,272990,538972
2018,Tamaulipas,28,Mier,28024,2274,2348,4622
2018,Tamaulipas,28,Miguel Alemán,28025,14300,14367,28667
2018,Tamaulipas,28,Miquihuana,28026,1965,1786,3751
2018,Tamaulipas,28,Méndez,28023,2228,2043,4271
2018,Tamaulipas,28,Nuevo Laredo,28027,208229,207720,415949
2018,Tamaulipas,28,Nuevo Morelos,28028,1917,1753,3670
2018,Tamaulipas,28,Ocampo,28029,7281,7012,14293
2018,Tamaulipas,28,Padilla,28030,7369,7238,14607
2018,Tamaulipas,28,Palmillas,28031,920,894,1814
2018,Tamaulipas,28,Reynosa,28032,335644,335352,670996
2018,Tamaulipas,28,Río Bravo,28033,65606,65168,130774
2018,Tamaulipas,28,San Carlos,28034,4926,4461,9387
2018,Tamaulipas,28,San Fernando,28035,29701,29345,59046
2018,Tamaulipas,28,San Nicolás,28036,575,517,1092
2018,Tamaulipas,28,Soto la Marina,28037,13448,12782,26230
2018,Tamaulipas,28,Tampico,28038,158621,171806,330427
2018,Tamaulipas,28,Tula,28039,15141,15213,30354
2018,Tamaulipas,28,Valle Hermoso,28040,33203,34178,67381
2018,Tamaulipas,28,Victoria,28041,176204,183755,359959
2018,Tamaulipas,28,Villagrán,28042,3378,3149,6527
2018,Tamaulipas,28,Xicoténcatl,28043,12420,12399,24819
2018,Tlaxcala,29,Acuamanala de Miguel Hidalgo,29022,3331,3321,6652
2018,Tlaxcala,29,Altzayanca,29004,9089,9055,18144
2018,Tlaxcala,29,Amaxac de Guerrero,29001,5743,5905,11648
2018,Tlaxcala,29,Apetatitlán de Antonio Carvajal,29002,7710,8200,15910
2018,Tlaxcala,29,Apizaco,29005,40210,43981,84191
2018,Tlaxcala,29,Atlangatepec,29003,3378,3516,6894
2018,Tlaxcala,29,Benito Juárez,29045,3129,3213,6342
2018,Tlaxcala,29,Calpulalpan,29006,24850,26114,50964
2018,Tlaxcala,29,Chiautempan,29010,36507,39021,75528
2018,Tlaxcala,29,Contla de Juan Cuamatzi,29018,19958,20468,40426
2018,Tlaxcala,29,Cuapiaxtla,29008,8013,7984,15997
2018,Tlaxcala,29,Cuaxomulco,29009,2789,2811,5600
2018,Tlaxcala,29,El Carmen Tequexquitla,29007,8831,9054,17885
2018,Tlaxcala,29,Emiliano Zapata,29046,2321,2427,4748
2018,Tlaxcala,29,Españita,29012,4595,4664,9259
2018,Tlaxcala,29,Huamantla,29013,48083,49888,97971
2018,Tlaxcala,29,Hueyotlipan,29014,7593,7742,15335
2018,Tlaxcala,29,Ixtacuixtla de Mariano Matamoros,29015,19800,20934,40734
2018,Tlaxcala,29,Ixtenco,29016,3658,3937,7595
2018,Tlaxcala,29,La Magdalena Tlaltelulco,29048,9437,10112,19549
2018,Tlaxcala,29,Lázaro Cárdenas,29047,1594,1623,3217
2018,Tlaxcala,29,Mazatecochco de José María Morelos,29017,5626,5720,11346
2018,Tlaxcala,29,Muñoz de Domingo Arenas,29011,2442,2406,4848
2018,Tlaxcala,29,Nanacamilpa de Mariano Arista,29021,9307,9725,19032
2018,Tlaxcala,29,Natívitas,29023,12885,13787,26672
2018,Tlaxcala,29,Panotla,29024,13795,14696,28491
2018,Tlaxcala,29,Papalotla de Xicohténcatl,29041,15394,16435,31829
2018,Tlaxcala,29,San Damián Texóloc,29049,2928,2946,5874
2018,Tlaxcala,29,San Francisco Tetlanohcan,29050,5558,5809,11367
2018,Tlaxcala,29,San Jerónimo Zacualpan,29051,1900,2111,4011
2018,Tlaxcala,29,San José Teacalco,29052,3072,3221,6293
2018,Tlaxcala,29,San Juan Huactzinco,29053,3775,4122,7897
2018,Tlaxcala,29,San Lorenzo Axocomanitla,29054,2847,3057,5904
2018,Tlaxcala,29,San Lucas Tecopilco,29055,1580,1681,3261
2018,Tlaxcala,29,San Pablo del Monte,29025,40300,40504,80804
2018,Tlaxcala,29,Sanctórum de Lázaro Cárdenas,29020,5032,5123,10155
2018,Tlaxcala,29,Santa Ana Nopalucan,29056,4001,4125,8126
2018,Tlaxcala,29,Santa Apolonia Teacalco,29057,2291,2550,4841
2018,Tlaxcala,29,Santa Catarina Ayometla,29058,4463,4813,9276
2018,Tlaxcala,29,Santa Cruz Quilehtla,29059,3716,3731,7447
2018,Tlaxcala,29,Santa Cruz Tlaxcala,29026,10513,10844,21357
2018,Tlaxcala,29,Santa Isabel Xiloxoxtla,29060,2554,2683,5237
2018,Tlaxcala,29,Tenancingo,29027,6672,6916,13588
2018,Tlaxcala,29,Teolocholco,29028,12346,13086,25432
2018,Tlaxcala,29,Tepetitla de Lardizábal,29019,10662,11446,22108
2018,Tlaxcala,29,Tepeyanco,29029,6509,7103,13612
2018,Tlaxcala,29,Terrenate,29030,7947,7867,15814
2018,Tlaxcala,29,Tetla de la Solidaridad,29031,16754,17206,33960
2018,Tlaxcala,29,Tetlatlahuca,29032,7111,7518,14629
2018,Tlaxcala,29,Tlaxcala,29033,48475,53066,101541
2018,Tlaxcala,29,Tlaxco,29034,22058,22827,44885
2018,Tlaxcala,29,Tocatlán,29035,3065,3129,6194
2018,Tlaxcala,29,Totolac,29036,11328,12270,23598
2018,Tlaxcala,29,Tzompantepec,29038,8611,9190,17801
2018,Tlaxcala,29,Xaloztoc,29039,12629,12545,25174
2018,Tlaxcala,29,Xaltocan,29040,5423,5788,11211
2018,Tlaxcala,29,Xicohtzinco,29042,6855,7521,14376
2018,Tlaxcala,29,Yauhquemehcan,29043,19581,20818,40399
2018,Tlaxcala,29,Zacatelco,29044,21881,23734,45615
2018,Tlaxcala,29,Ziltlaltépec de Trinidad Sánchez Santos,29037,4479,4859,9338
2018,Veracruz,30,Acajete,30001,4640,4400,9040
2018,Veracruz,30,Acatlán,30002,1624,1681,3305
2018,Veracruz,30,Acayucan,30003,43631,46902,90533
2018,Veracruz,30,Actopan,30004,22203,22980,45183
2018,Veracruz,30,Acula,30005,2809,2800,5609
2018,Veracruz,30,Acultzingo,30006,11581,11973,23554
2018,Veracruz,30,Agua Dulce,30204,24361,25757,50118
2018,Veracruz,30,Alpatláhuac,30008,5212,5234,10446
2018,Veracruz,30,Alto Lucero de Gutiérrez Barrios,30009,15212,15146,30358
2018,Veracruz,30,Altotonga,30010,32599,34819,67418
2018,Veracruz,30,Alvarado,30011,27772,28205,55977
2018,Veracruz,30,Amatitlán,30012,4092,4259,8351
2018,Veracruz,30,Amatlán de los Reyes,30014,22832,24408,47240
2018,Veracruz,30,Angel R. Cabada,30015,17346,18297,35643
2018,Veracruz,30,Apazapan,30017,2106,2129,4235
2018,Veracruz,30,Aquila,30018,941,1009,1950
2018,Veracruz,30,Astacinga,30019,3086,3507,6593
2018,Veracruz,30,Atlahuilco,30020,5446,5713,11159
2018,Veracruz,30,Atoyac,30021,12042,12772,24814
2018,Veracruz,30,Atzacan,30022,10906,11194,22100
2018,Veracruz,30,Atzalan,30023,26058,26170,52228
2018,Veracruz,30,Ayahualulco,30025,13767,13856,27623
2018,Veracruz,30,Banderilla,30026,11547,12800,24347
2018,Veracruz,30,Benito Juárez,30027,8931,9331,18262
2018,Veracruz,30,Boca del Río,30028,71357,80095,151452
2018,Veracruz,30,Calcahualco,30029,6766,6689,13455
2018,Veracruz,30,Camarón de Tejeda,30007,3373,3363,6736
2018,Veracruz,30,Camerino Z. Mendoza,30030,21034,23503,44537
2018,Veracruz,30,Carlos A. Carrillo,30208,12311,13337,25648
2018,Veracruz,30,Carrillo Puerto,30031,8628,8977,17605
2018,Veracruz,30,Castillo de Teayo,30157,10386,10205,20591
2018,Veracruz,30,Catemaco,30032,25098,26719,51817
2018,Veracruz,30,Cazones de Herrera,30033,12060,12745,24805
2018,Veracruz,30,Cerro Azul,30034,13363,14796,28159
2018,Veracruz,30,Chacaltianguis,30054,6302,6665,12967
2018,Veracruz,30,Chalma,30055,6902,7107,14009
2018,Veracruz,30,Chiconamel,30056,3412,3612,7024
2018,Veracruz,30,Chiconquiaco,30057,7291,7352,14643
2018,Veracruz,30,Chicontepec,30058,28517,29861,58378
2018,Veracruz,30,Chinameca,30059,8227,8620,16847
2018,Veracruz,30,Chinampa de Gorostiza,30060,8487,8717,17204
2018,Veracruz,30,Chocamán,30062,10762,10840,21602
2018,Veracruz,30,Chontla,30063,7585,7629,15214
2018,Veracruz,30,Chumatlán,30064,1976,2078,4054
2018,Veracruz,30,Citlaltépetl,30035,6045,6310,12355
2018,Veracruz,30,Coacoatzintla,30036,5256,5501,10757
2018,Veracruz,30,Coahuitlán,30037,4309,4430,8739
2018,Veracruz,30,Coatepec,30038,46668,49896,96564
2018,Veracruz,30,Coatzacoalcos,30039,162572,172397,334969
2018,Veracruz,30,Coatzintla,30040,28449,29894,58343
2018,Veracruz,30,Coetzala,30041,1154,1185,2339
2018,Veracruz,30,Colipa,30042,2908,3020,5928
2018,Veracruz,30,Comapa,30043,10632,10202,20834
2018,Veracruz,30,Cosamaloapan de Carpio,30045,28437,30861,59298
2018,Veracruz,30,Cosautlán de Carvajal,30046,8435,8529,16964
2018,Veracruz,30,Coscomatepec,30047,29437,30328,59765
2018,Veracruz,30,Cosoleacaque,30048,69484,74331,143815
2018,Veracruz,30,Cotaxtla,30049,10861,10906,21767
2018,Veracruz,30,Coxquihui,30050,8468,8809,17277
2018,Veracruz,30,Coyutla,30051,11276,12080,23356
2018,Veracruz,30,Cuichapa,30052,6038,6655,12693
2018,Veracruz,30,Cuitláhuac,30053,13889,15172,29061
2018,Veracruz,30,Córdoba,30044,106140,119305,225445
2018,Veracruz,30,El Higo,30205,10168,10220,20388
2018,Veracruz,30,Emiliano Zapata,30065,39264,41972,81236
2018,Veracruz,30,Espinal,30066,13796,14415,28211
2018,Veracruz,30,Filomeno Mata,30067,9528,9457,18985
2018,Veracruz,30,Fortín,30068,32733,36221,68954
2018,Veracruz,30,Gutiérrez Zamora,30069,12149,13653,25802
2018,Veracruz,30,Hidalgotitlán,30070,9912,9635,19547
2018,Veracruz,30,Huatusco,30071,30241,32243,62484
2018,Veracruz,30,Huayacocotla,30072,10819,11488,22307
2018,Veracruz,30,Hueyapan de Ocampo,30073,21850,22993,44843
2018,Veracruz,30,Huiloapan de Cuauhtémoc,30074,3644,3887,7531
2018,Veracruz,30,Ignacio de la Llave,30075,8721,9426,18147
2018,Veracruz,30,Ilamatlán,30076,6779,7385,14164
2018,Veracruz,30,Isla,30077,22070,23038,45108
2018,Veracruz,30,Ixcatepec,30078,7023,6998,14021
2018,Veracruz,30,Ixhuacán de los Reyes,30079,5984,5855,11839
2018,Veracruz,30,Ixhuatlancillo,30081,12674,13726,26400
2018,Veracruz,30,Ixhuatlán de Madero,30083,27316,28487,55803
2018,Veracruz,30,Ixhuatlán del Café,30080,11808,11857,23665
2018,Veracruz,30,Ixhuatlán del Sureste,30082,8199,8154,16353
2018,Veracruz,30,Ixmatlahuacan,30084,3001,3049,6050
2018,Veracruz,30,Ixtaczoquitlán,30085,34896,36928,71824
2018,Veracruz,30,Jalacingo,30086,22471,23318,45789
2018,Veracruz,30,Jalcomulco,30088,2691,2631,5322
2018,Veracruz,30,Jamapa,30090,5789,6000,11789
2018,Veracruz,30,Jesús Carranza,30091,14887,14993,29880
2018,Veracruz,30,Jilotepec,30093,8415,8845,17260
2018,Veracruz,30,José Azueta,30169,11846,12288,24134
2018,Veracruz,30,Juan Rodríguez Clara,30094,20037,20513,40550
2018,Veracruz,30,Juchique de Ferrer,30095,8272,8435,16707
2018,Veracruz,30,Jáltipan,30089,20731,22576,43307
2018,Veracruz,30,La Antigua,30016,13647,14578,28225
2018,Veracruz,30,La Perla,30127,13909,14372,28281
2018,Veracruz,30,Landero y Coss,30096,801,849,1650
2018,Veracruz,30,Las Choapas,30061,41240,42744,83984
2018,Veracruz,30,Las Minas,30107,1582,1510,3092
2018,Veracruz,30,Las Vigas de Ramírez,30132,10104,10147,20251
2018,Veracruz,30,Lerdo de Tejada,30097,9760,11095,20855
2018,Veracruz,30,Los Reyes,30137,3031,3062,6093
2018,Veracruz,30,Magdalena,30098,1594,1599,3193
2018,Veracruz,30,Maltrata,30099,8976,9595,18571
2018,Veracruz,30,Manlio Fabio Altamirano,30100,12099,12428,24527
2018,Veracruz,30,Mariano Escobedo,30101,18358,19702,38060
2018,Veracruz,30,Martínez de la Torre,30102,53399,57722,111121
2018,Veracruz,30,Mecatlán,30103,6332,6491,12823
2018,Veracruz,30,Mecayapan,30104,8487,8863,17350
2018,Veracruz,30,Medellín,30105,38286,41366,79652
2018,Veracruz,30,Miahuatlán,30106,2393,2470,4863
2018,Veracruz,30,Minatitlán,30108,79132,84192,163324
2018,Veracruz,30,Misantla,30109,32845,34379,67224
2018,Veracruz,30,Mixtla de Altamirano,30110,6047,5920,11967
2018,Veracruz,30,Moloacán,30111,8732,9197,17929
2018,Veracruz,30,Nanchital de Lázaro Cárdenas del Rio,30206,15012,15859,30871
2018,Veracruz,30,Naolinco,30112,11087,11562,22649
2018,Veracruz,30,Naranjal,30113,2328,2463,4791
2018,Veracruz,30,Naranjos Amatlán,30013,14146,15628,29774
2018,Veracruz,30,Nautla,30114,5571,5775,11346
2018,Veracruz,30,Nogales,30115,18749,20418,39167
2018,Veracruz,30,Oluta,30116,8202,8820,17022
2018,Veracruz,30,Omealca,30117,12018,12855,24873
2018,Veracruz,30,Orizaba,30118,61455,71567,133022
2018,Veracruz,30,Otatitlán,30119,2835,3083,5918
2018,Veracruz,30,Oteapan,30120,8230,8524,16754
2018,Veracruz,30,Ozuluama de Mascareñas,30121,12496,11901,24397
2018,Veracruz,30,Pajapan,30122,9000,8916,17916
2018,Veracruz,30,Papantla,30124,82306,84159,166465
2018,Veracruz,30,Paso de Ovejas,30126,17495,17581,35076
2018,Veracruz,30,Paso del Macho,30125,16280,16616,32896
2018,Veracruz,30,Perote,30128,37801,38006,75807
2018,Veracruz,30,Platón Sánchez,30129,9338,9669,19007
2018,Veracruz,30,Playa Vicente,30130,19204,20860,40064
2018,Veracruz,30,Poza Rica de Hidalgo,30131,101598,112383,213981
2018,Veracruz,30,Pueblo Viejo,30133,30295,30085,60380
2018,Veracruz,30,Puente Nacional,30134,11625,11964,23589
2018,Veracruz,30,Pánuco,30123,52314,52590,104904
2018,Veracruz,30,Rafael Delgado,30135,11757,12091,23848
2018,Veracruz,30,Rafael Lucio,30136,4040,4257,8297
2018,Veracruz,30,Río Blanco,30138,20829,23387,44216
2018,Veracruz,30,Saltabarranca,30139,3127,3326,6453
2018,Veracruz,30,San Andrés Tenejapan,30140,1492,1554,3046
2018,Veracruz,30,San Andrés Tuxtla,30141,82602,88852,171454
2018,Veracruz,30,San Juan Evangelista,30142,17357,17931,35288
2018,Veracruz,30,San Rafael,30211,15349,15909,31258
2018,Veracruz,30,Santiago Sochiapan,30212,7152,7610,14762
2018,Veracruz,30,Santiago Tuxtla,30143,29041,31140,60181
2018,Veracruz,30,Sayula de Alemán,30144,16723,17267,33990
2018,Veracruz,30,Sochiapa,30146,1905,1891,3796
2018,Veracruz,30,Soconusco,30145,8151,8564,16715
2018,Veracruz,30,Soledad Atzompa,30147,11900,11975,23875
2018,Veracruz,30,Soledad de Doblado,30148,14378,14631,29009
2018,Veracruz,30,Soteapan,30149,17512,18051,35563
2018,Veracruz,30,Tamalín,30150,6108,6059,12167
2018,Veracruz,30,Tamiahua,30151,12271,12136,24407
2018,Veracruz,30,Tampico Alto,30152,6726,6265,12991
2018,Veracruz,30,Tancoco,30153,2953,3108,6061
2018,Veracruz,30,Tantima,30154,6926,6689,13615
2018,Veracruz,30,Tantoyuca,30155,53726,54562,108288
2018,Veracruz,30,Tatahuicapan de Juárez,30209,7825,8170,15995
2018,Veracruz,30,Tatatila,30156,3180,2904,6084
2018,Veracruz,30,Tecolutla,30158,12507,12850,25357
2018,Veracruz,30,Tehuipango,30159,13005,13750,26755
2018,Veracruz,30,Tempoal,30161,18348,18820,37168
2018,Veracruz,30,Tenampa,30162,3417,3568,6985
2018,Veracruz,30,Tenochtitlán,30163,2602,2803,5405
2018,Veracruz,30,Teocelo,30164,8468,8930,17398
2018,Veracruz,30,Tepatlaxco,30165,4521,4288,8809
2018,Veracruz,30,Tepetlán,30166,5106,4927,10033
2018,Veracruz,30,Tepetzintla,30167,7558,7725,15283
2018,Veracruz,30,Tequila,30168,7756,7980,15736
2018,Veracruz,30,Texcatepec,30170,5577,5816,11393
2018,Veracruz,30,Texhuacán,30171,2643,2935,5578
2018,Veracruz,30,Texistepec,30172,10795,10772,21567
2018,Veracruz,30,Tezonapa,30173,28909,29537,58446
2018,Veracruz,30,Tierra Blanca,30174,52407,56392,108799
2018,Veracruz,30,Tihuatlán,30175,48811,50644,99455
2018,Veracruz,30,Tlachichilco,30180,5933,6128,12061
2018,Veracruz,30,Tlacojalpan,30176,2528,2597,5125
2018,Veracruz,30,Tlacolulan,30177,5920,5726,11646
2018,Veracruz,30,Tlacotalpan,30178,6798,7312,14110
2018,Veracruz,30,Tlacotepec de Mejía,30179,2038,2078,4116
2018,Veracruz,30,Tlalixcoyan,30181,19574,20182,39756
2018,Veracruz,30,Tlalnelhuayocan,30182,9498,9811,19309
2018,Veracruz,30,Tlaltetela,30024,8243,8017,16260
2018,Veracruz,30,Tlapacoyan,30183,31275,33007,64282
2018,Veracruz,30,Tlaquilpa,30184,3711,4222,7933
2018,Veracruz,30,Tlilapan,30185,2688,2803,5491
2018,Veracruz,30,Tomatlán,30186,3570,3677,7247
2018,Veracruz,30,Tonayán,30187,2910,3053,5963
2018,Veracruz,30,Totutla,30188,9004,9064,18068
2018,Veracruz,30,Tres Valles,30207,23566,24809,48375
2018,Veracruz,30,Tuxpan,30189,81390,85293,166683
2018,Veracruz,30,Tuxtilla,30190,1156,1183,2339
2018,Veracruz,30,Ursulo Galván,30191,15570,16460,32030
2018,Veracruz,30,Uxpanapa,30210,15216,14876,30092
2018,Veracruz,30,Vega de Alatorre,30192,10222,10904,21126
2018,Veracruz,30,Veracruz,30193,296751,320379,617130
2018,Veracruz,30,Villa Aldama,30194,6037,6132,12169
2018,Veracruz,30,Xalapa,30087,238894,267891,506785
2018,Veracruz,30,Xico,30092,19651,20078,39729
2018,Veracruz,30,Xoxocotla,30195,2878,2736,5614
2018,Veracruz,30,Yanga,30196,8793,9935,18728
2018,Veracruz,30,Yecuatla,30197,6116,6335,12451
2018,Veracruz,30,Zacualpan,30198,3602,3844,7446
2018,Veracruz,30,Zaragoza,30199,5753,6002,11755
2018,Veracruz,30,Zentla,30200,7014,6871,13885
2018,Veracruz,30,Zongolica,30201,22536,22881,45417
2018,Veracruz,30,Zontecomatlán de López y Fuentes,30202,7485,7614,15099
2018,Veracruz,30,Zozocolco de Hidalgo,30203,7568,7850,15418
2018,Veracruz,30,Álamo Temapache,30160,54569,55224,109793
2018,Yucatán,31,Abalá,31001,3534,3365,6899
2018,Yucatán,31,Acanceh,31002,8524,8505,17029
2018,Yucatán,31,Akil,31003,5728,5935,11663
2018,Yucatán,31,Baca,31004,3100,3154,6254
2018,Yucatán,31,Bokobá,31005,1173,1123,2296
2018,Yucatán,31,Buctzotz,31006,4722,4687,9409
2018,Yucatán,31,Cacalchén,31007,3898,3706,7604
2018,Yucatán,31,Calotmul,31008,2148,2119,4267
2018,Yucatán,31,Cansahcab,31009,2457,2477,4934
2018,Yucatán,31,Cantamayec,31010,1374,1260,2634
2018,Yucatán,31,Celestún,31011,4130,3930,8060
2018,Yucatán,31,Cenotillo,31012,1974,2126,4100
2018,Yucatán,31,Chacsinkín,31016,1583,1549,3132
2018,Yucatán,31,Chankom,31017,2451,2365,4816
2018,Yucatán,31,Chapab,31018,1669,1655,3324
2018,Yucatán,31,Chemax,31019,19207,18878,38085
2018,Yucatán,31,Chichimilá,31021,4422,4360,8782
2018,Yucatán,31,Chicxulub Pueblo,31020,2415,2275,4690
2018,Yucatán,31,Chikindzonot,31022,2237,2161,4398
2018,Yucatán,31,Chocholá,31023,2536,2441,4977
2018,Yucatán,31,Chumayel,31024,1691,1752,3443
2018,Yucatán,31,Conkal,31013,5761,5724,11485
2018,Yucatán,31,Cuncunul,31014,862,833,1695
2018,Yucatán,31,Cuzamá,31015,2774,2688,5462
2018,Yucatán,31,Dzemul,31026,1958,1926,3884
2018,Yucatán,31,Dzidzantún,31027,4438,4320,8758
2018,Yucatán,31,Dzilam González,31029,3319,3134,6453
2018,Yucatán,31,Dzilam de Bravo,31028,1456,1374,2830
2018,Yucatán,31,Dzitás,31030,2027,1924,3951
2018,Yucatán,31,Dzoncauich,31031,1405,1417,2822
2018,Yucatán,31,Dzán,31025,2722,2849,5571
2018,Yucatán,31,Espita,31032,8611,8342,16953
2018,Yucatán,31,Halachó,31033,10723,10465,21188
2018,Yucatán,31,Hocabá,31034,3261,3233,6494
2018,Yucatán,31,Hoctún,31035,3098,3160,6258
2018,Yucatán,31,Homún,31036,4118,3962,8080
2018,Yucatán,31,Huhí,31037,2779,2672,5451
2018,Yucatán,31,Hunucmá,31038,17054,17067,34121
2018,Yucatán,31,Ixil,31039,2196,2101,4297
2018,Yucatán,31,Izamal,31040,14048,14257,28305
2018,Yucatán,31,Kanasín,31041,51483,52147,103630
2018,Yucatán,31,Kantunil,31042,2832,2925,5757
2018,Yucatán,31,Kaua,31043,1651,1574,3225
2018,Yucatán,31,Kinchil,31044,3782,3694,7476
2018,Yucatán,31,Kopomá,31045,1377,1292,2669
2018,Yucatán,31,Mama,31046,1567,1730,3297
2018,Yucatán,31,Maní,31047,2874,3000,5874
2018,Yucatán,31,Maxcanú,31048,12038,11830,23868
2018,Yucatán,31,Mayapán,31049,1962,1836,3798
2018,Yucatán,31,Mocochá,31051,1736,1699,3435
2018,Yucatán,31,Motul,31052,18940,19189,38129
2018,Yucatán,31,Muna,31053,6568,6804,13372
2018,Yucatán,31,Muxupip,31054,1479,1537,3016
2018,Yucatán,31,Mérida,31050,454826,486849,941675
2018,Yucatán,31,Opichén,31055,3604,3471,7075
2018,Yucatán,31,Oxkutzcab,31056,15550,16976,32526
2018,Yucatán,31,Panabá,31057,4084,4072,8156
2018,Yucatán,31,Peto,31058,13107,13274,26381
2018,Yucatán,31,Progreso,31059,30753,30898,61651
2018,Yucatán,31,Quintana Roo,31060,509,503,1012
2018,Yucatán,31,Río Lagartos,31061,1922,1821,3743
2018,Yucatán,31,Sacalum,31062,2610,2449,5059
2018,Yucatán,31,Samahil,31063,2731,2706,5437
2018,Yucatán,31,San Felipe,31065,1056,989,2045
2018,Yucatán,31,Sanahcat,31064,891,894,1785
2018,Yucatán,31,Santa Elena,31066,2058,2156,4214
2018,Yucatán,31,Seyé,31067,5230,4976,10206
2018,Yucatán,31,Sinanché,31068,1731,1588,3319
2018,Yucatán,31,Sotuta,31069,4742,4559,9301
2018,Yucatán,31,Sucilá,31070,2116,2037,4153
2018,Yucatán,31,Sudzal,31071,945,853,1798
2018,Yucatán,31,Suma,31072,983,945,1928
2018,Yucatán,31,Tahdziú,31073,2689,2530,5219
2018,Yucatán,31,Tahmek,31074,1988,1913,3901
2018,Yucatán,31,Teabo,31075,3407,3460,6867
2018,Yucatán,31,Tecoh,31076,9252,9136,18388
2018,Yucatán,31,Tekal de Venegas,31077,1415,1374,2789
2018,Yucatán,31,Tekantó,31078,1993,2002,3995
2018,Yucatán,31,Tekax,31079,21988,22576,44564
2018,Yucatán,31,Tekit,31080,5477,5302,10779
2018,Yucatán,31,Tekom,31081,1692,1690,3382
2018,Yucatán,31,Telchac Pueblo,31082,1994,1963,3957
2018,Yucatán,31,Telchac Puerto,31083,988,895,1883
2018,Yucatán,31,Temax,31084,3813,3775,7588
2018,Yucatán,31,Temozón,31085,8279,8015,16294
2018,Yucatán,31,Tepakán,31086,1189,1132,2321
2018,Yucatán,31,Tetiz,31087,2639,2678,5317
2018,Yucatán,31,Teya,31088,1020,1043,2063
2018,Yucatán,31,Ticul,31089,20831,21298,42129
2018,Yucatán,31,Timucuy,31090,3950,3756,7706
2018,Yucatán,31,Tinum,31091,6382,6129,12511
2018,Yucatán,31,Tixcacalcupul,31092,3762,3688,7450
2018,Yucatán,31,Tixkokob,31093,9404,9537,18941
2018,Yucatán,31,Tixmehuac,31094,2570,2525,5095
2018,Yucatán,31,Tixpéhual,31095,2873,2937,5810
2018,Yucatán,31,Tizimín,31096,40234,40936,81170
2018,Yucatán,31,Tunkás,31097,1886,1814,3700
2018,Yucatán,31,Tzucacab,31098,7806,7615,15421
2018,Yucatán,31,Uayma,31099,2172,2066,4238
2018,Yucatán,31,Ucú,31100,1950,1918,3868
2018,Yucatán,31,Umán,31101,28811,28684,57495
2018,Yucatán,31,Valladolid,31102,41805,42420,84225
2018,Yucatán,31,Xocchel,31103,1855,1774,3629
2018,Yucatán,31,Yaxcabá,31104,8258,7762,16020
2018,Yucatán,31,Yaxkukul,31105,1638,1649,3287
2018,Yucatán,31,Yobaín,31106,1213,1157,2370
2018,Zacatecas,32,Apozol,32001,3072,3265,6337
2018,Zacatecas,32,Apulco,32002,2404,2665,5069
2018,Zacatecas,32,Atolinga,32003,1272,1349,2621
2018,Zacatecas,32,Benito Juárez,32004,2178,2108,4286
2018,Zacatecas,32,Calera,32005,23327,23203,46530
2018,Zacatecas,32,Cañitas de Felipe Pescador,32006,4291,4396,8687
2018,Zacatecas,32,Chalchihuites,32009,5682,6006,11688
2018,Zacatecas,32,Concepción del Oro,32007,6952,6769,13721
2018,Zacatecas,32,Cuauhtémoc,32008,6403,6678,13081
2018,Zacatecas,32,El Plateado de Joaquín Amaro,32015,666,680,1346
2018,Zacatecas,32,El Salvador,32041,1313,1262,2575
2018,Zacatecas,32,Fresnillo,32010,118255,120658,238913
2018,Zacatecas,32,Genaro Codina,32012,4140,4341,8481
2018,Zacatecas,32,General Enrique Estrada,32013,3245,3303,6548
2018,Zacatecas,32,General Francisco R. Murguía,32014,10975,11712,22687
2018,Zacatecas,32,General Pánfilo Natera,32016,11818,12261,24079
2018,Zacatecas,32,Guadalupe,32017,94774,98891,193665
2018,Zacatecas,32,Huanusco,32018,2084,2186,4270
2018,Zacatecas,32,Jalpa,32019,12322,12874,25196
2018,Zacatecas,32,Jerez,32020,30191,31903,62094
2018,Zacatecas,32,Jiménez del Teul,32021,2244,2273,4517
2018,Zacatecas,32,Juan Aldama,32022,10933,11537,22470
2018,Zacatecas,32,Juchipila,32023,6282,6920,13202
2018,Zacatecas,32,Loreto,32024,27515,27846,55361
2018,Zacatecas,32,Luis Moya,32025,6816,6885,13701
2018,Zacatecas,32,Mazapil,32026,9590,8648,18238
2018,Zacatecas,32,Melchor Ocampo,32027,1619,1422,3041
2018,Zacatecas,32,Mezquital del Oro,32028,1245,1356,2601
2018,Zacatecas,32,Miguel Auza,32029,12061,12485,24546
2018,Zacatecas,32,Momax,32030,1233,1318,2551
2018,Zacatecas,32,Monte Escobedo,32031,4750,4847,9597
2018,Zacatecas,32,Morelos,32032,6461,6454,12915
2018,Zacatecas,32,Moyahua de Estrada,32033,2006,2253,4259
2018,Zacatecas,32,Nochistlán de Mejía,32034,13836,15261,29097
2018,Zacatecas,32,Noria de Ángeles,32035,8537,8776,17313
2018,Zacatecas,32,Ojocaliente,32036,21918,22864,44782
2018,Zacatecas,32,Pinos,32038,37304,38730,76034
2018,Zacatecas,32,Pánuco,32037,9267,9210,18477
2018,Zacatecas,32,Río Grande,32039,32398,34406,66804
2018,Zacatecas,32,Sain Alto,32040,11209,11798,23007
2018,Zacatecas,32,Santa María de la Paz,32058,1412,1433,2845
2018,Zacatecas,32,Sombrerete,32042,32040,32828,64868
2018,Zacatecas,32,Susticacán,32043,676,732,1408
2018,Zacatecas,32,Tabasco,32044,7948,8323,16271
2018,Zacatecas,32,Tepechitlán,32045,4350,4726,9076
2018,Zacatecas,32,Tepetongo,32046,3596,3820,7416
2018,Zacatecas,32,Teúl de González Ortega,32047,2584,2700,5284
2018,Zacatecas,32,Tlaltenango de Sánchez Román,32048,13602,14033,27635
2018,Zacatecas,32,Trancoso,32057,9883,10042,19925
2018,Zacatecas,32,Trinidad García de la Cadena,32011,1488,1538,3026
2018,Zacatecas,32,Valparaíso,32049,17017,17478,34495
2018,Zacatecas,32,Vetagrande,32050,5114,5225,10339
2018,Zacatecas,32,Villa García,32052,9847,9996,19843
2018,Zacatecas,32,Villa González Ortega,32053,6668,7091,13759
2018,Zacatecas,32,Villa Hidalgo,32054,9923,10032,19955
2018,Zacatecas,32,Villa de Cos,32051,18487,18199,36686
2018,Zacatecas,32,Villanueva,32055,15429,16086,31515
2018,Zacatecas,32,Zacatecas,32056,74867,78788,153655
2019,Aguascalientes,01,Aguascalientes,01001,465782,483495,949277
2019,Aguascalientes,01,Asientos,01002,25053,25301,50354
2019,Aguascalientes,01,Calvillo,01003,29439,30742,60181
2019,Aguascalientes,01,Cosío,01004,8228,8538,16766
2019,Aguascalientes,01,El Llano,01010,11007,10703,21710
2019,Aguascalientes,01,Jesús María,01005,64166,63669,127835
2019,Aguascalientes,01,Pabellón de Arteaga,01006,24195,25284,49479
2019,Aguascalientes,01,Rincón de Romos,01007,28473,28886,57359
2019,Aguascalientes,01,San Francisco de los Romo,01011,25106,25335,50441
2019,Aguascalientes,01,San José de Gracia,01008,4627,4924,9551
2019,Aguascalientes,01,Tepezalá,01009,11052,11416,22468
2019,Baja California,02,Ensenada,02001,263631,263953,527584
2019,Baja California,02,Mexicali,02002,534105,535571,1069676
2019,Baja California,02,Playas de Rosarito,02005,53074,52883,105957
2019,Baja California,02,Tecate,02003,57864,54283,112147
2019,Baja California,02,Tijuana,02004,879485,883712,1763197
2019,Baja California Sur,03,Comondú,03001,41383,40237,81620
2019,Baja California Sur,03,La Paz,03003,148060,148691,296751
2019,Baja California Sur,03,Loreto,03009,11032,10106,21138
2019,Baja California Sur,03,Los Cabos,03008,165595,156163,321758
2019,Baja California Sur,03,Mulegé,03002,34670,32182,66852
2019,Campeche,04,Calakmul,04010,15872,15388,31260
2019,Campeche,04,Calkiní,04001,30680,31655,62335
2019,Campeche,04,Campeche,04002,150566,161479,312045
2019,Campeche,04,Candelaria,04011,24252,23713,47965
2019,Campeche,04,Carmen,04003,134722,135920,270642
2019,Campeche,04,Champotón,04004,49241,48974,98215
2019,Campeche,04,Escárcega,04009,30905,31728,62633
2019,Campeche,04,Hecelchakán,04005,17027,17113,34140
2019,Campeche,04,Hopelchén,04006,22124,21210,43334
2019,Campeche,04,Palizada,04007,4930,4813,9743
2019,Campeche,04,Tenabo,04008,6017,5717,11734
2019,Chiapas,07,Acacoyagua,07001,9813,9754,19567
2019,Chiapas,07,Acala,07002,16881,17119,34000
2019,Chiapas,07,Acapetahua,07003,15353,15329,30682
2019,Chiapas,07,Aldama,07113,3381,3655,7036
2019,Chiapas,07,Altamirano,07004,17810,17581,35391
2019,Chiapas,07,Amatenango de la Frontera,07006,16225,17172,33397
2019,Chiapas,07,Amatenango del Valle,07007,5115,5514,10629
2019,Chiapas,07,Amatán,07005,10997,10701,21698
2019,Chiapas,07,Angel Albino Corzo,07008,15274,15350,30624
2019,Chiapas,07,Arriaga,07009,21242,22609,43851
2019,Chiapas,07,Bejucal de Ocampo,07010,4136,4094,8230
2019,Chiapas,07,Bella Vista,07011,10788,10967,21755
2019,Chiapas,07,Benemérito de las Américas,07114,10727,10529,21256
2019,Chiapas,07,Berriozábal,07012,27837,27914,55751
2019,Chiapas,07,Bochil,07013,18578,18908,37486
2019,Chiapas,07,Cacahoatán,07015,24296,25518,49814
2019,Chiapas,07,Catazajá,07016,9497,9297,18794
2019,Chiapas,07,Chalchihuitán,07022,8805,8958,17763
2019,Chiapas,07,Chamula,07023,43396,50335,93731
2019,Chiapas,07,Chanal,07024,6519,6569,13088
2019,Chiapas,07,Chapultenango,07025,4092,4088,8180
2019,Chiapas,07,Chenalhó,07026,21130,21579,42709
2019,Chiapas,07,Chiapa de Corzo,07027,53672,55466,109138
2019,Chiapas,07,Chiapilla,07028,3227,3098,6325
2019,Chiapas,07,Chicoasén,07029,2778,2780,5558
2019,Chiapas,07,Chicomuselo,07030,18626,18869,37495
2019,Chiapas,07,Chilón,07031,67995,69469,137464
2019,Chiapas,07,Cintalapa,07017,46034,46133,92167
2019,Chiapas,07,Coapilla,07018,4895,5007,9902
2019,Chiapas,07,Comitán de Domínguez,07019,80143,87629,167772
2019,Chiapas,07,Copainalá,07021,11637,12138,23775
2019,Chiapas,07,El Bosque,07014,11541,12352,23893
2019,Chiapas,07,El Porvenir,07070,7643,7667,15310
2019,Chiapas,07,Escuintla,07032,16828,17384,34212
2019,Chiapas,07,Francisco León,07033,4136,4024,8160
2019,Chiapas,07,Frontera Comalapa,07034,38534,40953,79487
2019,Chiapas,07,Frontera Hidalgo,07035,7560,7913,15473
2019,Chiapas,07,Huehuetán,07037,18357,19384,37741
2019,Chiapas,07,Huitiupán,07039,12536,12369,24905
2019,Chiapas,07,Huixtla,07040,28249,30272,58521
2019,Chiapas,07,Huixtán,07038,12418,12817,25235
2019,Chiapas,07,Ixhuatán,07042,5985,6148,12133
2019,Chiapas,07,Ixtacomitán,07043,5780,5870,11650
2019,Chiapas,07,Ixtapa,07044,14588,14750,29338
2019,Chiapas,07,Ixtapangajoya,07045,2999,2921,5920
2019,Chiapas,07,Jiquipilas,07046,21056,21694,42750
2019,Chiapas,07,Jitotol,07047,11278,10956,22234
2019,Chiapas,07,Juárez,07048,11505,11759,23264
2019,Chiapas,07,La Concordia,07020,25134,24828,49962
2019,Chiapas,07,La Grandeza,07036,3862,3941,7803
2019,Chiapas,07,La Independencia,07041,23948,24899,48847
2019,Chiapas,07,La Libertad,07050,2655,2738,5393
2019,Chiapas,07,La Trinitaria,07099,40924,42998,83922
2019,Chiapas,07,Larráinzar,07049,12428,12845,25273
2019,Chiapas,07,Las Margaritas,07052,65642,66873,132515
2019,Chiapas,07,Las Rosas,07075,15094,15388,30482
2019,Chiapas,07,Mapastepec,07051,25140,25990,51130
2019,Chiapas,07,Maravilla Tenejapa,07115,6914,6667,13581
2019,Chiapas,07,Marqués de Comillas,07116,6099,5927,12026
2019,Chiapas,07,Mazapa de Madero,07053,4156,4291,8447
2019,Chiapas,07,Mazatán,07054,15490,15911,31401
2019,Chiapas,07,Metapa,07055,2946,3161,6107
2019,Chiapas,07,Mitontic,07056,6497,6578,13075
2019,Chiapas,07,Montecristo de Guerrero,07117,4195,4072,8267
2019,Chiapas,07,Motozintla,07057,38623,40019,78642
2019,Chiapas,07,Nicolás Ruíz,07058,2404,2275,4679
2019,Chiapas,07,Ocosingo,07059,117353,118173,235526
2019,Chiapas,07,Ocotepec,07060,6680,6925,13605
2019,Chiapas,07,Ocozocoautla de Espinosa,07061,48847,49976,98823
2019,Chiapas,07,Ostuacán,07062,9926,9793,19719
2019,Chiapas,07,Osumacinta,07063,2039,2031,4070
2019,Chiapas,07,Oxchuc,07064,25677,25410,51087
2019,Chiapas,07,Palenque,07065,63852,65804,129656
2019,Chiapas,07,Pantelhó,07066,11820,11990,23810
2019,Chiapas,07,Pantepec,07067,6538,6616,13154
2019,Chiapas,07,Pichucalco,07068,16818,17153,33971
2019,Chiapas,07,Pijijiapan,07069,28347,29105,57452
2019,Chiapas,07,Pueblo Nuevo Solistahuacán,07072,16713,18043,34756
2019,Chiapas,07,Rayón,07073,5175,5241,10416
2019,Chiapas,07,Reforma,07074,24125,24558,48683
2019,Chiapas,07,Sabanilla,07076,14586,14416,29002
2019,Chiapas,07,Salto de Agua,07077,33765,34093,67858
2019,Chiapas,07,San Andrés Duraznal,07118,2790,2939,5729
2019,Chiapas,07,San Cristóbal de las Casas,07078,108386,119254,227640
2019,Chiapas,07,San Fernando,07079,21266,20880,42146
2019,Chiapas,07,San Juan Cancuc,07112,18135,18923,37058
2019,Chiapas,07,San Lucas,07110,3896,3899,7795
2019,Chiapas,07,Santiago el Pinar,07119,1974,1945,3919
2019,Chiapas,07,Siltepec,07080,19925,19320,39245
2019,Chiapas,07,Simojovel,07081,23451,23811,47262
2019,Chiapas,07,Sitalá,07082,7571,7641,15212
2019,Chiapas,07,Socoltenango,07083,9915,10011,19926
2019,Chiapas,07,Solosuchiapa,07084,4391,4363,8754
2019,Chiapas,07,Soyaló,07085,5823,5757,11580
2019,Chiapas,07,Suchiapa,07086,13046,12998,26044
2019,Chiapas,07,Suchiate,07087,20391,21248,41639
2019,Chiapas,07,Sunuapa,07088,1305,1259,2564
2019,Chiapas,07,Tapachula,07089,181428,197134,378562
2019,Chiapas,07,Tapalapa,07090,2097,2214,4311
2019,Chiapas,07,Tapilula,07091,6830,7151,13981
2019,Chiapas,07,Tecpatán,07092,22306,22662,44968
2019,Chiapas,07,Tenejapa,07093,22967,24148,47115
2019,Chiapas,07,Teopisca,07094,22572,23845,46417
2019,Chiapas,07,Tila,07096,42195,42008,84203
2019,Chiapas,07,Tonalá,07097,47734,48946,96680
2019,Chiapas,07,Totolapa,07098,3907,3873,7780
2019,Chiapas,07,Tumbalá,07100,18052,18843,36895
2019,Chiapas,07,Tuxtla Chico,07102,21958,23206,45164
2019,Chiapas,07,Tuxtla Gutiérrez,07101,311615,341937,653552
2019,Chiapas,07,Tuzantán,07103,16858,17374,34232
2019,Chiapas,07,Tzimol,07104,8126,8500,16626
2019,Chiapas,07,Unión Juárez,07105,8052,8501,16553
2019,Chiapas,07,Venustiano Carranza,07106,34987,35191,70178
2019,Chiapas,07,Villa Comaltitlán,07071,15416,15783,31199
2019,Chiapas,07,Villa Corzo,07107,41707,43130,84837
2019,Chiapas,07,Villaflores,07108,55977,58250,114227
2019,Chiapas,07,Yajalón,07109,20077,20935,41012
2019,Chiapas,07,Zinacantán,07111,20689,23444,44133
2019,Chihuahua,08,Ahumada,08001,6507,6344,12851
2019,Chihuahua,08,Aldama,08002,12852,12984,25836
2019,Chihuahua,08,Allende,08003,4722,4611,9333
2019,Chihuahua,08,Aquiles Serdán,08004,9581,8965,18546
2019,Chihuahua,08,Ascensión,08005,13275,12922,26197
2019,Chihuahua,08,Bachíniva,08006,3386,3247,6633
2019,Chihuahua,08,Balleza,08007,9010,8728,17738
2019,Chihuahua,08,Batopilas,08008,6485,6489,12974
2019,Chihuahua,08,Bocoyna,08009,14581,15171,29752
2019,Chihuahua,08,Buenaventura,08010,12477,12251,24728
2019,Chihuahua,08,Camargo,08011,26814,27794,54608
2019,Chihuahua,08,Carichí,08012,4992,4933,9925
2019,Chihuahua,08,Casas Grandes,08013,6103,5844,11947
2019,Chihuahua,08,Chihuahua,08019,456830,480403,937233
2019,Chihuahua,08,Chínipas,08020,4444,4020,8464
2019,Chihuahua,08,Coronado,08014,1210,1117,2327
2019,Chihuahua,08,Coyame del Sotol,08015,979,814,1793
2019,Chihuahua,08,Cuauhtémoc,08017,86747,91990,178737
2019,Chihuahua,08,Cusihuiriachi,08018,2622,2447,5069
2019,Chihuahua,08,Delicias,08021,77279,80747,158026
2019,Chihuahua,08,Dr. Belisario Domínguez,08022,1388,1352,2740
2019,Chihuahua,08,El Tule,08064,928,893,1821
2019,Chihuahua,08,Galeana,08023,3468,3463,6931
2019,Chihuahua,08,Gran Morelos,08026,1418,1358,2776
2019,Chihuahua,08,Guachochi,08027,24302,25336,49638
2019,Chihuahua,08,Guadalupe,08028,2594,2643,5237
2019,Chihuahua,08,Guadalupe y Calvo,08029,29438,28832,58270
2019,Chihuahua,08,Guazapares,08030,4371,4170,8541
2019,Chihuahua,08,Guerrero,08031,21120,20850,41970
2019,Chihuahua,08,Gómez Farías,08025,4731,4733,9464
2019,Chihuahua,08,Hidalgo del Parral,08032,56526,60029,116555
2019,Chihuahua,08,Huejotitán,08033,528,528,1056
2019,Chihuahua,08,Ignacio Zaragoza,08034,3732,3668,7400
2019,Chihuahua,08,Janos,08035,6064,5545,11609
2019,Chihuahua,08,Jiménez,08036,22497,22774,45271
2019,Chihuahua,08,Julimes,08038,2487,2387,4874
2019,Chihuahua,08,Juárez,08037,728273,727650,1455923
2019,Chihuahua,08,La Cruz,08016,2140,2034,4174
2019,Chihuahua,08,López,08039,2225,2069,4294
2019,Chihuahua,08,Madera,08040,15518,15301,30819
2019,Chihuahua,08,Maguarichi,08041,897,843,1740
2019,Chihuahua,08,Manuel Benavides,08042,838,709,1547
2019,Chihuahua,08,Matachí,08043,1647,1620,3267
2019,Chihuahua,08,Matamoros,08044,2438,2343,4781
2019,Chihuahua,08,Meoqui,08045,23670,24089,47759
2019,Chihuahua,08,Morelos,08046,4203,4116,8319
2019,Chihuahua,08,Moris,08047,2841,2646,5487
2019,Chihuahua,08,Namiquipa,08048,12874,12291,25165
2019,Chihuahua,08,Nonoava,08049,1445,1365,2810
2019,Chihuahua,08,Nuevo Casas Grandes,08050,32566,33970,66536
2019,Chihuahua,08,Ocampo,08051,4124,3780,7904
2019,Chihuahua,08,Ojinaga,08052,14859,14669,29528
2019,Chihuahua,08,Praxedis G. Guerrero,08053,2650,2602,5252
2019,Chihuahua,08,Riva Palacio,08054,4201,4052,8253
2019,Chihuahua,08,Rosales,08055,9188,9009,18197
2019,Chihuahua,08,Rosario,08056,1103,1063,2166
2019,Chihuahua,08,San Francisco de Borja,08057,1240,1172,2412
2019,Chihuahua,08,San Francisco de Conchos,08058,1457,1352,2809
2019,Chihuahua,08,San Francisco del Oro,08059,2714,2691,5405
2019,Chihuahua,08,Santa Bárbara,08060,5676,5740,11416
2019,Chihuahua,08,Santa Isabel,08024,2106,2146,4252
2019,Chihuahua,08,Satevó,08061,1748,1632,3380
2019,Chihuahua,08,Saucillo,08062,16920,16739,33659
2019,Chihuahua,08,Temósachic,08063,3540,3363,6903
2019,Chihuahua,08,Urique,08065,11195,10860,22055
2019,Chihuahua,08,Uruachi,08066,3419,3266,6685
2019,Chihuahua,08,Valle de Zaragoza,08067,2839,2719,5558
2019,Ciudad de México,09,Azcapotzalco,09002,192944,216916,409860
2019,Ciudad de México,09,Benito Juárez,09014,198095,232259,430354
2019,Ciudad de México,09,Coyoacán,09003,293039,330644,623683
2019,Ciudad de México,09,Cuajimalpa de Morelos,09004,95608,103772,199380
2019,Ciudad de México,09,Cuauhtémoc,09015,259989,287714,547703
2019,Ciudad de México,09,Gustavo A. Madero,09005,567165,613564,1180729
2019,Ciudad de México,09,Iztacalco,09006,186979,207469,394448
2019,Ciudad de México,09,Iztapalapa,09007,885252,938216,1823468
2019,Ciudad de México,09,La Magdalena Contreras,09008,117979,127396,245375
2019,Ciudad de México,09,Miguel Hidalgo,09016,175144,203564,378708
2019,Ciudad de México,09,Milpa Alta,09009,67969,71066,139035
2019,Ciudad de México,09,Tlalpan,09012,326554,355174,681728
2019,Ciudad de México,09,Tláhuac,09011,177029,190377,367406
2019,Ciudad de México,09,Venustiano Carranza,09017,204702,229588,434290
2019,Ciudad de México,09,Xochimilco,09013,205763,213663,419426
2019,Ciudad de México,09,Álvaro Obregón,09010,360335,395285,755620
2019,Coahuila,05,Abasolo,05001,559,556,1115
2019,Coahuila,05,Acuña,05002,81310,80250,161560
2019,Coahuila,05,Allende,05003,12097,12365,24462
2019,Coahuila,05,Arteaga,05004,12878,12267,25145
2019,Coahuila,05,Candela,05005,1009,912,1921
2019,Coahuila,05,Castaños,05006,15100,15042,30142
2019,Coahuila,05,Cuatro Ciénegas,05007,7320,7140,14460
2019,Coahuila,05,Escobedo,05008,1685,1622,3307
2019,Coahuila,05,Francisco I. Madero,05009,31752,31775,63527
2019,Coahuila,05,Frontera,05010,43671,43147,86818
2019,Coahuila,05,General Cepeda,05011,6956,6383,13339
2019,Coahuila,05,Guerrero,05012,1041,915,1956
2019,Coahuila,05,Hidalgo,05013,964,913,1877
2019,Coahuila,05,Jiménez,05014,5550,5367,10917
2019,Coahuila,05,Juárez,05015,884,817,1701
2019,Coahuila,05,Lamadrid,05016,1012,953,1965
2019,Coahuila,05,Matamoros,05017,59181,58980,118161
2019,Coahuila,05,Monclova,05018,123572,124598,248170
2019,Coahuila,05,Morelos,05019,4721,4578,9299
2019,Coahuila,05,Múzquiz,05020,37803,36919,74722
2019,Coahuila,05,Nadadores,05021,3567,3504,7071
2019,Coahuila,05,Nava,05022,16782,15911,32693
2019,Coahuila,05,Ocampo,05023,6036,5592,11628
2019,Coahuila,05,Parras,05024,24741,23635,48376
2019,Coahuila,05,Piedras Negras,05025,88104,87181,175285
2019,Coahuila,05,Progreso,05026,1877,1749,3626
2019,Coahuila,05,Ramos Arizpe,05027,51421,49404,100825
2019,Coahuila,05,Sabinas,05028,34393,34178,68571
2019,Coahuila,05,Sacramento,05029,1308,1269,2577
2019,Coahuila,05,Saltillo,05030,427518,429024,856542
2019,Coahuila,05,San Buenaventura,05031,12737,12703,25440
2019,Coahuila,05,San Juan de Sabinas,05032,23018,23757,46775
2019,Coahuila,05,San Pedro,05033,57835,57815,115650
2019,Coahuila,05,Sierra Mojada,05034,3931,3631,7562
2019,Coahuila,05,Torreón,05035,359433,374670,734103
2019,Coahuila,05,Viesca,05036,11943,11517,23460
2019,Coahuila,05,Villa Unión,05037,3496,3307,6803
2019,Coahuila,05,Zaragoza,05038,7089,7003,14092
2019,Colima,06,Armería,06001,16063,15872,31935
2019,Colima,06,Colima,06002,81227,85546,166773
2019,Colima,06,Comala,06003,11879,11727,23606
2019,Colima,06,Coquimatlán,06004,11044,10847,21891
2019,Colima,06,Cuauhtémoc,06005,16233,16124,32357
2019,Colima,06,Ixtlahuacán,06006,3022,2976,5998
2019,Colima,06,Manzanillo,06007,100812,98879,199691
2019,Colima,06,Minatitlán,06008,4958,4578,9536
2019,Colima,06,Tecomán,06009,66896,65743,132639
2019,Colima,06,Villa de Álvarez,06010,72391,76025,148416
2019,Durango,10,Canatlán,10001,17065,17420,34485
2019,Durango,10,Canelas,10002,2506,2276,4782
2019,Durango,10,Coneto de Comonfort,10003,2291,2339,4630
2019,Durango,10,Cuencamé,10004,18750,18450,37200
2019,Durango,10,Durango,10005,333519,354734,688253
2019,Durango,10,El Oro,10018,6061,6117,12178
2019,Durango,10,General Simón Bolívar,10006,5320,5433,10753
2019,Durango,10,Guadalupe Victoria,10008,18588,18932,37520
2019,Durango,10,Guanaceví,10009,5414,5073,10487
2019,Durango,10,Gómez Palacio,10007,181865,184987,366852
2019,Durango,10,Hidalgo,10010,2108,2048,4156
2019,Durango,10,Indé,10011,2675,2672,5347
2019,Durango,10,Lerdo,10012,81220,81901,163121
2019,Durango,10,Mapimí,10013,14022,14007,28029
2019,Durango,10,Mezquital,10014,19802,20401,40203
2019,Durango,10,Nazas,10015,6863,6902,13765
2019,Durango,10,Nombre de Dios,10016,10302,10396,20698
2019,Durango,10,Nuevo Ideal,10039,14252,14378,28630
2019,Durango,10,Ocampo,10017,5238,5012,10250
2019,Durango,10,Otáez,10019,2848,2646,5494
2019,Durango,10,Peñón Blanco,10021,5758,5704,11462
2019,Durango,10,Poanas,10022,13195,13565,26760
2019,Durango,10,Pueblo Nuevo,10023,26333,26506,52839
2019,Durango,10,Pánuco de Coronado,10020,6330,6516,12846
2019,Durango,10,Rodeo,10024,7139,7113,14252
2019,Durango,10,San Bernardo,10025,1827,1626,3453
2019,Durango,10,San Dimas,10026,10379,9733,20112
2019,Durango,10,San Juan de Guadalupe,10027,2913,2997,5910
2019,Durango,10,San Juan del Río,10028,6509,6679,13188
2019,Durango,10,San Luis del Cordero,10029,1137,1105,2242
2019,Durango,10,San Pedro del Gallo,10030,838,784,1622
2019,Durango,10,Santa Clara,10031,3717,3741,7458
2019,Durango,10,Santiago Papasquiaro,10032,25382,25336,50718
2019,Durango,10,Súchil,10033,3244,3526,6770
2019,Durango,10,Tamazula,10034,14312,13112,27424
2019,Durango,10,Tepehuanes,10035,5746,5775,11521
2019,Durango,10,Tlahualilo,10036,12444,12192,24636
2019,Durango,10,Topia,10037,5030,4723,9753
2019,Durango,10,Vicente Guerrero,10038,11240,11913,23153
2019,Estado de México,15,Acambay de Ruíz Castañeda,15001,33380,35490,68870
2019,Estado de México,15,Acolman,15002,91196,90755,181951
2019,Estado de México,15,Aculco,15003,25437,26135,51572
2019,Estado de México,15,Almoloya de Alquisiras,15004,7453,8134,15587
2019,Estado de México,15,Almoloya de Juárez,15005,91564,93497,185061
2019,Estado de México,15,Almoloya del Río,15006,5796,6220,12016
2019,Estado de México,15,Amanalco,15007,12553,13061,25614
2019,Estado de México,15,Amatepec,15008,13704,14570,28274
2019,Estado de México,15,Amecameca,15009,26161,27983,54144
2019,Estado de México,15,Apaxco,15010,15431,15823,31254
2019,Estado de México,15,Atenco,15011,34070,34706,68776
2019,Estado de México,15,Atizapán,15012,5998,6344,12342
2019,Estado de México,15,Atizapán de Zaragoza,15013,268909,284436,553345
2019,Estado de México,15,Atlacomulco,15014,50930,55135,106065
2019,Estado de México,15,Atlautla,15015,15766,16526,32292
2019,Estado de México,15,Axapusco,15016,14718,14903,29621
2019,Estado de México,15,Ayapango,15017,5333,5540,10873
2019,Estado de México,15,Calimaya,15018,28918,30367,59285
2019,Estado de México,15,Capulhuac,15019,18397,19437,37834
2019,Estado de México,15,Chalco,15025,189955,198523,388478
2019,Estado de México,15,Chapa de Mota,15026,14705,15267,29972
2019,Estado de México,15,Chapultepec,15027,6235,6466,12701
2019,Estado de México,15,Chiautla,15028,15370,15934,31304
2019,Estado de México,15,Chicoloapan,15029,108162,114491,222653
2019,Estado de México,15,Chiconcuac,15030,13384,13772,27156
2019,Estado de México,15,Chimalhuacán,15031,350391,362776,713167
2019,Estado de México,15,Coacalco de Berriozábal,15020,149111,160064,309175
2019,Estado de México,15,Coatepec Harinas,15021,19866,21423,41289
2019,Estado de México,15,Cocotitlán,15022,7421,7759,15180
2019,Estado de México,15,Coyotepec,15023,21748,22173,43921
2019,Estado de México,15,Cuautitlán,15024,84945,86988,171933
2019,Estado de México,15,Cuautitlán Izcalli,15121,279210,293534,572744
2019,Estado de México,15,Donato Guerra,15032,17654,18201,35855
2019,Estado de México,15,Ecatepec de Morelos,15033,839606,860131,1699737
2019,Estado de México,15,Ecatzingo,15034,4926,5081,10007
2019,Estado de México,15,El Oro,15064,19011,20125,39136
2019,Estado de México,15,Huehuetoca,15035,70723,72786,143509
2019,Estado de México,15,Hueypoxtla,15036,23260,22931,46191
2019,Estado de México,15,Huixquilucan,15037,138152,148429,286581
2019,Estado de México,15,Isidro Fabela,15038,6110,6230,12340
2019,Estado de México,15,Ixtapaluca,15039,266848,277238,544086
2019,Estado de México,15,Ixtapan de la Sal,15040,18223,19634,37857
2019,Estado de México,15,Ixtapan del Oro,15041,3653,3568,7221
2019,Estado de México,15,Ixtlahuaca,15042,77999,83397,161396
2019,Estado de México,15,Jaltenco,15044,14148,14979,29127
2019,Estado de México,15,Jilotepec,15045,46109,47643,93752
2019,Estado de México,15,Jilotzingo,15046,9968,10505,20473
2019,Estado de México,15,Jiquipilco,15047,37950,40354,78304
2019,Estado de México,15,Jocotitlán,15048,33669,35999,69668
2019,Estado de México,15,Joquicingo,15049,7091,7455,14546
2019,Estado de México,15,Juchitepec,15050,13266,13658,26924
2019,Estado de México,15,La Paz,15070,150956,154956,305912
2019,Estado de México,15,Lerma,15051,77693,79774,157467
2019,Estado de México,15,Luvianos,15123,14667,14925,29592
2019,Estado de México,15,Malinalco,15052,14356,14817,29173
2019,Estado de México,15,Melchor Ocampo,15053,29438,30701,60139
2019,Estado de México,15,Metepec,15054,118259,125659,243918
2019,Estado de México,15,Mexicaltzingo,15055,6569,6994,13563
2019,Estado de México,15,Morelos,15056,15117,16429,31546
2019,Estado de México,15,Naucalpan de Juárez,15057,439224,464736,903960
2019,Estado de México,15,Nextlalpan,15059,21132,21608,42740
2019,Estado de México,15,Nezahualcóyotl,15058,546128,585848,1131976
2019,Estado de México,15,Nicolás Romero,15060,213071,221452,434523
2019,Estado de México,15,Nopaltepec,15061,4824,4844,9668
2019,Estado de México,15,Ocoyoacac,15062,34846,35970,70816
2019,Estado de México,15,Ocuilan,15063,17715,18450,36165
2019,Estado de México,15,Otumba,15065,19016,18771,37787
2019,Estado de México,15,Otzoloapan,15066,2154,2114,4268
2019,Estado de México,15,Otzolotepec,15067,44241,45397,89638
2019,Estado de México,15,Ozumba,15068,14815,15995,30810
2019,Estado de México,15,Papalotla,15069,2116,2224,4340
2019,Estado de México,15,Polotitlán,15071,7283,7602,14885
2019,Estado de México,15,Rayón,15072,7090,7317,14407
2019,Estado de México,15,San Antonio la Isla,15073,15222,15656,30878
2019,Estado de México,15,San Felipe del Progreso,15074,65699,73368,139067
2019,Estado de México,15,San José del Rincón,15124,48748,49483,98231
2019,Estado de México,15,San Martín de las Pirámides,15075,14209,14562,28771
2019,Estado de México,15,San Mateo Atenco,15076,39427,40781,80208
2019,Estado de México,15,San Simón de Guerrero,15077,3153,3354,6507
2019,Estado de México,15,Santo Tomás,15078,5013,5164,10177
2019,Estado de México,15,Soyaniquilpan de Juárez,15079,6987,7144,14131
2019,Estado de México,15,Sultepec,15080,13263,14762,28025
2019,Estado de México,15,Tecámac,15081,238685,250385,489070
2019,Estado de México,15,Tejupilco,15082,38179,41376,79555
2019,Estado de México,15,Temamatla,15083,6555,6964,13519
2019,Estado de México,15,Temascalapa,15084,20597,20639,41236
2019,Estado de México,15,Temascalcingo,15085,32102,34781,66883
2019,Estado de México,15,Temascaltepec,15086,16725,17385,34110
2019,Estado de México,15,Temoaya,15087,52504,55414,107918
2019,Estado de México,15,Tenancingo,15088,50570,53435,104005
2019,Estado de México,15,Tenango del Aire,15089,6482,6652,13134
2019,Estado de México,15,Tenango del Valle,15090,44544,46367,90911
2019,Estado de México,15,Teoloyucan,15091,34471,35091,69562
2019,Estado de México,15,Teotihuacán,15092,29710,30631,60341
2019,Estado de México,15,Tepetlaoxtoc,15093,16178,16521,32699
2019,Estado de México,15,Tepetlixpa,15094,10314,10609,20923
2019,Estado de México,15,Tepotzotlán,15095,50513,52248,102761
2019,Estado de México,15,Tequixquiac,15096,19471,19729,39200
2019,Estado de México,15,Texcaltitlán,15097,9637,10303,19940
2019,Estado de México,15,Texcalyacac,15098,2786,2863,5649
2019,Estado de México,15,Texcoco,15099,126363,133182,259545
2019,Estado de México,15,Tezoyuca,15100,22626,22915,45541
2019,Estado de México,15,Tianguistenco,15101,39676,41848,81524
2019,Estado de México,15,Timilpan,15102,8023,8662,16685
2019,Estado de México,15,Tlalmanalco,15103,24588,26368,50956
2019,Estado de México,15,Tlalnepantla de Baz,15104,363085,387139,750224
2019,Estado de México,15,Tlatlaya,15105,18195,18999,37194
2019,Estado de México,15,Toluca,15106,453268,484726,937994
2019,Estado de México,15,Tonanitla,15125,5373,5510,10883
2019,Estado de México,15,Tonatico,15107,6496,6912,13408
2019,Estado de México,15,Tultepec,15108,77819,80861,158680
2019,Estado de México,15,Tultitlán,15109,271332,281396,552728
2019,Estado de México,15,Valle de Bravo,15110,34132,35468,69600
2019,Estado de México,15,Valle de Chalco Solidaridad,15122,204182,210985,415167
2019,Estado de México,15,Villa Guerrero,15113,34797,35949,70746
2019,Estado de México,15,Villa Victoria,15114,54121,54784,108905
2019,Estado de México,15,Villa de Allende,15111,26651,27624,54275
2019,Estado de México,15,Villa del Carbón,15112,25163,24912,50075
2019,Estado de México,15,Xalatlaco,15043,15382,16221,31603
2019,Estado de México,15,Xonacatlán,15115,27068,26970,54038
2019,Estado de México,15,Zacazonapan,15116,2179,2162,4341
2019,Estado de México,15,Zacualpan,15117,7603,8354,15957
2019,Estado de México,15,Zinacantepec,15118,98053,100836,198889
2019,Estado de México,15,Zumpahuacán,15119,8545,9311,17856
2019,Estado de México,15,Zumpango,15120,102870,110004,212874
2019,Guanajuato,11,Abasolo,11001,45934,48909,94843
2019,Guanajuato,11,Acámbaro,11002,56796,61376,118172
2019,Guanajuato,11,Apaseo el Alto,11004,34999,36666,71665
2019,Guanajuato,11,Apaseo el Grande,11005,47562,50360,97922
2019,Guanajuato,11,Atarjea,11006,2714,2822,5536
2019,Guanajuato,11,Celaya,11007,256025,270141,526166
2019,Guanajuato,11,Comonfort,11009,41044,45481,86525
2019,Guanajuato,11,Coroneo,11010,6110,6786,12896
2019,Guanajuato,11,Cortazar,11011,48923,51598,100521
2019,Guanajuato,11,Cuerámaro,11012,14310,15423,29733
2019,Guanajuato,11,Doctor Mora,11013,12276,13165,25441
2019,Guanajuato,11,Dolores Hidalgo Cuna de la Independencia Nacional,11014,75810,84072,159882
2019,Guanajuato,11,Guanajuato,11015,96217,99887,196104
2019,Guanajuato,11,Huanímaro,11016,10639,11803,22442
2019,Guanajuato,11,Irapuato,11017,295229,309549,604778
2019,Guanajuato,11,Jaral del Progreso,11018,19991,20752,40743
2019,Guanajuato,11,Jerécuaro,11019,23955,27289,51244
2019,Guanajuato,11,León,11020,826373,837031,1663404
2019,Guanajuato,11,Manuel Doblado,11008,19235,21125,40360
2019,Guanajuato,11,Moroleón,11021,25822,28138,53960
2019,Guanajuato,11,Ocampo,11022,11900,12687,24587
2019,Guanajuato,11,Pueblo Nuevo,11024,5914,6579,12493
2019,Guanajuato,11,Purísima del Rincón,11025,42399,42310,84709
2019,Guanajuato,11,Pénjamo,11023,76036,83075,159111
2019,Guanajuato,11,Romita,11026,30193,32000,62193
2019,Guanajuato,11,Salamanca,11027,141884,148853,290737
2019,Guanajuato,11,Salvatierra,11028,50688,55511,106199
2019,Guanajuato,11,San Diego de la Unión,11029,19263,22011,41274
2019,Guanajuato,11,San Felipe,11030,57052,60485,117537
2019,Guanajuato,11,San Francisco del Rincón,11031,61148,63971,125119
2019,Guanajuato,11,San José Iturbide,11032,40101,42519,82620
2019,Guanajuato,11,San Luis de la Paz,11033,60466,66273,126739
2019,Guanajuato,11,San Miguel de Allende,11003,87178,94054,181232
2019,Guanajuato,11,Santa Catarina,11034,2648,2894,5542
2019,Guanajuato,11,Santa Cruz de Juventino Rosas,11035,42448,45452,87900
2019,Guanajuato,11,Santiago Maravatío,11036,3446,3809,7255
2019,Guanajuato,11,Silao de la Victoria,11037,98250,100562,198812
2019,Guanajuato,11,Tarandacuao,11038,6126,6723,12849
2019,Guanajuato,11,Tarimoro,11039,17678,18752,36430
2019,Guanajuato,11,Tierra Blanca,11040,9729,10324,20053
2019,Guanajuato,11,Uriangato,11041,32269,34311,66580
2019,Guanajuato,11,Valle de Santiago,11042,72508,79417,151925
2019,Guanajuato,11,Victoria,11043,10162,11216,21378
2019,Guanajuato,11,Villagrán,11044,30550,31821,62371
2019,Guanajuato,11,Xichú,11045,5854,6351,12205
2019,Guanajuato,11,Yuriria,11046,34968,38563,73531
2019,Guerrero,12,Acapulco de Juárez,12001,403990,433924,837914
2019,Guerrero,12,Acatepec,12076,18868,19740,38608
2019,Guerrero,12,Ahuacuotzingo,12002,12743,14491,27234
2019,Guerrero,12,Ajuchitlán del Progreso,12003,18832,20138,38970
2019,Guerrero,12,Alcozauca de Guerrero,12004,9354,10643,19997
2019,Guerrero,12,Alpoyeca,12005,3260,3671,6931
2019,Guerrero,12,Apaxtla,12006,5638,6113,11751
2019,Guerrero,12,Arcelia,12007,15806,16781,32587
2019,Guerrero,12,Atenango del Río,12008,4246,4643,8889
2019,Guerrero,12,Atlamajalcingo del Monte,12009,2528,2800,5328
2019,Guerrero,12,Atlixtac,12010,13533,14476,28009
2019,Guerrero,12,Atoyac de Álvarez,12011,30717,31844,62561
2019,Guerrero,12,Ayutla de los Libres,12012,34219,35684,69903
2019,Guerrero,12,Azoyú,12013,6519,6932,13451
2019,Guerrero,12,Benito Juárez,12014,7742,8143,15885
2019,Guerrero,12,Buenavista de Cuéllar,12015,6679,7025,13704
2019,Guerrero,12,Chilapa de Álvarez,12028,62940,69559,132499
2019,Guerrero,12,Chilpancingo de los Bravo,12029,134973,146994,281967
2019,Guerrero,12,Coahuayutla de José María Izazaga,12016,6510,6249,12759
2019,Guerrero,12,Cochoapa el Grande,12078,9194,10139,19333
2019,Guerrero,12,Cocula,12017,6780,7304,14084
2019,Guerrero,12,Copala,12018,7159,7421,14580
2019,Guerrero,12,Copalillo,12019,7172,7912,15084
2019,Guerrero,12,Copanatoyac,12020,9875,10782,20657
2019,Guerrero,12,Coyuca de Benítez,12021,38617,40081,78698
2019,Guerrero,12,Coyuca de Catalán,12022,20545,20065,40610
2019,Guerrero,12,Cuajinicuilapa,12023,13915,13892,27807
2019,Guerrero,12,Cualác,12024,3741,4032,7773
2019,Guerrero,12,Cuautepec,12025,8236,8299,16535
2019,Guerrero,12,Cuetzala del Progreso,12026,4358,4604,8962
2019,Guerrero,12,Cutzamala de Pinzón,12027,10018,10425,20443
2019,Guerrero,12,Eduardo Neri,12075,25696,26823,52519
2019,Guerrero,12,Florencio Villarreal,12030,10602,10861,21463
2019,Guerrero,12,General Canuto A. Neri,12031,2863,3099,5962
2019,Guerrero,12,General Heliodoro Castillo,12032,18929,18907,37836
2019,Guerrero,12,Huamuxtitlán,12033,7376,8328,15704
2019,Guerrero,12,Huitzuco de los Figueroa,12034,18504,20103,38607
2019,Guerrero,12,Iguala de la Independencia,12035,75861,81363,157224
2019,Guerrero,12,Igualapa,12036,5695,5901,11596
2019,Guerrero,12,Iliatenco,12081,5381,5908,11289
2019,Guerrero,12,Ixcateopan de Cuauhtémoc,12037,3060,3387,6447
2019,Guerrero,12,José Joaquín de Herrera,12079,8823,8993,17816
2019,Guerrero,12,Juan R. Escudero,12039,12478,13204,25682
2019,Guerrero,12,Juchitán,12080,3970,3909,7879
2019,Guerrero,12,La Unión de Isidoro Montes de Oca,12068,13761,13211,26972
2019,Guerrero,12,Leonardo Bravo,12040,13233,13532,26765
2019,Guerrero,12,Malinaltepec,12041,13368,14952,28320
2019,Guerrero,12,Marquelia,12077,7061,7144,14205
2019,Guerrero,12,Metlatónoc,12043,9004,10344,19348
2019,Guerrero,12,Mochitlán,12044,6411,6680,13091
2019,Guerrero,12,Mártir de Cuilapan,12042,9133,10023,19156
2019,Guerrero,12,Olinalá,12045,12622,13649,26271
2019,Guerrero,12,Ometepec,12046,33834,35539,69373
2019,Guerrero,12,Pedro Ascencio Alquisiras,12047,3260,3803,7063
2019,Guerrero,12,Petatlán,12048,22549,22939,45488
2019,Guerrero,12,Pilcaya,12049,6390,6799,13189
2019,Guerrero,12,Pungarabato,12050,18842,20015,38857
2019,Guerrero,12,Quechultenango,12051,17998,18893,36891
2019,Guerrero,12,San Luis Acatlán,12052,22230,22834,45064
2019,Guerrero,12,San Marcos,12053,24927,25818,50745
2019,Guerrero,12,San Miguel Totolapan,12054,13928,14418,28346
2019,Guerrero,12,Taxco de Alarcón,12055,53888,58349,112237
2019,Guerrero,12,Tecoanapa,12056,23427,24084,47511
2019,Guerrero,12,Teloloapan,12058,27726,31111,58837
2019,Guerrero,12,Tepecoacuilco de Trujano,12059,15703,17033,32736
2019,Guerrero,12,Tetipac,12060,7192,7623,14815
2019,Guerrero,12,Tixtla de Guerrero,12061,21256,22978,44234
2019,Guerrero,12,Tlacoachistlahuaca,12062,11295,12691,23986
2019,Guerrero,12,Tlacoapa,12063,4924,5426,10350
2019,Guerrero,12,Tlalchapa,12064,6312,6331,12643
2019,Guerrero,12,Tlalixtaquilla de Maldonado,12065,3634,3953,7587
2019,Guerrero,12,Tlapa de Comonfort,12066,43951,48681,92632
2019,Guerrero,12,Tlapehuala,12067,10956,11751,22707
2019,Guerrero,12,Técpan de Galeana,12057,33100,33599,66699
2019,Guerrero,12,Xalpatláhuac,12069,5663,6605,12268
2019,Guerrero,12,Xochihuehuetlán,12070,3456,3943,7399
2019,Guerrero,12,Xochistlahuaca,12071,14608,15478,30086
2019,Guerrero,12,Zapotitlán Tablas,12072,5851,6459,12310
2019,Guerrero,12,Zihuatanejo de Azueta,12038,64275,65864,130139
2019,Guerrero,12,Zirándaro,12073,9379,9009,18388
2019,Guerrero,12,Zitlala,12074,11201,12528,23729
2019,Hidalgo,13,Acatlán,13001,10590,11366,21956
2019,Hidalgo,13,Acaxochitlán,13002,21999,23754,45753
2019,Hidalgo,13,Actopan,13003,28777,31896,60673
2019,Hidalgo,13,Agua Blanca de Iturbide,13004,4580,5060,9640
2019,Hidalgo,13,Ajacuba,13005,9609,10053,19662
2019,Hidalgo,13,Alfajayucan,13006,10572,11218,21790
2019,Hidalgo,13,Almoloya,13007,6467,6542,13009
2019,Hidalgo,13,Apan,13008,22836,24759,47595
2019,Hidalgo,13,Atitalaquia,13010,15753,16076,31829
2019,Hidalgo,13,Atlapexco,13011,10357,11126,21483
2019,Hidalgo,13,Atotonilco de Tula,13013,19624,20750,40374
2019,Hidalgo,13,Atotonilco el Grande,13012,13773,15424,29197
2019,Hidalgo,13,Calnali,13014,8928,9586,18514
2019,Hidalgo,13,Cardonal,13015,9416,10242,19658
2019,Hidalgo,13,Chapantongo,13017,7052,7428,14480
2019,Hidalgo,13,Chapulhuacán,13018,12686,12537,25223
2019,Hidalgo,13,Chilcuautla,13019,9519,9906,19425
2019,Hidalgo,13,Cuautepec de Hinojosa,13016,29418,32223,61641
2019,Hidalgo,13,El Arenal,13009,9549,10401,19950
2019,Hidalgo,13,Eloxochitlán,13020,1376,1566,2942
2019,Hidalgo,13,Emiliano Zapata,13021,7427,8195,15622
2019,Hidalgo,13,Epazoyucan,13022,7695,8135,15830
2019,Hidalgo,13,Francisco I. Madero,13023,18367,20053,38420
2019,Hidalgo,13,Huasca de Ocampo,13024,9023,9867,18890
2019,Hidalgo,13,Huautla,13025,11106,12009,23115
2019,Hidalgo,13,Huazalingo,13026,7253,7586,14839
2019,Hidalgo,13,Huehuetla,13027,13124,13956,27080
2019,Hidalgo,13,Huejutla de Reyes,13028,68152,70333,138485
2019,Hidalgo,13,Huichapan,13029,23605,25690,49295
2019,Hidalgo,13,Ixmiquilpan,13030,46521,52066,98587
2019,Hidalgo,13,Jacala de Ledezma,13031,6781,7553,14334
2019,Hidalgo,13,Jaltocán,13032,6249,6419,12668
2019,Hidalgo,13,Juárez Hidalgo,13033,1623,1760,3383
2019,Hidalgo,13,La Misión,13040,5348,5512,10860
2019,Hidalgo,13,Lolotla,13034,4989,5224,10213
2019,Hidalgo,13,Metepec,13035,5812,6585,12397
2019,Hidalgo,13,Metztitlán,13037,10444,11615,22059
2019,Hidalgo,13,Mineral de la Reforma,13051,86485,94634,181119
2019,Hidalgo,13,Mineral del Chico,13038,4618,4896,9514
2019,Hidalgo,13,Mineral del Monte,13039,7418,8139,15557
2019,Hidalgo,13,Mixquiahuala de Juárez,13041,23692,25628,49320
2019,Hidalgo,13,Molango de Escamilla,13042,6081,6325,12406
2019,Hidalgo,13,Nicolás Flores,13043,3450,3881,7331
2019,Hidalgo,13,Nopala de Villagrán,13044,8823,9129,17952
2019,Hidalgo,13,Omitlán de Juárez,13045,4972,5444,10416
2019,Hidalgo,13,Pachuca de Soto,13048,133309,145665,278974
2019,Hidalgo,13,Pacula,13047,2469,2856,5325
2019,Hidalgo,13,Pisaflores,13049,9373,9370,18743
2019,Hidalgo,13,Progreso de Obregón,13050,11885,13207,25092
2019,Hidalgo,13,San Agustín Metzquititlán,13036,4892,5344,10236
2019,Hidalgo,13,San Agustín Tlaxiaca,13052,18856,19714,38570
2019,Hidalgo,13,San Bartolo Tutotepec,13053,9883,10069,19952
2019,Hidalgo,13,San Felipe Orizatlán,13046,20454,21114,41568
2019,Hidalgo,13,San Salvador,13054,18145,19416,37561
2019,Hidalgo,13,Santiago Tulantepec de Lugo Guerrero,13056,18931,20671,39602
2019,Hidalgo,13,Santiago de Anaya,13055,8858,9311,18169
2019,Hidalgo,13,Singuilucan,13057,8466,8705,17171
2019,Hidalgo,13,Tasquillo,13058,8045,9481,17526
2019,Hidalgo,13,Tecozautla,13059,19187,20878,40065
2019,Hidalgo,13,Tenango de Doria,13060,9267,10213,19480
2019,Hidalgo,13,Tepeapulco,13061,28206,30055,58261
2019,Hidalgo,13,Tepehuacán de Guerrero,13062,16549,15992,32541
2019,Hidalgo,13,Tepeji del Río de Ocampo,13063,45660,46961,92621
2019,Hidalgo,13,Tepetitlán,13064,5673,5974,11647
2019,Hidalgo,13,Tetepango,13065,6180,6235,12415
2019,Hidalgo,13,Tezontepec de Aldama,13067,27815,28460,56275
2019,Hidalgo,13,Tianguistengo,13068,7774,8125,15899
2019,Hidalgo,13,Tizayuca,13069,66074,67751,133825
2019,Hidalgo,13,Tlahuelilpan,13070,10080,10396,20476
2019,Hidalgo,13,Tlahuiltepa,13071,5379,5462,10841
2019,Hidalgo,13,Tlanalapa,13072,5357,5706,11063
2019,Hidalgo,13,Tlanchinol,13073,20696,21057,41753
2019,Hidalgo,13,Tlaxcoapan,13074,15013,15418,30431
2019,Hidalgo,13,Tolcayuca,13075,8473,8958,17431
2019,Hidalgo,13,Tula de Allende,13076,57188,60370,117558
2019,Hidalgo,13,Tulancingo de Bravo,13077,79481,88157,167638
2019,Hidalgo,13,Villa de Tezontepec,13066,6530,6771,13301
2019,Hidalgo,13,Xochiatipan,13078,10269,10799,21068
2019,Hidalgo,13,Xochicoatlán,13079,4041,4166,8207
2019,Hidalgo,13,Yahualica,13080,12704,13209,25913
2019,Hidalgo,13,Zacualtipán de Ángeles,13081,17726,19392,37118
2019,Hidalgo,13,Zapotlán de Juárez,13082,9727,10488,20215
2019,Hidalgo,13,Zempoala,13083,24059,25408,49467
2019,Hidalgo,13,Zimapán,13084,19545,22691,42236
2019,Jalisco,14,Acatic,14001,11195,11645,22840
2019,Jalisco,14,Acatlán de Juárez,14002,12458,11602,24060
2019,Jalisco,14,Ahualulco de Mercado,14003,12110,12491,24601
2019,Jalisco,14,Amacueca,14004,2828,2974,5802
2019,Jalisco,14,Amatitán,14005,8114,8190,16304
2019,Jalisco,14,Ameca,14006,31550,32810,64360
2019,Jalisco,14,Arandas,14008,38762,41556,80318
2019,Jalisco,14,Atemajac de Brizuela,14010,3531,3578,7109
2019,Jalisco,14,Atengo,14011,3041,2820,5861
2019,Jalisco,14,Atenguillo,14012,2084,2151,4235
2019,Jalisco,14,Atotonilco el Alto,14013,31512,32603,64115
2019,Jalisco,14,Atoyac,14014,4168,4514,8682
2019,Jalisco,14,Autlán de Navarro,14015,31955,32902,64857
2019,Jalisco,14,Ayotlán,14016,19767,20662,40429
2019,Jalisco,14,Ayutla,14017,6645,6649,13294
2019,Jalisco,14,Bolaños,14019,4015,4033,8048
2019,Jalisco,14,Cabo Corrientes,14020,5721,5274,10995
2019,Jalisco,14,Casimiro Castillo,14021,11489,11521,23010
2019,Jalisco,14,Cañadas de Obregón,14117,2151,2252,4403
2019,Jalisco,14,Chapala,14030,26560,27703,54263
2019,Jalisco,14,Chimaltitán,14031,1770,1815,3585
2019,Jalisco,14,Chiquilistlán,14032,3228,3185,6413
2019,Jalisco,14,Cihuatlán,14022,22055,21501,43556
2019,Jalisco,14,Cocula,14024,13832,14539,28371
2019,Jalisco,14,Colotlán,14025,9253,9900,19153
2019,Jalisco,14,Concepción de Buenos Aires,14026,3314,3183,6497
2019,Jalisco,14,Cuautitlán de García Barragán,14027,9652,9361,19013
2019,Jalisco,14,Cuautla,14028,1101,1180,2281
2019,Jalisco,14,Cuquío,14029,9173,10018,19191
2019,Jalisco,14,Degollado,14033,10969,11694,22663
2019,Jalisco,14,Ejutla,14034,1056,991,2047
2019,Jalisco,14,El Arenal,14009,10294,10457,20751
2019,Jalisco,14,El Grullo,14037,12729,13359,26088
2019,Jalisco,14,El Limón,14054,2928,2925,5853
2019,Jalisco,14,El Salto,14070,97765,98683,196448
2019,Jalisco,14,Encarnación de Díaz,14035,27343,29396,56739
2019,Jalisco,14,Etzatlán,14036,10267,10707,20974
2019,Jalisco,14,Guachinango,14038,2289,2211,4500
2019,Jalisco,14,Guadalajara,14039,730524,769749,1500273
2019,Jalisco,14,Gómez Farías,14079,7370,7848,15218
2019,Jalisco,14,Hostotipaquillo,14040,5829,5046,10875
2019,Jalisco,14,Huejuquilla el Alto,14042,4498,4859,9357
2019,Jalisco,14,Huejúcar,14041,2921,3218,6139
2019,Jalisco,14,Ixtlahuacán de los Membrillos,14044,28940,29558,58498
2019,Jalisco,14,Ixtlahuacán del Río,14045,9813,10436,20249
2019,Jalisco,14,Jalostotitlán,14046,17616,18097,35713
2019,Jalisco,14,Jamay,14047,13102,13109,26211
2019,Jalisco,14,Jesús María,14048,9279,10974,20253
2019,Jalisco,14,Jilotlán de los Dolores,14049,5165,4950,10115
2019,Jalisco,14,Jocotepec,14050,24274,24572,48846
2019,Jalisco,14,Juanacatlán,14051,9441,9441,18882
2019,Jalisco,14,Juchitlán,14052,2897,3078,5975
2019,Jalisco,14,La Barca,14018,33626,35780,69406
2019,Jalisco,14,La Huerta,14043,13115,12680,25795
2019,Jalisco,14,La Manzanilla de la Paz,14057,1926,2079,4005
2019,Jalisco,14,Lagos de Moreno,14053,85101,88842,173943
2019,Jalisco,14,Magdalena,14055,11925,11946,23871
2019,Jalisco,14,Mascota,14058,7616,7866,15482
2019,Jalisco,14,Mazamitla,14059,7096,7687,14783
2019,Jalisco,14,Mexticacán,14060,2534,2969,5503
2019,Jalisco,14,Mezquitic,14061,9960,10530,20490
2019,Jalisco,14,Mixtlán,14062,1884,1861,3745
2019,Jalisco,14,Ocotlán,14063,51775,53399,105174
2019,Jalisco,14,Ojuelos de Jalisco,14064,16490,17280,33770
2019,Jalisco,14,Pihuamo,14065,6032,5943,11975
2019,Jalisco,14,Poncitlán,14066,26991,27676,54667
2019,Jalisco,14,Puerto Vallarta,14067,149696,146103,295799
2019,Jalisco,14,Quitupan,14069,4143,4629,8772
2019,Jalisco,14,San Cristóbal de la Barranca,14071,1570,1591,3161
2019,Jalisco,14,San Diego de Alejandría,14072,3673,3953,7626
2019,Jalisco,14,San Gabriel,14113,8409,8749,17158
2019,Jalisco,14,San Ignacio Cerro Gordo,14125,9714,10299,20013
2019,Jalisco,14,San Juan de los Lagos,14073,36440,36979,73419
2019,Jalisco,14,San Juanito de Escobedo,14007,4971,4907,9878
2019,Jalisco,14,San Julián,14074,7990,8834,16824
2019,Jalisco,14,San Marcos,14075,2041,1985,4026
2019,Jalisco,14,San Martín Hidalgo,14077,14249,14965,29214
2019,Jalisco,14,San Martín de Bolaños,14076,1641,1626,3267
2019,Jalisco,14,San Miguel el Alto,14078,16922,17799,34721
2019,Jalisco,14,San Pedro Tlaquepaque,14098,349292,352152,701444
2019,Jalisco,14,San Sebastián del Oeste,14080,3113,2820,5933
2019,Jalisco,14,Santa María de los Ángeles,14081,1614,1793,3407
2019,Jalisco,14,Santa María del Oro,14056,1128,1115,2243
2019,Jalisco,14,Sayula,14082,18845,20227,39072
2019,Jalisco,14,Tala,14083,41837,42424,84261
2019,Jalisco,14,Talpa de Allende,14084,8008,7892,15900
2019,Jalisco,14,Tamazula de Gordiano,14085,19973,20847,40820
2019,Jalisco,14,Tapalpa,14086,10025,10419,20444
2019,Jalisco,14,Tecalitlán,14087,8623,9001,17624
2019,Jalisco,14,Techaluta de Montenegro,14089,1940,2006,3946
2019,Jalisco,14,Tecolotlán,14088,9156,9137,18293
2019,Jalisco,14,Tenamaxtlán,14090,3744,3722,7466
2019,Jalisco,14,Teocaltiche,14091,20874,22921,43795
2019,Jalisco,14,Teocuitatlán de Corona,14092,5451,5651,11102
2019,Jalisco,14,Tepatitlán de Morelos,14093,73669,76314,149983
2019,Jalisco,14,Tequila,14094,22131,22352,44483
2019,Jalisco,14,Teuchitlán,14095,5000,5202,10202
2019,Jalisco,14,Tizapán el Alto,14096,10900,11448,22348
2019,Jalisco,14,Tlajomulco de Zúñiga,14097,310667,315801,626468
2019,Jalisco,14,Tolimán,14099,5359,5451,10810
2019,Jalisco,14,Tomatlán,14100,19299,18356,37655
2019,Jalisco,14,Tonalá,14101,285932,284842,570774
2019,Jalisco,14,Tonaya,14102,3114,3241,6355
2019,Jalisco,14,Tonila,14103,4153,4187,8340
2019,Jalisco,14,Totatiche,14104,2316,2338,4654
2019,Jalisco,14,Tototlán,14105,12064,12366,24430
2019,Jalisco,14,Tuxcacuesco,14106,2337,2240,4577
2019,Jalisco,14,Tuxcueca,14107,3209,3421,6630
2019,Jalisco,14,Tuxpan,14108,17902,19010,36912
2019,Jalisco,14,Unión de San Antonio,14109,9190,9847,19037
2019,Jalisco,14,Unión de Tula,14110,6946,7417,14363
2019,Jalisco,14,Valle de Guadalupe,14111,3691,3721,7412
2019,Jalisco,14,Valle de Juárez,14112,2856,3013,5869
2019,Jalisco,14,Villa Corona,14114,9334,9578,18912
2019,Jalisco,14,Villa Guerrero,14115,2876,2961,5837
2019,Jalisco,14,Villa Hidalgo,14116,10425,11120,21545
2019,Jalisco,14,Villa Purificación,14068,6006,5604,11610
2019,Jalisco,14,Yahualica de González Gallo,14118,11419,12458,23877
2019,Jalisco,14,Zacoalco de Torres,14119,14960,15201,30161
2019,Jalisco,14,Zapopan,14120,698994,720684,1419678
2019,Jalisco,14,Zapotiltic,14121,15232,15865,31097
2019,Jalisco,14,Zapotitlán de Vadillo,14122,3720,3692,7412
2019,Jalisco,14,Zapotlanejo,14124,35373,36364,71737
2019,Jalisco,14,Zapotlán del Rey,14123,9553,9617,19170
2019,Jalisco,14,Zapotlán el Grande,14023,55113,57799,112912
2019,Michoacán,16,Acuitzio,16001,5748,6189,11937
2019,Michoacán,16,Aguililla,16002,7796,7633,15429
2019,Michoacán,16,Angamacutiro,16004,7447,8264,15711
2019,Michoacán,16,Angangueo,16005,5679,6008,11687
2019,Michoacán,16,Apatzingán,16006,66199,67199,133398
2019,Michoacán,16,Aporo,16007,1648,1756,3404
2019,Michoacán,16,Aquila,16008,13190,12744,25934
2019,Michoacán,16,Ario,16009,18675,19666,38341
2019,Michoacán,16,Arteaga,16010,11340,11432,22772
2019,Michoacán,16,Briseñas,16011,5778,6078,11856
2019,Michoacán,16,Buenavista,16012,24999,23970,48969
2019,Michoacán,16,Carácuaro,16013,4833,4814,9647
2019,Michoacán,16,Charapan,16021,6062,6860,12922
2019,Michoacán,16,Charo,16022,12006,11131,23137
2019,Michoacán,16,Chavinda,16023,5217,5499,10716
2019,Michoacán,16,Cherán,16024,9571,10291,19862
2019,Michoacán,16,Chilchota,16025,19602,21123,40725
2019,Michoacán,16,Chinicuila,16026,2631,2422,5053
2019,Michoacán,16,Chucándiro,16027,2103,2517,4620
2019,Michoacán,16,Churintzio,16028,2496,2830,5326
2019,Michoacán,16,Churumuco,16029,7909,7902,15811
2019,Michoacán,16,Coahuayana,16014,7802,7236,15038
2019,Michoacán,16,Coalcomán de Vázquez Pallares,16015,9146,9356,18502
2019,Michoacán,16,Coeneo,16016,9948,11652,21600
2019,Michoacán,16,Cojumatlán de Régules,16074,5320,5544,10864
2019,Michoacán,16,Contepec,16017,17349,18336,35685
2019,Michoacán,16,Copándaro,16018,4452,4991,9443
2019,Michoacán,16,Cotija,16019,9333,10342,19675
2019,Michoacán,16,Cuitzeo,16020,14771,16325,31096
2019,Michoacán,16,Ecuandureo,16030,6006,7140,13146
2019,Michoacán,16,Epitacio Huerta,16031,8522,8917,17439
2019,Michoacán,16,Erongarícuaro,16032,7712,8271,15983
2019,Michoacán,16,Gabriel Zamora,16033,11820,11887,23707
2019,Michoacán,16,Hidalgo,16034,62520,65849,128369
2019,Michoacán,16,Huandacareo,16036,5787,6614,12401
2019,Michoacán,16,Huaniqueo,16037,3823,4534,8357
2019,Michoacán,16,Huetamo,16038,20828,21771,42599
2019,Michoacán,16,Huiramba,16039,4504,4663,9167
2019,Michoacán,16,Indaparapeo,16040,8496,9025,17521
2019,Michoacán,16,Irimbo,16041,7530,8267,15797
2019,Michoacán,16,Ixtlán,16042,6639,6856,13495
2019,Michoacán,16,Jacona,16043,35130,37102,72232
2019,Michoacán,16,Jiménez,16044,6348,6943,13291
2019,Michoacán,16,Jiquilpan,16045,16495,18146,34641
2019,Michoacán,16,José Sixto Verduzco,16113,12959,14366,27325
2019,Michoacán,16,Jungapeo,16047,11029,11207,22236
2019,Michoacán,16,Juárez,16046,7386,7765,15151
2019,Michoacán,16,La Huacana,16035,17609,17799,35408
2019,Michoacán,16,La Piedad,16069,52457,57055,109512
2019,Michoacán,16,Lagunillas,16048,2862,2961,5823
2019,Michoacán,16,Los Reyes,16075,35414,37001,72415
2019,Michoacán,16,Lázaro Cárdenas,16052,96189,95265,191454
2019,Michoacán,16,Madero,16049,9408,9257,18665
2019,Michoacán,16,Maravatío,16050,44097,47658,91755
2019,Michoacán,16,Marcos Castellanos,16051,6938,7444,14382
2019,Michoacán,16,Morelia,16053,395100,424261,819361
2019,Michoacán,16,Morelos,16054,3562,4336,7898
2019,Michoacán,16,Múgica,16055,23564,24060,47624
2019,Michoacán,16,Nahuatzen,16056,14408,15284,29692
2019,Michoacán,16,Nocupétaro,16057,4195,4269,8464
2019,Michoacán,16,Nuevo Parangaricutiro,16058,10134,10529,20663
2019,Michoacán,16,Nuevo Urecho,16059,4220,4230,8450
2019,Michoacán,16,Numarán,16060,4874,5367,10241
2019,Michoacán,16,Ocampo,16061,12633,12640,25273
2019,Michoacán,16,Pajacuarán,16062,9792,10476,20268
2019,Michoacán,16,Panindícuaro,16063,7741,8732,16473
2019,Michoacán,16,Paracho,16065,18622,20396,39018
2019,Michoacán,16,Parácuaro,16064,14043,13759,27802
2019,Michoacán,16,Penjamillo,16067,8239,9432,17671
2019,Michoacán,16,Peribán,16068,14603,14459,29062
2019,Michoacán,16,Puruándiro,16071,33146,37057,70203
2019,Michoacán,16,Purépero,16070,7857,8217,16074
2019,Michoacán,16,Pátzcuaro,16066,46777,50634,97411
2019,Michoacán,16,Queréndaro,16072,6966,7334,14300
2019,Michoacán,16,Quiroga,16073,13798,15082,28880
2019,Michoacán,16,Sahuayo,16076,39417,41197,80614
2019,Michoacán,16,Salvador Escalante,16079,24859,26321,51180
2019,Michoacán,16,San Lucas,16077,9351,9518,18869
2019,Michoacán,16,Santa Ana Maya,16078,6094,6971,13065
2019,Michoacán,16,Senguio,16080,9598,10241,19839
2019,Michoacán,16,Susupuato,16081,4528,4591,9119
2019,Michoacán,16,Tacámbaro,16082,39227,40985,80212
2019,Michoacán,16,Tancítaro,16083,16421,16047,32468
2019,Michoacán,16,Tangamandapio,16084,14788,15939,30727
2019,Michoacán,16,Tangancícuaro,16085,16993,18087,35080
2019,Michoacán,16,Tanhuato,16086,7897,8310,16207
2019,Michoacán,16,Taretan,16087,7572,7762,15334
2019,Michoacán,16,Tarímbaro,16088,55853,60396,116249
2019,Michoacán,16,Tepalcatepec,16089,12537,12253,24790
2019,Michoacán,16,Tingambato,16090,7650,8097,15747
2019,Michoacán,16,Tingüindín,16091,7306,7897,15203
2019,Michoacán,16,Tiquicheo de Nicolás Romero,16092,6993,7106,14099
2019,Michoacán,16,Tlalpujahua,16093,14289,15840,30129
2019,Michoacán,16,Tlazazalca,16094,3208,3425,6633
2019,Michoacán,16,Tocumbo,16095,6181,6303,12484
2019,Michoacán,16,Tumbiscatío,16096,3609,3482,7091
2019,Michoacán,16,Turicato,16097,15895,16721,32616
2019,Michoacán,16,Tuxpan,16098,13670,14686,28356
2019,Michoacán,16,Tuzantla,16099,7941,8047,15988
2019,Michoacán,16,Tzintzuntzan,16100,7128,7892,15020
2019,Michoacán,16,Tzitzio,16101,4597,4475,9072
2019,Michoacán,16,Uruapan,16102,170897,180926,351823
2019,Michoacán,16,Venustiano Carranza,16103,12682,13167,25849
2019,Michoacán,16,Villamar,16104,8343,9077,17420
2019,Michoacán,16,Vista Hermosa,16105,10549,10929,21478
2019,Michoacán,16,Yurécuaro,16106,16015,16848,32863
2019,Michoacán,16,Zacapu,16107,38307,41125,79432
2019,Michoacán,16,Zamora,16108,100380,106058,206438
2019,Michoacán,16,Zinapécuaro,16110,23642,25625,49267
2019,Michoacán,16,Zináparo,16109,1530,1796,3326
2019,Michoacán,16,Ziracuaretiro,16111,8932,9124,18056
2019,Michoacán,16,Zitácuaro,16112,81941,88912,170853
2019,Michoacán,16,Álvaro Obregón,16003,10964,11758,22722
2019,Morelos,17,Amacuzac,17001,9118,9580,18698
2019,Morelos,17,Atlatlahucan,17002,11623,12109,23732
2019,Morelos,17,Axochiapan,17003,18650,19179,37829
2019,Morelos,17,Ayala,17004,43563,46483,90046
2019,Morelos,17,Coatlán del Río,17005,5107,5256,10363
2019,Morelos,17,Cuautla,17006,99230,106507,205737
2019,Morelos,17,Cuernavaca,17007,186929,209489,396418
2019,Morelos,17,Emiliano Zapata,17008,51559,53270,104829
2019,Morelos,17,Huitzilac,17009,10041,10093,20134
2019,Morelos,17,Jantetelco,17010,8864,9268,18132
2019,Morelos,17,Jiutepec,17011,109403,116317,225720
2019,Morelos,17,Jojutla,17012,29378,31462,60840
2019,Morelos,17,Jonacatepec,17013,7970,8602,16572
2019,Morelos,17,Mazatepec,17014,5182,5409,10591
2019,Morelos,17,Miacatlán,17015,13634,14371,28005
2019,Morelos,17,Ocuituco,17016,9597,9859,19456
2019,Morelos,17,Puente de Ixtla,17017,34400,35768,70168
2019,Morelos,17,Temixco,17018,59977,62636,122613
2019,Morelos,17,Temoac,17033,8122,8606,16728
2019,Morelos,17,Tepalcingo,17019,13975,14609,28584
2019,Morelos,17,Tepoztlán,17020,24832,25685,50517
2019,Morelos,17,Tetecala,17021,4106,4132,8238
2019,Morelos,17,Tetela del Volcán,17022,10568,11194,21762
2019,Morelos,17,Tlalnepantla,17023,3858,3763,7621
2019,Morelos,17,Tlaltizapán de Zapata,17024,26833,28180,55013
2019,Morelos,17,Tlaquiltenango,17025,17664,18110,35774
2019,Morelos,17,Tlayacapan,17026,9358,9548,18906
2019,Morelos,17,Totolapan,17027,6240,6414,12654
2019,Morelos,17,Xochitepec,17028,37313,36381,73694
2019,Morelos,17,Yautepec,17029,52983,55837,108820
2019,Morelos,17,Yecapixtla,17030,27448,28073,55521
2019,Morelos,17,Zacatepec,17031,18656,20133,38789
2019,Morelos,17,Zacualpan,17032,4918,5146,10064
2019,Nayarit,18,Acaponeta,18001,20102,19967,40069
2019,Nayarit,18,Ahuacatlán,18002,8558,8478,17036
2019,Nayarit,18,Amatlán de Cañas,18003,6408,6182,12590
2019,Nayarit,18,Bahía de Banderas,18020,86715,83539,170254
2019,Nayarit,18,Compostela,18004,40632,40281,80913
2019,Nayarit,18,Del Nayar,18009,22368,22243,44611
2019,Nayarit,18,Huajicori,18005,6819,6555,13374
2019,Nayarit,18,Ixtlán del Río,18006,15229,16176,31405
2019,Nayarit,18,Jala,18007,9829,9980,19809
2019,Nayarit,18,La Yesca,18019,7634,7232,14866
2019,Nayarit,18,Rosamorada,18010,18802,17980,36782
2019,Nayarit,18,Ruíz,18011,13477,13124,26601
2019,Nayarit,18,San Blas,18012,25003,22455,47458
2019,Nayarit,18,San Pedro Lagunillas,18013,4133,4015,8148
2019,Nayarit,18,Santa María del Oro,18014,12947,12328,25275
2019,Nayarit,18,Santiago Ixcuintla,18015,53307,51481,104788
2019,Nayarit,18,Tecuala,18016,21698,20961,42659
2019,Nayarit,18,Tepic,18017,215124,224792,439916
2019,Nayarit,18,Tuxpan,18018,16454,16562,33016
2019,Nayarit,18,Xalisco,18008,29948,31128,61076
2019,Nuevo León,19,Abasolo,19001,1458,1453,2911
2019,Nuevo León,19,Agualeguas,19002,1346,1281,2627
2019,Nuevo León,19,Allende,19004,19062,18735,37797
2019,Nuevo León,19,Anáhuac,19005,9890,9954,19844
2019,Nuevo León,19,Apodaca,19006,329744,324505,654249
2019,Nuevo León,19,Aramberri,19007,8886,8700,17586
2019,Nuevo León,19,Bustamante,19008,2170,2160,4330
2019,Nuevo León,19,Cadereyta Jiménez,19009,53227,50505,103732
2019,Nuevo León,19,Cerralvo,19011,4288,4024,8312
2019,Nuevo León,19,China,19013,6076,5780,11856
2019,Nuevo León,19,Ciénega de Flores,19012,25013,24085,49098
2019,Nuevo León,19,Doctor Arroyo,19014,18906,18606,37512
2019,Nuevo León,19,Doctor Coss,19015,933,889,1822
2019,Nuevo León,19,Doctor González,19016,1678,1600,3278
2019,Nuevo León,19,El Carmen,19010,23122,22670,45792
2019,Nuevo León,19,Galeana,19017,22524,22019,44543
2019,Nuevo León,19,García,19018,146151,144760,290911
2019,Nuevo León,19,General Bravo,19020,3114,2945,6059
2019,Nuevo León,19,General Escobedo,19021,230142,228929,459071
2019,Nuevo León,19,General Terán,19022,8035,8077,16112
2019,Nuevo León,19,General Treviño,19023,586,610,1196
2019,Nuevo León,19,General Zaragoza,19024,3387,3159,6546
2019,Nuevo León,19,General Zuazua,19025,44858,44117,88975
2019,Nuevo León,19,Guadalupe,19026,358220,348011,706231
2019,Nuevo León,19,Hidalgo,19047,7978,7897,15875
2019,Nuevo León,19,Higueras,19028,885,815,1700
2019,Nuevo León,19,Hualahuises,19029,3793,3868,7661
2019,Nuevo León,19,Iturbide,19030,2044,1893,3937
2019,Nuevo León,19,Juárez,19031,195008,190869,385877
2019,Nuevo León,19,Lampazos de Naranjo,19032,2900,2819,5719
2019,Nuevo León,19,Linares,19033,43765,43918,87683
2019,Nuevo León,19,Los Aldamas,19003,752,733,1485
2019,Nuevo León,19,Los Herreras,19027,983,1003,1986
2019,Nuevo León,19,Los Ramones,19042,2636,2567,5203
2019,Nuevo León,19,Marín,19034,3176,2974,6150
2019,Nuevo León,19,Melchor Ocampo,19035,536,521,1057
2019,Nuevo León,19,Mier y Noriega,19036,3815,3739,7554
2019,Nuevo León,19,Mina,19037,2993,2853,5846
2019,Nuevo León,19,Montemorelos,19038,33482,33352,66834
2019,Nuevo León,19,Monterrey,19039,547202,567841,1115043
2019,Nuevo León,19,Parás,19040,546,534,1080
2019,Nuevo León,19,Pesquería,19041,54577,54219,108796
2019,Nuevo León,19,Rayones,19043,1523,1419,2942
2019,Nuevo León,19,Sabinas Hidalgo,19044,19087,19623,38710
2019,Nuevo León,19,Salinas Victoria,19045,30825,29552,60377
2019,Nuevo León,19,San Nicolás de los Garza,19046,233210,240075,473285
2019,Nuevo León,19,San Pedro Garza García,19019,64451,72029,136480
2019,Nuevo León,19,Santa Catarina,19048,160236,158358,318594
2019,Nuevo León,19,Santiago,19049,23348,23087,46435
2019,Nuevo León,19,Vallecillo,19050,1041,880,1921
2019,Nuevo León,19,Villaldama,19051,2273,2254,4527
2019,Oaxaca,20,Abejones,20001,452,593,1045
2019,Oaxaca,20,Acatlán de Pérez Figueroa,20002,23194,24250,47444
2019,Oaxaca,20,Asunción Cacalotepec,20003,1061,1125,2186
2019,Oaxaca,20,Asunción Cuyotepeji,20004,476,547,1023
2019,Oaxaca,20,Asunción Ixtaltepec,20005,7845,7926,15771
2019,Oaxaca,20,Asunción Nochixtlán,20006,9198,10279,19477
2019,Oaxaca,20,Asunción Ocotlán,20007,1129,1403,2532
2019,Oaxaca,20,Asunción Tlacolulita,20008,392,411,803
2019,Oaxaca,20,Ayoquezco de Aldama,20398,2086,2358,4444
2019,Oaxaca,20,Ayotzintepec,20009,3676,3727,7403
2019,Oaxaca,20,Calihualá,20011,583,611,1194
2019,Oaxaca,20,Candelaria Loxicha,20012,5210,5545,10755
2019,Oaxaca,20,Capulálpam de Méndez,20247,722,886,1608
2019,Oaxaca,20,Chahuites,20025,5933,6019,11952
2019,Oaxaca,20,Chalcatongo de Hidalgo,20026,4367,4980,9347
2019,Oaxaca,20,Chiquihuitlán de Benito Juárez,20027,1107,1304,2411
2019,Oaxaca,20,Ciudad Ixtepec,20014,14420,15664,30084
2019,Oaxaca,20,Ciénega de Zimatlán,20013,1468,1605,3073
2019,Oaxaca,20,Coatecas Altas,20015,2250,2528,4778
2019,Oaxaca,20,Coicoyán de las Flores,20016,4811,5432,10243
2019,Oaxaca,20,Concepción Buenavista,20018,401,424,825
2019,Oaxaca,20,Concepción Pápalo,20019,1535,1535,3070
2019,Oaxaca,20,Constancia del Rosario,20020,1887,2189,4076
2019,Oaxaca,20,Cosolapa,20021,7793,8397,16190
2019,Oaxaca,20,Cosoltepec,20022,364,429,793
2019,Oaxaca,20,Cuilápam de Guerrero,20023,10892,11540,22432
2019,Oaxaca,20,Cuyamecalco Villa de Zaragoza,20024,1921,1881,3802
2019,Oaxaca,20,El Barrio de la Soledad,20010,7151,7691,14842
2019,Oaxaca,20,El Espinal,20030,4439,4633,9072
2019,Oaxaca,20,Eloxochitlán de Flores Magón,20029,2087,2331,4418
2019,Oaxaca,20,Fresnillo de Trujano,20032,505,545,1050
2019,Oaxaca,20,Guadalupe Etla,20033,1324,1472,2796
2019,Oaxaca,20,Guadalupe de Ramírez,20034,651,670,1321
2019,Oaxaca,20,Guelatao de Juárez,20035,284,289,573
2019,Oaxaca,20,Guevea de Humboldt,20036,2682,2801,5483
2019,Oaxaca,20,Heroica Ciudad de Ejutla de Crespo,20028,10249,11448,21697
2019,Oaxaca,20,Heroica Ciudad de Huajuapan de León,20039,38052,42338,80390
2019,Oaxaca,20,Heroica Ciudad de Juchitán de Zaragoza,20043,50070,52512,102582
2019,Oaxaca,20,Heroica Ciudad de Tlaxiaco,20397,19875,22452,42327
2019,Oaxaca,20,Huautepec,20040,3008,3435,6443
2019,Oaxaca,20,Huautla de Jiménez,20041,15128,17330,32458
2019,Oaxaca,20,Ixpantepec Nieves,20065,529,662,1191
2019,Oaxaca,20,Ixtlán de Juárez,20042,4170,4304,8474
2019,Oaxaca,20,La Compañía,20017,1613,1787,3400
2019,Oaxaca,20,La Pe,20069,1313,1409,2722
2019,Oaxaca,20,La Reforma,20076,1577,1746,3323
2019,Oaxaca,20,La Trinidad Vista Hermosa,20556,116,144,260
2019,Oaxaca,20,Loma Bonita,20044,21182,23189,44371
2019,Oaxaca,20,Magdalena Apasco,20045,4332,4816,9148
2019,Oaxaca,20,Magdalena Jaltepec,20046,1526,1787,3313
2019,Oaxaca,20,Magdalena Mixtepec,20048,685,708,1393
2019,Oaxaca,20,Magdalena Ocotlán,20049,577,627,1204
2019,Oaxaca,20,Magdalena Peñasco,20050,1688,1957,3645
2019,Oaxaca,20,Magdalena Teitipac,20051,2298,2462,4760
2019,Oaxaca,20,Magdalena Tequisistlán,20052,3091,3247,6338
2019,Oaxaca,20,Magdalena Tlacotepec,20053,617,676,1293
2019,Oaxaca,20,Magdalena Yodocono de Porfirio Díaz,20562,772,817,1589
2019,Oaxaca,20,Magdalena Zahuatlán,20054,200,227,427
2019,Oaxaca,20,Mariscala de Juárez,20055,1753,1906,3659
2019,Oaxaca,20,Matías Romero Avendaño,20057,19585,21055,40640
2019,Oaxaca,20,Mazatlán Villa de Flores,20058,6706,6807,13513
2019,Oaxaca,20,Mesones Hidalgo,20037,2078,2453,4531
2019,Oaxaca,20,Miahuatlán de Porfirio Díaz,20059,21607,23621,45228
2019,Oaxaca,20,Mixistlán de la Reforma,20060,1280,1431,2711
2019,Oaxaca,20,Monjas,20061,1287,1524,2811
2019,Oaxaca,20,Mártires de Tacubaya,20056,711,769,1480
2019,Oaxaca,20,Natividad,20062,288,329,617
2019,Oaxaca,20,Nazareno Etla,20063,2001,2207,4208
2019,Oaxaca,20,Nejapa de Madero,20064,3775,3930,7705
2019,Oaxaca,20,Nuevo Zoquiápam,20504,803,877,1680
2019,Oaxaca,20,Oaxaca de Juárez,20067,121197,137439,258636
2019,Oaxaca,20,Ocotlán de Morelos,20068,10920,11889,22809
2019,Oaxaca,20,Pinotepa de Don Luis,20070,3544,3633,7177
2019,Oaxaca,20,Pluma Hidalgo,20071,1464,1537,3001
2019,Oaxaca,20,Putla Villa de Guerrero,20073,16134,18191,34325
2019,Oaxaca,20,Reforma de Pineda,20075,1395,1483,2878
2019,Oaxaca,20,Reyes Etla,20077,1955,2087,4042
2019,Oaxaca,20,Rojas de Cuauhtémoc,20078,548,608,1156
2019,Oaxaca,20,Salina Cruz,20079,44252,47785,92037
2019,Oaxaca,20,San Agustín Amatengo,20080,688,783,1471
2019,Oaxaca,20,San Agustín Atenango,20081,837,970,1807
2019,Oaxaca,20,San Agustín Chayuco,20082,1950,2164,4114
2019,Oaxaca,20,San Agustín Etla,20084,2019,2221,4240
2019,Oaxaca,20,San Agustín Loxicha,20085,12485,12985,25470
2019,Oaxaca,20,San Agustín Tlacotepec,20086,417,554,971
2019,Oaxaca,20,San Agustín Yatareni,20087,2135,2430,4565
2019,Oaxaca,20,San Agustín de las Juntas,20083,4900,5099,9999
2019,Oaxaca,20,San Andrés Cabecera Nueva,20088,1411,1449,2860
2019,Oaxaca,20,San Andrés Dinicuiti,20089,1070,1132,2202
2019,Oaxaca,20,San Andrés Huaxpaltepec,20090,3092,3266,6358
2019,Oaxaca,20,San Andrés Huayápam,20091,2681,2934,5615
2019,Oaxaca,20,San Andrés Ixtlahuaca,20092,770,879,1649
2019,Oaxaca,20,San Andrés Lagunas,20093,233,272,505
2019,Oaxaca,20,San Andrés Nuxiño,20094,873,950,1823
2019,Oaxaca,20,San Andrés Paxtlán,20095,2232,2244,4476
2019,Oaxaca,20,San Andrés Sinaxtla,20096,363,410,773
2019,Oaxaca,20,San Andrés Solaga,20097,861,910,1771
2019,Oaxaca,20,San Andrés Teotilálpam,20098,2204,2379,4583
2019,Oaxaca,20,San Andrés Tepetlapa,20099,243,276,519
2019,Oaxaca,20,San Andrés Yaá,20100,207,251,458
2019,Oaxaca,20,San Andrés Zabache,20101,325,409,734
2019,Oaxaca,20,San Andrés Zautla,20102,2326,2463,4789
2019,Oaxaca,20,San Antonino Castillo Velasco,20103,2993,3277,6270
2019,Oaxaca,20,San Antonino Monte Verde,20105,3428,3992,7420
2019,Oaxaca,20,San Antonino el Alto,20104,1359,1401,2760
2019,Oaxaca,20,San Antonio Acutla,20106,120,146,266
2019,Oaxaca,20,San Antonio Huitepec,20108,2106,2439,4545
2019,Oaxaca,20,San Antonio Nanahuatípam,20109,635,643,1278
2019,Oaxaca,20,San Antonio Sinicahua,20110,754,872,1626
2019,Oaxaca,20,San Antonio Tepetlapa,20111,2136,2306,4442
2019,Oaxaca,20,San Antonio de la Cal,20107,11982,13324,25306
2019,Oaxaca,20,San Baltazar Chichicápam,20112,1217,1388,2605
2019,Oaxaca,20,San Baltazar Loxicha,20113,1494,1569,3063
2019,Oaxaca,20,San Baltazar Yatzachi el Bajo,20114,317,358,675
2019,Oaxaca,20,San Bartolo Coyotepec,20115,4779,5284,10063
2019,Oaxaca,20,San Bartolo Soyaltepec,20121,298,373,671
2019,Oaxaca,20,San Bartolo Yautepec,20122,335,341,676
2019,Oaxaca,20,San Bartolomé Ayautla,20116,2248,2384,4632
2019,Oaxaca,20,San Bartolomé Loxicha,20117,1200,1234,2434
2019,Oaxaca,20,San Bartolomé Quialana,20118,1055,1489,2544
2019,Oaxaca,20,San Bartolomé Yucuañe,20119,159,232,391
2019,Oaxaca,20,San Bartolomé Zoogocho,20120,136,185,321
2019,Oaxaca,20,San Bernardo Mixtepec,20123,1330,1451,2781
2019,Oaxaca,20,San Blas Atempa,20124,9499,9395,18894
2019,Oaxaca,20,San Carlos Yautepec,20125,6272,6199,12471
2019,Oaxaca,20,San Cristóbal Amatlán,20126,2522,2851,5373
2019,Oaxaca,20,San Cristóbal Amoltepec,20127,531,625,1156
2019,Oaxaca,20,San Cristóbal Lachirioag,20128,617,672,1289
2019,Oaxaca,20,San Cristóbal Suchixtlahuaca,20129,180,193,373
2019,Oaxaca,20,San Dionisio Ocotepec,20131,5173,5898,11071
2019,Oaxaca,20,San Dionisio Ocotlán,20132,590,608,1198
2019,Oaxaca,20,San Dionisio del Mar,20130,2737,2627,5364
2019,Oaxaca,20,San Esteban Atatlahuca,20133,1896,1986,3882
2019,Oaxaca,20,San Felipe Jalapa de Díaz,20134,14022,14926,28948
2019,Oaxaca,20,San Felipe Tejalápam,20135,3872,4237,8109
2019,Oaxaca,20,San Felipe Usila,20136,5771,6247,12018
2019,Oaxaca,20,San Francisco Cahuacuá,20137,1736,1762,3498
2019,Oaxaca,20,San Francisco Cajonos,20138,208,235,443
2019,Oaxaca,20,San Francisco Chapulapa,20139,1029,1107,2136
2019,Oaxaca,20,San Francisco Chindúa,20140,409,429,838
2019,Oaxaca,20,San Francisco Huehuetlán,20142,491,619,1110
2019,Oaxaca,20,San Francisco Ixhuatán,20143,4599,4690,9289
2019,Oaxaca,20,San Francisco Jaltepetongo,20144,499,519,1018
2019,Oaxaca,20,San Francisco Lachigoló,20145,2188,2273,4461
2019,Oaxaca,20,San Francisco Logueche,20146,1402,1592,2994
2019,Oaxaca,20,San Francisco Nuxaño,20147,198,189,387
2019,Oaxaca,20,San Francisco Ozolotepec,20148,957,1014,1971
2019,Oaxaca,20,San Francisco Sola,20149,831,926,1757
2019,Oaxaca,20,San Francisco Telixtlahuaca,20150,6452,6910,13362
2019,Oaxaca,20,San Francisco Teopan,20151,181,164,345
2019,Oaxaca,20,San Francisco Tlapancingo,20152,1041,1297,2338
2019,Oaxaca,20,San Francisco del Mar,20141,4069,3962,8031
2019,Oaxaca,20,San Gabriel Mixtepec,20153,2442,2606,5048
2019,Oaxaca,20,San Ildefonso Amatlán,20154,1189,1361,2550
2019,Oaxaca,20,San Ildefonso Sola,20155,504,499,1003
2019,Oaxaca,20,San Ildefonso Villa Alta,20156,1710,1814,3524
2019,Oaxaca,20,San Jacinto Amilpas,20157,8578,9456,18034
2019,Oaxaca,20,San Jacinto Tlacotepec,20158,1100,1165,2265
2019,Oaxaca,20,San Jerónimo Coatlán,20159,2674,2827,5501
2019,Oaxaca,20,San Jerónimo Silacayoapilla,20160,695,731,1426
2019,Oaxaca,20,San Jerónimo Sosola,20161,1261,1413,2674
2019,Oaxaca,20,San Jerónimo Taviche,20162,952,1039,1991
2019,Oaxaca,20,San Jerónimo Tecóatl,20163,782,878,1660
2019,Oaxaca,20,San Jerónimo Tlacochahuaya,20550,2681,3023,5704
2019,Oaxaca,20,San Jorge Nuchita,20164,1353,1591,2944
2019,Oaxaca,20,San José Ayuquila,20165,730,853,1583
2019,Oaxaca,20,San José Chiltepec,20166,6053,6420,12473
2019,Oaxaca,20,San José Estancia Grande,20168,539,544,1083
2019,Oaxaca,20,San José Independencia,20169,1848,1988,3836
2019,Oaxaca,20,San José Lachiguiri,20170,1621,1997,3618
2019,Oaxaca,20,San José Tenango,20171,9115,9823,18938
2019,Oaxaca,20,San José del Peñasco,20167,1076,1118,2194
2019,Oaxaca,20,San José del Progreso,20072,3416,3626,7042
2019,Oaxaca,20,San Juan Achiutla,20172,203,212,415
2019,Oaxaca,20,San Juan Atepec,20173,723,809,1532
2019,Oaxaca,20,San Juan Bautista Atatlahuca,20175,800,851,1651
2019,Oaxaca,20,San Juan Bautista Coixtlahuaca,20176,1313,1450,2763
2019,Oaxaca,20,San Juan Bautista Cuicatlán,20177,4996,5290,10286
2019,Oaxaca,20,San Juan Bautista Guelache,20178,3654,4074,7728
2019,Oaxaca,20,San Juan Bautista Jayacatlán,20179,774,759,1533
2019,Oaxaca,20,San Juan Bautista Lo de Soto,20180,1301,1327,2628
2019,Oaxaca,20,San Juan Bautista Suchitepec,20181,206,246,452
2019,Oaxaca,20,San Juan Bautista Tlachichilco,20183,667,774,1441
2019,Oaxaca,20,San Juan Bautista Tlacoatzintepec,20182,1069,1187,2256
2019,Oaxaca,20,San Juan Bautista Tuxtepec,20184,81519,88189,169708
2019,Oaxaca,20,San Juan Bautista Valle Nacional,20559,11142,12180,23322
2019,Oaxaca,20,San Juan Cacahuatepec,20185,4501,4712,9213
2019,Oaxaca,20,San Juan Chicomezúchil,20191,158,186,344
2019,Oaxaca,20,San Juan Chilateca,20192,731,845,1576
2019,Oaxaca,20,San Juan Cieneguilla,20186,282,308,590
2019,Oaxaca,20,San Juan Coatzóspam,20187,1105,1085,2190
2019,Oaxaca,20,San Juan Colorado,20188,4982,5289,10271
2019,Oaxaca,20,San Juan Comaltepec,20189,1422,1492,2914
2019,Oaxaca,20,San Juan Cotzocón,20190,11890,12525,24415
2019,Oaxaca,20,San Juan Diuxi,20195,555,565,1120
2019,Oaxaca,20,San Juan Evangelista Analco,20196,208,221,429
2019,Oaxaca,20,San Juan Guelavía,20197,1644,1741,3385
2019,Oaxaca,20,San Juan Guichicovi,20198,14408,16244,30652
2019,Oaxaca,20,San Juan Ihualtepec,20199,296,347,643
2019,Oaxaca,20,San Juan Juquila Mixes,20200,1868,2086,3954
2019,Oaxaca,20,San Juan Juquila Vijanos,20201,962,1050,2012
2019,Oaxaca,20,San Juan Lachao,20202,2388,2551,4939
2019,Oaxaca,20,San Juan Lachigalla,20203,1654,1769,3423
2019,Oaxaca,20,San Juan Lajarcia,20204,303,369,672
2019,Oaxaca,20,San Juan Lalana,20205,8580,8992,17572
2019,Oaxaca,20,San Juan Mazatlán,20207,9492,9638,19130
2019,Oaxaca,20,San Juan Mixtepec Distrito 08,20208,3323,3809,7132
2019,Oaxaca,20,San Juan Mixtepec Distrito 26,20209,292,415,707
2019,Oaxaca,20,San Juan Ozolotepec,20211,1410,1389,2799
2019,Oaxaca,20,San Juan Petlapa,20212,1468,1562,3030
2019,Oaxaca,20,San Juan Quiahije,20213,1946,2211,4157
2019,Oaxaca,20,San Juan Quiotepec,20214,1053,1088,2141
2019,Oaxaca,20,San Juan Sayultepec,20215,384,449,833
2019,Oaxaca,20,San Juan Tabaá,20216,654,717,1371
2019,Oaxaca,20,San Juan Tamazola,20217,1509,1582,3091
2019,Oaxaca,20,San Juan Teita,20218,305,320,625
2019,Oaxaca,20,San Juan Teitipac,20219,1289,1410,2699
2019,Oaxaca,20,San Juan Tepeuxila,20220,1418,1336,2754
2019,Oaxaca,20,San Juan Teposcolula,20221,630,667,1297
2019,Oaxaca,20,San Juan Yaeé,20222,731,828,1559
2019,Oaxaca,20,San Juan Yatzona,20223,215,272,487
2019,Oaxaca,20,San Juan Yucuita,20224,281,336,617
2019,Oaxaca,20,San Juan de los Cués,20206,1234,1261,2495
2019,Oaxaca,20,San Juan del Estado,20193,1320,1427,2747
2019,Oaxaca,20,San Juan del Río,20194,597,714,1311
2019,Oaxaca,20,San Juan Ñumí,20210,2875,3290,6165
2019,Oaxaca,20,San Lorenzo,20225,3048,3284,6332
2019,Oaxaca,20,San Lorenzo Albarradas,20226,1450,1409,2859
2019,Oaxaca,20,San Lorenzo Cacaotepec,20227,7870,8551,16421
2019,Oaxaca,20,San Lorenzo Cuaunecuiltitla,20228,439,397,836
2019,Oaxaca,20,San Lorenzo Texmelúcan,20229,3906,4536,8442
2019,Oaxaca,20,San Lorenzo Victoria,20230,494,510,1004
2019,Oaxaca,20,San Lucas Camotlán,20231,1515,1613,3128
2019,Oaxaca,20,San Lucas Ojitlán,20232,10223,10864,21087
2019,Oaxaca,20,San Lucas Quiaviní,20233,740,1049,1789
2019,Oaxaca,20,San Lucas Zoquiápam,20234,3740,3949,7689
2019,Oaxaca,20,San Luis Amatlán,20235,1732,2032,3764
2019,Oaxaca,20,San Marcial Ozolotepec,20236,740,816,1556
2019,Oaxaca,20,San Marcos Arteaga,20237,666,769,1435
2019,Oaxaca,20,San Martín Huamelúlpam,20239,496,590,1086
2019,Oaxaca,20,San Martín Itunyoso,20240,1035,1307,2342
2019,Oaxaca,20,San Martín Lachilá,20241,494,621,1115
2019,Oaxaca,20,San Martín Peras,20242,6045,6484,12529
2019,Oaxaca,20,San Martín Tilcajete,20243,836,1038,1874
2019,Oaxaca,20,San Martín Toxpalan,20244,1924,2034,3958
2019,Oaxaca,20,San Martín Zacatepec,20245,646,671,1317
2019,Oaxaca,20,San Martín de los Cansecos,20238,434,446,880
2019,Oaxaca,20,San Mateo Cajonos,20246,295,351,646
2019,Oaxaca,20,San Mateo Etlatongo,20250,573,607,1180
2019,Oaxaca,20,San Mateo Nejápam,20251,561,619,1180
2019,Oaxaca,20,San Mateo Peñasco,20252,1021,1180,2201
2019,Oaxaca,20,San Mateo Piñas,20253,993,1001,1994
2019,Oaxaca,20,San Mateo Río Hondo,20254,1586,1656,3242
2019,Oaxaca,20,San Mateo Sindihui,20255,995,1108,2103
2019,Oaxaca,20,San Mateo Tlapiltepec,20256,107,127,234
2019,Oaxaca,20,San Mateo Yoloxochitlán,20249,1780,1959,3739
2019,Oaxaca,20,San Mateo Yucutindoo,20566,1559,1598,3157
2019,Oaxaca,20,San Mateo del Mar,20248,7938,7691,15629
2019,Oaxaca,20,San Melchor Betaza,20257,494,566,1060
2019,Oaxaca,20,San Miguel Achiutla,20258,362,406,768
2019,Oaxaca,20,San Miguel Ahuehuetitlán,20259,1175,1297,2472
2019,Oaxaca,20,San Miguel Aloápam,20260,1080,1225,2305
2019,Oaxaca,20,San Miguel Amatitlán,20261,3662,4078,7740
2019,Oaxaca,20,San Miguel Amatlán,20262,495,526,1021
2019,Oaxaca,20,San Miguel Chicahua,20264,992,1222,2214
2019,Oaxaca,20,San Miguel Chimalapa,20265,3641,3446,7087
2019,Oaxaca,20,San Miguel Coatlán,20263,1567,1842,3409
2019,Oaxaca,20,San Miguel Ejutla,20268,471,555,1026
2019,Oaxaca,20,San Miguel Huautla,20270,539,627,1166
2019,Oaxaca,20,San Miguel Mixtepec,20271,1627,1682,3309
2019,Oaxaca,20,San Miguel Panixtlahuaca,20272,3070,3713,6783
2019,Oaxaca,20,San Miguel Peras,20273,1660,1795,3455
2019,Oaxaca,20,San Miguel Piedras,20274,650,684,1334
2019,Oaxaca,20,San Miguel Quetzaltepec,20275,4229,4177,8406
2019,Oaxaca,20,San Miguel Santa Flor,20276,367,365,732
2019,Oaxaca,20,San Miguel Soyaltepec,20278,19572,20733,40305
2019,Oaxaca,20,San Miguel Suchixtepec,20279,1346,1487,2833
2019,Oaxaca,20,San Miguel Tecomatlán,20281,169,144,313
2019,Oaxaca,20,San Miguel Tenango,20282,382,369,751
2019,Oaxaca,20,San Miguel Tequixtepec,20283,508,541,1049
2019,Oaxaca,20,San Miguel Tilquiápam,20284,1430,1796,3226
2019,Oaxaca,20,San Miguel Tlacamama,20285,1847,1910,3757
2019,Oaxaca,20,San Miguel Tlacotepec,20286,1519,1744,3263
2019,Oaxaca,20,San Miguel Tulancingo,20287,125,191,316
2019,Oaxaca,20,San Miguel Yotao,20288,297,327,624
2019,Oaxaca,20,San Miguel del Puerto,20266,4247,4342,8589
2019,Oaxaca,20,San Miguel del Río,20267,139,132,271
2019,Oaxaca,20,San Miguel el Grande,20269,2041,2300,4341
2019,Oaxaca,20,San Nicolás,20289,533,648,1181
2019,Oaxaca,20,San Nicolás Hidalgo,20290,477,559,1036
2019,Oaxaca,20,San Pablo Coatlán,20291,2126,2227,4353
2019,Oaxaca,20,San Pablo Cuatro Venados,20292,671,770,1441
2019,Oaxaca,20,San Pablo Etla,20293,8986,9933,18919
2019,Oaxaca,20,San Pablo Huitzo,20294,3468,3891,7359
2019,Oaxaca,20,San Pablo Huixtepec,20295,4630,5095,9725
2019,Oaxaca,20,San Pablo Macuiltianguis,20296,447,475,922
2019,Oaxaca,20,San Pablo Tijaltepec,20297,1126,1353,2479
2019,Oaxaca,20,San Pablo Villa de Mitla,20298,6270,6833,13103
2019,Oaxaca,20,San Pablo Yaganiza,20299,523,588,1111
2019,Oaxaca,20,San Pedro Amuzgos,20300,3239,3702,6941
2019,Oaxaca,20,San Pedro Apóstol,20301,730,857,1587
2019,Oaxaca,20,San Pedro Atoyac,20302,2155,2414,4569
2019,Oaxaca,20,San Pedro Cajonos,20303,515,624,1139
2019,Oaxaca,20,San Pedro Comitancillo,20305,2099,2306,4405
2019,Oaxaca,20,San Pedro Coxcaltepec Cántaros,20304,372,406,778
2019,Oaxaca,20,San Pedro Huamelula,20307,5108,5127,10235
2019,Oaxaca,20,San Pedro Huilotepec,20308,1607,1639,3246
2019,Oaxaca,20,San Pedro Ixcatlán,20309,5761,6002,11763
2019,Oaxaca,20,San Pedro Ixtlahuaca,20310,4444,4717,9161
2019,Oaxaca,20,San Pedro Jaltepetongo,20311,261,300,561
2019,Oaxaca,20,San Pedro Jicayán,20312,6055,6606,12661
2019,Oaxaca,20,San Pedro Jocotipac,20313,366,441,807
2019,Oaxaca,20,San Pedro Juchatengo,20314,791,876,1667
2019,Oaxaca,20,San Pedro Mixtepec Distrito 22,20318,24682,25932,50614
2019,Oaxaca,20,San Pedro Mixtepec Distrito 26,20319,530,581,1111
2019,Oaxaca,20,San Pedro Molinos,20320,335,371,706
2019,Oaxaca,20,San Pedro Mártir,20315,762,972,1734
2019,Oaxaca,20,San Pedro Mártir Quiechapa,20316,341,388,729
2019,Oaxaca,20,San Pedro Mártir Yucuxaco,20317,600,704,1304
2019,Oaxaca,20,San Pedro Nopala,20321,360,397,757
2019,Oaxaca,20,San Pedro Ocopetatillo,20322,394,456,850
2019,Oaxaca,20,San Pedro Ocotepec,20323,1070,1132,2202
2019,Oaxaca,20,San Pedro Pochutla,20324,24112,24908,49020
2019,Oaxaca,20,San Pedro Quiatoni,20325,5485,5804,11289
2019,Oaxaca,20,San Pedro Sochiápam,20326,2584,2646,5230
2019,Oaxaca,20,San Pedro Tapanatepec,20327,7582,7753,15335
2019,Oaxaca,20,San Pedro Taviche,20328,614,632,1246
2019,Oaxaca,20,San Pedro Teozacoalco,20329,617,663,1280
2019,Oaxaca,20,San Pedro Teutila,20330,2173,2241,4414
2019,Oaxaca,20,San Pedro Tidaá,20331,428,492,920
2019,Oaxaca,20,San Pedro Topiltepec,20332,178,197,375
2019,Oaxaca,20,San Pedro Totolápam,20333,1294,1433,2727
2019,Oaxaca,20,San Pedro Yaneri,20335,468,493,961
2019,Oaxaca,20,San Pedro Yucunama,20341,103,138,241
2019,Oaxaca,20,San Pedro Yólox,20336,894,958,1852
2019,Oaxaca,20,San Pedro el Alto,20306,1857,1956,3813
2019,Oaxaca,20,San Pedro y San Pablo Ayutla,20337,2468,2924,5392
2019,Oaxaca,20,San Pedro y San Pablo Teposcolula,20339,2027,2234,4261
2019,Oaxaca,20,San Pedro y San Pablo Tequixtepec,20340,797,977,1774
2019,Oaxaca,20,San Raymundo Jalpan,20342,1653,1982,3635
2019,Oaxaca,20,San Sebastián Abasolo,20343,945,1029,1974
2019,Oaxaca,20,San Sebastián Coatlán,20344,1353,1434,2787
2019,Oaxaca,20,San Sebastián Ixcapa,20345,2063,2124,4187
2019,Oaxaca,20,San Sebastián Nicananduta,20346,646,853,1499
2019,Oaxaca,20,San Sebastián Río Hondo,20347,1863,1901,3764
2019,Oaxaca,20,San Sebastián Tecomaxtlahuaca,20348,4036,4453,8489
2019,Oaxaca,20,San Sebastián Teitipac,20349,927,1106,2033
2019,Oaxaca,20,San Sebastián Tutla,20350,8979,10327,19306
2019,Oaxaca,20,San Simón Almolongas,20351,1319,1519,2838
2019,Oaxaca,20,San Simón Zahuatlán,20352,2136,2187,4323
2019,Oaxaca,20,San Vicente Coatlán,20534,1843,2216,4059
2019,Oaxaca,20,San Vicente Lachixío,20535,1391,1574,2965
2019,Oaxaca,20,San Vicente Nuñú,20536,206,242,448
2019,Oaxaca,20,Santa Ana,20353,1072,1171,2243
2019,Oaxaca,20,Santa Ana Ateixtlahuaca,20354,269,264,533
2019,Oaxaca,20,Santa Ana Cuauhtémoc,20355,358,386,744
2019,Oaxaca,20,Santa Ana Tavela,20357,407,432,839
2019,Oaxaca,20,Santa Ana Tlapacoyan,20358,971,1061,2032
2019,Oaxaca,20,Santa Ana Yareni,20359,425,499,924
2019,Oaxaca,20,Santa Ana Zegache,20360,1827,2060,3887
2019,Oaxaca,20,Santa Ana del Valle,20356,1035,1106,2141
2019,Oaxaca,20,Santa Catalina Quierí,20361,423,516,939
2019,Oaxaca,20,Santa Catarina Cuixtla,20362,666,832,1498
2019,Oaxaca,20,Santa Catarina Ixtepeji,20363,1305,1407,2712
2019,Oaxaca,20,Santa Catarina Juquila,20364,7899,8364,16263
2019,Oaxaca,20,Santa Catarina Lachatao,20365,549,592,1141
2019,Oaxaca,20,Santa Catarina Loxicha,20366,1966,2016,3982
2019,Oaxaca,20,Santa Catarina Mechoacán,20367,2314,2355,4669
2019,Oaxaca,20,Santa Catarina Minas,20368,985,1018,2003
2019,Oaxaca,20,Santa Catarina Quiané,20369,964,1031,1995
2019,Oaxaca,20,Santa Catarina Quioquitani,20074,262,288,550
2019,Oaxaca,20,Santa Catarina Tayata,20370,308,369,677
2019,Oaxaca,20,Santa Catarina Ticuá,20371,484,600,1084
2019,Oaxaca,20,Santa Catarina Yosonotú,20372,789,951,1740
2019,Oaxaca,20,Santa Catarina Zapoquila,20373,178,207,385
2019,Oaxaca,20,Santa Cruz Acatepec,20374,774,839,1613
2019,Oaxaca,20,Santa Cruz Amilpas,20375,6252,7217,13469
2019,Oaxaca,20,Santa Cruz Itundujia,20377,5715,6184,11899
2019,Oaxaca,20,Santa Cruz Mixtepec,20378,1728,1905,3633
2019,Oaxaca,20,Santa Cruz Nundaco,20379,1401,1646,3047
2019,Oaxaca,20,Santa Cruz Papalutla,20380,1077,1141,2218
2019,Oaxaca,20,Santa Cruz Tacache de Mina,20381,1317,1455,2772
2019,Oaxaca,20,Santa Cruz Tacahua,20382,544,611,1155
2019,Oaxaca,20,Santa Cruz Tayata,20383,307,314,621
2019,Oaxaca,20,Santa Cruz Xitla,20384,2331,2601,4932
2019,Oaxaca,20,Santa Cruz Xoxocotlán,20385,46025,51597,97622
2019,Oaxaca,20,Santa Cruz Zenzontepec,20386,9259,9704,18963
2019,Oaxaca,20,Santa Cruz de Bravo,20376,180,193,373
2019,Oaxaca,20,Santa Gertrudis,20387,1417,1525,2942
2019,Oaxaca,20,Santa Inés Yatzeche,20389,404,543,947
2019,Oaxaca,20,Santa Inés de Zaragoza,20569,783,889,1672
2019,Oaxaca,20,Santa Inés del Monte,20388,1213,1269,2482
2019,Oaxaca,20,Santa Lucía Miahuatlán,20391,1723,1804,3527
2019,Oaxaca,20,Santa Lucía Monteverde,20392,3192,3478,6670
2019,Oaxaca,20,Santa Lucía Ocotlán,20393,1820,2155,3975
2019,Oaxaca,20,Santa Lucía del Camino,20390,25009,26990,51999
2019,Oaxaca,20,Santa Magdalena Jicotlán,20047,44,51,95
2019,Oaxaca,20,Santa María Alotepec,20394,1426,1461,2887
2019,Oaxaca,20,Santa María Apazco,20395,795,985,1780
2019,Oaxaca,20,Santa María Atzompa,20399,17626,18955,36581
2019,Oaxaca,20,Santa María Camotlán,20400,771,897,1668
2019,Oaxaca,20,Santa María Chachoápam,20404,358,410,768
2019,Oaxaca,20,Santa María Chilchotla,20406,10333,10704,21037
2019,Oaxaca,20,Santa María Chimalapa,20407,4744,4603,9347
2019,Oaxaca,20,Santa María Colotepec,20401,12403,12577,24980
2019,Oaxaca,20,Santa María Cortijo,20402,530,571,1101
2019,Oaxaca,20,Santa María Coyotepec,20403,1527,1690,3217
2019,Oaxaca,20,Santa María Ecatepec,20410,1737,1773,3510
2019,Oaxaca,20,Santa María Guelacé,20411,381,470,851
2019,Oaxaca,20,Santa María Guienagati,20412,1634,1639,3273
2019,Oaxaca,20,Santa María Huatulco,20413,22708,23686,46394
2019,Oaxaca,20,Santa María Huazolotitlán,20414,5787,5995,11782
2019,Oaxaca,20,Santa María Ipalapa,20415,2417,2699,5116
2019,Oaxaca,20,Santa María Ixcatlán,20416,240,269,509
2019,Oaxaca,20,Santa María Jacatepec,20417,4549,5078,9627
2019,Oaxaca,20,Santa María Jalapa del Marqués,20418,6551,6958,13509
2019,Oaxaca,20,Santa María Jaltianguis,20419,247,293,540
2019,Oaxaca,20,Santa María Lachixío,20420,917,1064,1981
2019,Oaxaca,20,Santa María Mixtequilla,20421,2338,2473,4811
2019,Oaxaca,20,Santa María Nativitas,20422,282,337,619
2019,Oaxaca,20,Santa María Nduayaco,20423,255,253,508
2019,Oaxaca,20,Santa María Ozolotepec,20424,1928,2053,3981
2019,Oaxaca,20,Santa María Petapa,20427,8217,8796,17013
2019,Oaxaca,20,Santa María Peñoles,20426,4258,4469,8727
2019,Oaxaca,20,Santa María Pápalo,20425,1105,1097,2202
2019,Oaxaca,20,Santa María Quiegolani,20428,996,982,1978
2019,Oaxaca,20,Santa María Sola,20429,729,791,1520
2019,Oaxaca,20,Santa María Tataltepec,20430,182,196,378
2019,Oaxaca,20,Santa María Tecomavaca,20431,842,904,1746
2019,Oaxaca,20,Santa María Temaxcalapa,20432,467,494,961
2019,Oaxaca,20,Santa María Temaxcaltepec,20433,1270,1421,2691
2019,Oaxaca,20,Santa María Teopoxco,20434,2082,2348,4430
2019,Oaxaca,20,Santa María Tepantlali,20435,1895,1965,3860
2019,Oaxaca,20,Santa María Texcatitlán,20436,492,536,1028
2019,Oaxaca,20,Santa María Tlahuitoltepec,20437,4664,4948,9612
2019,Oaxaca,20,Santa María Tlalixtac,20438,849,905,1754
2019,Oaxaca,20,Santa María Tonameca,20439,12963,13239,26202
2019,Oaxaca,20,Santa María Totolapilla,20440,405,454,859
2019,Oaxaca,20,Santa María Xadani,20441,4555,4484,9039
2019,Oaxaca,20,Santa María Yalina,20442,134,157,291
2019,Oaxaca,20,Santa María Yavesía,20443,225,277,502
2019,Oaxaca,20,Santa María Yolotepec,20444,205,223,428
2019,Oaxaca,20,Santa María Yosoyúa,20445,848,838,1686
2019,Oaxaca,20,Santa María Yucuhiti,20446,3098,3369,6467
2019,Oaxaca,20,Santa María Zacatepec,20447,7723,8720,16443
2019,Oaxaca,20,Santa María Zaniza,20448,1105,1175,2280
2019,Oaxaca,20,Santa María Zoquitlán,20449,1539,1588,3127
2019,Oaxaca,20,Santa María del Rosario,20408,264,247,511
2019,Oaxaca,20,Santa María del Tule,20409,4365,4991,9356
2019,Oaxaca,20,Santa María la Asunción,20396,1497,1879,3376
2019,Oaxaca,20,Santiago Amoltepec,20450,6326,6724,13050
2019,Oaxaca,20,Santiago Apoala,20451,427,498,925
2019,Oaxaca,20,Santiago Apóstol,20452,1834,2278,4112
2019,Oaxaca,20,Santiago Astata,20453,2033,2055,4088
2019,Oaxaca,20,Santiago Atitlán,20454,1594,1540,3134
2019,Oaxaca,20,Santiago Ayuquililla,20455,1321,1459,2780
2019,Oaxaca,20,Santiago Cacaloxtepec,20456,796,869,1665
2019,Oaxaca,20,Santiago Camotlán,20457,1629,1646,3275
2019,Oaxaca,20,Santiago Chazumba,20459,2053,2551,4604
2019,Oaxaca,20,Santiago Choápam,20460,2574,2752,5326
2019,Oaxaca,20,Santiago Comaltepec,20458,477,530,1007
2019,Oaxaca,20,Santiago Huajolotitlán,20462,1962,2345,4307
2019,Oaxaca,20,Santiago Huauclilla,20463,260,286,546
2019,Oaxaca,20,Santiago Ihuitlán Plumas,20464,168,207,375
2019,Oaxaca,20,Santiago Ixcuintepec,20465,825,847,1672
2019,Oaxaca,20,Santiago Ixtayutla,20466,6450,6806,13256
2019,Oaxaca,20,Santiago Jamiltepec,20467,9445,10213,19658
2019,Oaxaca,20,Santiago Jocotepec,20468,7101,7314,14415
2019,Oaxaca,20,Santiago Juxtlahuaca,20469,17616,19495,37111
2019,Oaxaca,20,Santiago Lachiguiri,20470,2415,2466,4881
2019,Oaxaca,20,Santiago Lalopa,20471,247,266,513
2019,Oaxaca,20,Santiago Laollaga,20472,1738,1756,3494
2019,Oaxaca,20,Santiago Laxopa,20473,640,715,1355
2019,Oaxaca,20,Santiago Llano Grande,20474,1683,1703,3386
2019,Oaxaca,20,Santiago Matatlán,20475,4788,5423,10211
2019,Oaxaca,20,Santiago Miltepec,20476,209,213,422
2019,Oaxaca,20,Santiago Minas,20477,711,732,1443
2019,Oaxaca,20,Santiago Nacaltepec,20478,863,962,1825
2019,Oaxaca,20,Santiago Nejapilla,20479,111,100,211
2019,Oaxaca,20,Santiago Niltepec,20066,2757,2798,5555
2019,Oaxaca,20,Santiago Nundiche,20480,450,492,942
2019,Oaxaca,20,Santiago Nuyoó,20481,867,956,1823
2019,Oaxaca,20,Santiago Pinotepa Nacional,20482,26804,28068,54872
2019,Oaxaca,20,Santiago Suchilquitongo,20483,5228,5627,10855
2019,Oaxaca,20,Santiago Tamazola,20484,2135,2463,4598
2019,Oaxaca,20,Santiago Tapextla,20485,1609,1566,3175
2019,Oaxaca,20,Santiago Tenango,20487,1052,1046,2098
2019,Oaxaca,20,Santiago Tepetlapa,20488,58,66,124
2019,Oaxaca,20,Santiago Tetepec,20489,2514,2573,5087
2019,Oaxaca,20,Santiago Texcalcingo,20490,1547,1657,3204
2019,Oaxaca,20,Santiago Textitlán,20491,2263,2279,4542
2019,Oaxaca,20,Santiago Tilantongo,20492,1400,1638,3038
2019,Oaxaca,20,Santiago Tillo,20493,261,298,559
2019,Oaxaca,20,Santiago Tlazoyaltepec,20494,2224,2661,4885
2019,Oaxaca,20,Santiago Xanica,20495,1551,1548,3099
2019,Oaxaca,20,Santiago Xiacuí,20496,1016,1124,2140
2019,Oaxaca,20,Santiago Yaitepec,20497,2047,2397,4444
2019,Oaxaca,20,Santiago Yaveo,20498,3532,3519,7051
2019,Oaxaca,20,Santiago Yolomécatl,20499,1008,1189,2197
2019,Oaxaca,20,Santiago Yosondúa,20500,4057,4545,8602
2019,Oaxaca,20,Santiago Yucuyachi,20501,448,492,940
2019,Oaxaca,20,Santiago Zacatepec,20502,2689,2764,5453
2019,Oaxaca,20,Santiago Zoochila,20503,189,216,405
2019,Oaxaca,20,Santiago del Río,20461,267,289,556
2019,Oaxaca,20,Santo Domingo Albarradas,20506,369,426,795
2019,Oaxaca,20,Santo Domingo Armenta,20507,1744,1763,3507
2019,Oaxaca,20,Santo Domingo Chihuitán,20508,776,794,1570
2019,Oaxaca,20,Santo Domingo Ingenio,20505,4132,4128,8260
2019,Oaxaca,20,Santo Domingo Ixcatlán,20510,326,382,708
2019,Oaxaca,20,Santo Domingo Nuxaá,20511,1618,1729,3347
2019,Oaxaca,20,Santo Domingo Ozolotepec,20512,409,451,860
2019,Oaxaca,20,Santo Domingo Petapa,20513,4731,4675,9406
2019,Oaxaca,20,Santo Domingo Roayaga,20514,504,549,1053
2019,Oaxaca,20,Santo Domingo Tehuantepec,20515,32947,34687,67634
2019,Oaxaca,20,Santo Domingo Teojomulco,20516,2488,2643,5131
2019,Oaxaca,20,Santo Domingo Tepuxtepec,20517,2720,3078,5798
2019,Oaxaca,20,Santo Domingo Tlatayápam,20518,66,77,143
2019,Oaxaca,20,Santo Domingo Tomaltepec,20519,1506,1553,3059
2019,Oaxaca,20,Santo Domingo Tonaltepec,20521,109,140,249
2019,Oaxaca,20,Santo Domingo Tonalá,20520,3420,3779,7199
2019,Oaxaca,20,Santo Domingo Xagacía,20522,555,639,1194
2019,Oaxaca,20,Santo Domingo Yanhuitlán,20523,759,850,1609
2019,Oaxaca,20,Santo Domingo Yodohino,20524,154,167,321
2019,Oaxaca,20,Santo Domingo Zanatepec,20525,6254,6303,12557
2019,Oaxaca,20,Santo Domingo de Morelos,20509,5420,6046,11466
2019,Oaxaca,20,Santo Tomás Jalieza,20530,1757,1940,3697
2019,Oaxaca,20,Santo Tomás Mazaltepec,20531,1287,1420,2707
2019,Oaxaca,20,Santo Tomás Ocotepec,20532,1830,2094,3924
2019,Oaxaca,20,Santo Tomás Tamazulapan,20533,1119,1190,2309
2019,Oaxaca,20,Santos Reyes Nopala,20526,8790,9331,18121
2019,Oaxaca,20,Santos Reyes Pápalo,20527,1322,1423,2745
2019,Oaxaca,20,Santos Reyes Tepejillo,20528,434,600,1034
2019,Oaxaca,20,Santos Reyes Yucuná,20529,670,683,1353
2019,Oaxaca,20,Silacayoápam,20537,3193,3634,6827
2019,Oaxaca,20,Sitio de Xitlapehua,20538,337,377,714
2019,Oaxaca,20,Soledad Etla,20539,2860,2999,5859
2019,Oaxaca,20,Tamazulápam del Espíritu Santo,20031,3478,4157,7635
2019,Oaxaca,20,Tanetze de Zaragoza,20541,816,884,1700
2019,Oaxaca,20,Taniche,20542,373,456,829
2019,Oaxaca,20,Tataltepec de Valdés,20543,2925,3053,5978
2019,Oaxaca,20,Teococuilco de Marcos Pérez,20544,455,541,996
2019,Oaxaca,20,Teotitlán de Flores Magón,20545,4873,5381,10254
2019,Oaxaca,20,Teotitlán del Valle,20546,2875,3188,6063
2019,Oaxaca,20,Teotongo,20547,445,531,976
2019,Oaxaca,20,Tepelmeme Villa de Morelos,20548,771,921,1692
2019,Oaxaca,20,Tlacolula de Matamoros,20551,11139,12534,23673
2019,Oaxaca,20,Tlacotepec Plumas,20552,223,245,468
2019,Oaxaca,20,Tlalixtac de Cabrera,20553,5129,5671,10800
2019,Oaxaca,20,Totontepec Villa de Morelos,20554,2666,2893,5559
2019,Oaxaca,20,Trinidad Zaachila,20555,1459,1619,3078
2019,Oaxaca,20,Unión Hidalgo,20557,7724,8197,15921
2019,Oaxaca,20,Valerio Trujano,20558,659,806,1465
2019,Oaxaca,20,Villa Díaz Ordaz,20560,3162,3759,6921
2019,Oaxaca,20,Villa Hidalgo,20038,963,1061,2024
2019,Oaxaca,20,Villa Sola de Vega,20277,6278,6424,12702
2019,Oaxaca,20,Villa Talea de Castro,20280,1129,1239,2368
2019,Oaxaca,20,Villa Tejúpam de la Unión,20486,1230,1313,2543
2019,Oaxaca,20,Villa Tezoatlán de Segura y Luna,20549,5232,6165,11397
2019,Oaxaca,20,Villa de Chilapa de Díaz,20405,962,1227,2189
2019,Oaxaca,20,Villa de Etla,20338,5397,5894,11291
2019,Oaxaca,20,Villa de Tamazulápam del Progreso,20540,3760,4204,7964
2019,Oaxaca,20,Villa de Tututepec de Melchor Ocampo,20334,23051,24070,47121
2019,Oaxaca,20,Villa de Zaachila,20565,22002,24034,46036
2019,Oaxaca,20,Yaxe,20561,1401,1517,2918
2019,Oaxaca,20,Yogana,20563,586,699,1285
2019,Oaxaca,20,Yutanduchi de Guerrero,20564,570,633,1203
2019,Oaxaca,20,Zapotitlán Lagunas,20567,1535,1727,3262
2019,Oaxaca,20,Zapotitlán Palmas,20568,668,826,1494
2019,Oaxaca,20,Zimatlán de Álvarez,20570,9730,11053,20783
2019,Oaxaca,20,Ánimas Trujano,20174,1982,2187,4169
2019,Puebla,21,Acajete,21001,33099,35230,68329
2019,Puebla,21,Acateno,21002,4836,4795,9631
2019,Puebla,21,Acatlán,21003,17313,20158,37471
2019,Puebla,21,Acatzingo,21004,30265,31432,61697
2019,Puebla,21,Acteopan,21005,1460,1660,3120
2019,Puebla,21,Ahuacatlán,21006,7900,8682,16582
2019,Puebla,21,Ahuatlán,21007,1650,1774,3424
2019,Puebla,21,Ahuazotepec,21008,5883,6067,11950
2019,Puebla,21,Ahuehuetitla,21009,884,1016,1900
2019,Puebla,21,Ajalpan,21010,33745,35614,69359
2019,Puebla,21,Albino Zertuche,21011,873,1024,1897
2019,Puebla,21,Aljojuca,21012,3259,3615,6874
2019,Puebla,21,Altepexi,21013,10883,11426,22309
2019,Puebla,21,Amixtlán,21014,2483,2741,5224
2019,Puebla,21,Amozoc,21015,60657,63228,123885
2019,Puebla,21,Aquixtla,21016,4545,4554,9099
2019,Puebla,21,Atempan,21017,14086,15624,29710
2019,Puebla,21,Atexcal,21018,1915,2063,3978
2019,Puebla,21,Atlequizayan,21080,1330,1491,2821
2019,Puebla,21,Atlixco,21019,67339,75307,142646
2019,Puebla,21,Atoyatempan,21020,3561,3798,7359
2019,Puebla,21,Atzala,21021,654,726,1380
2019,Puebla,21,Atzitzihuacán,21022,5965,6879,12844
2019,Puebla,21,Atzitzintla,21023,4755,4889,9644
2019,Puebla,21,Axutla,21024,449,525,974
2019,Puebla,21,Ayotoxco de Guerrero,21025,4444,4596,9040
2019,Puebla,21,Calpan,21026,7231,8000,15231
2019,Puebla,21,Caltepec,21027,1936,2215,4151
2019,Puebla,21,Camocuautla,21028,1367,1395,2762
2019,Puebla,21,Caxhuacan,21029,1875,2046,3921
2019,Puebla,21,Cañada Morelos,21099,9827,10487,20314
2019,Puebla,21,Chalchicomula de Sesma,21045,23820,25831,49651
2019,Puebla,21,Chapulco,21046,3934,4217,8151
2019,Puebla,21,Chiautla,21047,10167,10833,21000
2019,Puebla,21,Chiautzingo,21048,10135,11153,21288
2019,Puebla,21,Chichiquila,21050,13224,13954,27178
2019,Puebla,21,Chiconcuautla,21049,8554,8885,17439
2019,Puebla,21,Chietla,21051,17499,18813,36312
2019,Puebla,21,Chigmecatitlán,21052,573,677,1250
2019,Puebla,21,Chignahuapan,21053,32215,33397,65612
2019,Puebla,21,Chignautla,21054,17389,18403,35792
2019,Puebla,21,Chila,21055,2268,2571,4839
2019,Puebla,21,Chila de la Sal,21056,717,767,1484
2019,Puebla,21,Chilchotla,21058,10446,10408,20854
2019,Puebla,21,Chinantla,21059,1128,1274,2402
2019,Puebla,21,Coatepec,21030,375,417,792
2019,Puebla,21,Coatzingo,21031,1480,1633,3113
2019,Puebla,21,Cohetzala,21032,709,699,1408
2019,Puebla,21,Cohuecan,21033,2454,2686,5140
2019,Puebla,21,Coronango,21034,20853,21690,42543
2019,Puebla,21,Coxcatlán,21035,10346,11344,21690
2019,Puebla,21,Coyomeapan,21036,7065,7696,14761
2019,Puebla,21,Coyotepec,21037,1122,1309,2431
2019,Puebla,21,Cuapiaxtla de Madero,21038,5235,5298,10533
2019,Puebla,21,Cuautempan,21039,4742,5084,9826
2019,Puebla,21,Cuautinchán,21040,5359,5426,10785
2019,Puebla,21,Cuautlancingo,21041,60134,63651,123785
2019,Puebla,21,Cuayuca de Andrade,21042,1583,1701,3284
2019,Puebla,21,Cuetzalan del Progreso,21043,24917,26059,50976
2019,Puebla,21,Cuyoaco,21044,7968,8610,16578
2019,Puebla,21,Domingo Arenas,21060,3714,4121,7835
2019,Puebla,21,Eloxochitlán,21061,6538,6842,13380
2019,Puebla,21,Epatlán,21062,2462,2599,5061
2019,Puebla,21,Esperanza,21063,7572,8095,15667
2019,Puebla,21,Francisco Z. Mena,21064,8978,8851,17829
2019,Puebla,21,General Felipe Ángeles,21065,10401,11254,21655
2019,Puebla,21,Guadalupe,21066,2839,3283,6122
2019,Puebla,21,Guadalupe Victoria,21067,8719,9192,17911
2019,Puebla,21,Hermenegildo Galeana,21068,4032,4081,8113
2019,Puebla,21,Honey,21057,3947,4329,8276
2019,Puebla,21,Huaquechula,21069,12269,13977,26246
2019,Puebla,21,Huatlatlauca,21070,3101,3708,6809
2019,Puebla,21,Huauchinango,21071,52445,57844,110289
2019,Puebla,21,Huehuetla,21072,9597,9833,19430
2019,Puebla,21,Huehuetlán el Chico,21073,4353,4604,8957
2019,Puebla,21,Huehuetlán el Grande,21150,3673,3908,7581
2019,Puebla,21,Huejotzingo,21074,37756,39625,77381
2019,Puebla,21,Hueyapan,21075,6535,6919,13454
2019,Puebla,21,Hueytamalco,21076,13696,14010,27706
2019,Puebla,21,Hueytlalpan,21077,2803,2942,5745
2019,Puebla,21,Huitzilan de Serdán,21078,7974,7787,15761
2019,Puebla,21,Huitziltepec,21079,2770,2991,5761
2019,Puebla,21,Ixcamilpa de Guerrero,21081,1795,1995,3790
2019,Puebla,21,Ixcaquixtla,21082,4444,4861,9305
2019,Puebla,21,Ixtacamaxtitlán,21083,12694,13028,25722
2019,Puebla,21,Ixtepec,21084,3625,3833,7458
2019,Puebla,21,Izúcar de Matamoros,21085,38699,43059,81758
2019,Puebla,21,Jalpan,21086,6165,6638,12803
2019,Puebla,21,Jolalpan,21087,6571,7152,13723
2019,Puebla,21,Jonotla,21088,2361,2455,4816
2019,Puebla,21,Jopala,21089,6699,7016,13715
2019,Puebla,21,Juan C. Bonilla,21090,10617,11594,22211
2019,Puebla,21,Juan Galindo,21091,5307,6038,11345
2019,Puebla,21,Juan N. Méndez,21092,2738,2806,5544
2019,Puebla,21,La Magdalena Tlatlauquitepec,21095,297,292,589
2019,Puebla,21,Lafragua,21093,4034,4144,8178
2019,Puebla,21,Libres,21094,17360,18286,35646
2019,Puebla,21,Los Reyes de Juárez,21118,14202,14714,28916
2019,Puebla,21,Mazapiltepec de Juárez,21096,1475,1502,2977
2019,Puebla,21,Mixtla,21097,1175,1305,2480
2019,Puebla,21,Molcaxac,21098,3077,3482,6559
2019,Puebla,21,Naupan,21100,4997,5450,10447
2019,Puebla,21,Nauzontla,21101,1708,1918,3626
2019,Puebla,21,Nealtican,21102,6271,6811,13082
2019,Puebla,21,Nicolás Bravo,21103,3205,3409,6614
2019,Puebla,21,Nopalucan,21104,16076,16507,32583
2019,Puebla,21,Ocotepec,21105,2413,2624,5037
2019,Puebla,21,Ocoyucan,21106,13902,15760,29662
2019,Puebla,21,Olintla,21107,6020,6307,12327
2019,Puebla,21,Oriental,21108,9297,9822,19119
2019,Puebla,21,Pahuatlán,21109,10936,12123,23059
2019,Puebla,21,Palmar de Bravo,21110,23954,24528,48482
2019,Puebla,21,Pantepec,21111,9423,9997,19420
2019,Puebla,21,Petlalcingo,21112,4740,5426,10166
2019,Puebla,21,Piaxtla,21113,2217,2389,4606
2019,Puebla,21,Puebla,21114,808776,877028,1685804
2019,Puebla,21,Quecholac,21115,26236,27252,53488
2019,Puebla,21,Quimixtlán,21116,11448,11709,23157
2019,Puebla,21,Rafael Lara Grajales,21117,7086,7630,14716
2019,Puebla,21,San Andrés Cholula,21119,74421,76226,150647
2019,Puebla,21,San Antonio Cañada,21120,2743,3075,5818
2019,Puebla,21,San Diego la Mesa Tochimiltzingo,21121,621,637,1258
2019,Puebla,21,San Felipe Teotlalcingo,21122,5273,5629,10902
2019,Puebla,21,San Felipe Tepatlán,21123,2032,2107,4139
2019,Puebla,21,San Gabriel Chilac,21124,7869,8680,16549
2019,Puebla,21,San Gregorio Atzompa,21125,4597,4890,9487
2019,Puebla,21,San Jerónimo Tecuanipan,21126,3126,3447,6573
2019,Puebla,21,San Jerónimo Xayacatlán,21127,1713,1968,3681
2019,Puebla,21,San José Chiapa,21128,4552,4659,9211
2019,Puebla,21,San José Miahuatlán,21129,6697,7329,14026
2019,Puebla,21,San Juan Atenco,21130,1639,1899,3538
2019,Puebla,21,San Juan Atzompa,21131,477,455,932
2019,Puebla,21,San Martín Texmelucan,21132,77718,83172,160890
2019,Puebla,21,San Martín Totoltepec,21133,329,355,684
2019,Puebla,21,San Matías Tlalancaleca,21134,10525,10910,21435
2019,Puebla,21,San Miguel Ixitlán,21135,251,283,534
2019,Puebla,21,San Miguel Xoxtla,21136,6415,6758,13173
2019,Puebla,21,San Nicolás Buenos Aires,21137,5082,5310,10392
2019,Puebla,21,San Nicolás de los Ranchos,21138,5996,6291,12287
2019,Puebla,21,San Pablo Anicano,21139,1790,1966,3756
2019,Puebla,21,San Pedro Cholula,21140,66390,71819,138209
2019,Puebla,21,San Pedro Yeloixtlahuaca,21141,1684,1824,3508
2019,Puebla,21,San Salvador Huixcolotla,21144,7769,7919,15688
2019,Puebla,21,San Salvador el Seco,21142,15543,16329,31872
2019,Puebla,21,San Salvador el Verde,21143,16209,16799,33008
2019,Puebla,21,San Sebastián Tlacotepec,21145,7280,7376,14656
2019,Puebla,21,Santa Catarina Tlaltempan,21146,427,423,850
2019,Puebla,21,Santa Inés Ahuatempan,21147,3180,3469,6649
2019,Puebla,21,Santa Isabel Cholula,21148,4503,4893,9396
2019,Puebla,21,Santiago Miahuatlán,21149,13026,13719,26745
2019,Puebla,21,Santo Tomás Hueyotlipan,21151,4335,4681,9016
2019,Puebla,21,Soltepec,21152,6309,6635,12944
2019,Puebla,21,Tecali de Herrera,21153,11320,11935,23255
2019,Puebla,21,Tecamachalco,21154,39365,41779,81144
2019,Puebla,21,Tecomatlán,21155,2960,3073,6033
2019,Puebla,21,Tehuacán,21156,158819,176266,335085
2019,Puebla,21,Tehuitzingo,21157,5584,6208,11792
2019,Puebla,21,Tenampulco,21158,3662,3797,7459
2019,Puebla,21,Teopantlán,21159,1753,2190,3943
2019,Puebla,21,Teotlalco,21160,1620,1701,3321
2019,Puebla,21,Tepanco de López,21161,10251,11351,21602
2019,Puebla,21,Tepango de Rodríguez,21162,2049,2281,4330
2019,Puebla,21,Tepatlaxco de Hidalgo,21163,8903,9395,18298
2019,Puebla,21,Tepeaca,21164,40666,44073,84739
2019,Puebla,21,Tepemaxalco,21165,560,601,1161
2019,Puebla,21,Tepeojuma,21166,4111,4804,8915
2019,Puebla,21,Tepetzintla,21167,5762,6174,11936
2019,Puebla,21,Tepexco,21168,3475,3685,7160
2019,Puebla,21,Tepexi de Rodríguez,21169,11143,11072,22215
2019,Puebla,21,Tepeyahualco,21170,8861,9018,17879
2019,Puebla,21,Tepeyahualco de Cuauhtémoc,21171,1788,1964,3752
2019,Puebla,21,Tetela de Ocampo,21172,14213,15253,29466
2019,Puebla,21,Teteles de Ávila Castillo,21173,2881,3374,6255
2019,Puebla,21,Teziutlán,21174,49308,54743,104051
2019,Puebla,21,Tianguismanalco,21175,6339,6870,13209
2019,Puebla,21,Tilapa,21176,4360,4685,9045
2019,Puebla,21,Tlachichuca,21179,15063,15660,30723
2019,Puebla,21,Tlacotepec de Benito Juárez,21177,26209,28519,54728
2019,Puebla,21,Tlacuilotepec,21178,8670,8954,17624
2019,Puebla,21,Tlahuapan,21180,20884,21152,42036
2019,Puebla,21,Tlaltenango,21181,3671,3733,7404
2019,Puebla,21,Tlanepantla,21182,2536,2730,5266
2019,Puebla,21,Tlaola,21183,10318,10896,21214
2019,Puebla,21,Tlapacoya,21184,3333,3486,6819
2019,Puebla,21,Tlapanalá,21185,4224,4690,8914
2019,Puebla,21,Tlatlauquitepec,21186,27054,29635,56689
2019,Puebla,21,Tlaxco,21187,2807,2840,5647
2019,Puebla,21,Tochimilco,21188,8873,9928,18801
2019,Puebla,21,Tochtepec,21189,10701,11559,22260
2019,Puebla,21,Totoltepec de Guerrero,21190,577,694,1271
2019,Puebla,21,Tulcingo,21191,4649,5314,9963
2019,Puebla,21,Tuzamapan de Galeana,21192,3275,3433,6708
2019,Puebla,21,Tzicatlacoyan,21193,3633,3712,7345
2019,Puebla,21,Venustiano Carranza,21194,14888,16014,30902
2019,Puebla,21,Vicente Guerrero,21195,12337,13389,25726
2019,Puebla,21,Xayacatlán de Bravo,21196,753,901,1654
2019,Puebla,21,Xicotepec,21197,41202,44153,85355
2019,Puebla,21,Xicotlán,21198,606,670,1276
2019,Puebla,21,Xiutetelco,21199,20420,21865,42285
2019,Puebla,21,Xochiapulco,21200,1734,1900,3634
2019,Puebla,21,Xochiltepec,21201,1576,1895,3471
2019,Puebla,21,Xochitlán Todos Santos,21203,3196,3549,6745
2019,Puebla,21,Xochitlán de Vicente Suárez,21202,6454,6867,13321
2019,Puebla,21,Yaonáhuac,21204,4020,4382,8402
2019,Puebla,21,Yehualtepec,21205,12743,13455,26198
2019,Puebla,21,Zacapala,21206,2181,2447,4628
2019,Puebla,21,Zacapoaxtla,21207,27867,30516,58383
2019,Puebla,21,Zacatlán,21208,41326,45484,86810
2019,Puebla,21,Zapotitlán,21209,4067,4849,8916
2019,Puebla,21,Zapotitlán de Méndez,21210,2923,2973,5896
2019,Puebla,21,Zaragoza,21211,7926,9225,17151
2019,Puebla,21,Zautla,21212,9473,10668,20141
2019,Puebla,21,Zihuateutla,21213,6802,7179,13981
2019,Puebla,21,Zinacatepec,21214,8535,9370,17905
2019,Puebla,21,Zongozotla,21215,2570,2631,5201
2019,Puebla,21,Zoquiapan,21216,1211,1373,2584
2019,Puebla,21,Zoquitlán,21217,9565,10122,19687
2019,Querétaro,22,Amealco de Bonfil,22001,32890,34782,67672
2019,Querétaro,22,Arroyo Seco,22003,7001,7585,14586
2019,Querétaro,22,Cadereyta de Montes,22004,36224,39392,75616
2019,Querétaro,22,Colón,22005,34398,33712,68110
2019,Querétaro,22,Corregidora,22006,98177,104091,202268
2019,Querétaro,22,El Marqués,22011,87489,86282,173771
2019,Querétaro,22,Ezequiel Montes,22007,21842,23288,45130
2019,Querétaro,22,Huimilpan,22008,20061,21635,41696
2019,Querétaro,22,Jalpan de Serra,22009,13946,15242,29188
2019,Querétaro,22,Landa de Matamoros,22010,9657,10515,20172
2019,Querétaro,22,Pedro Escobedo,22012,37358,37854,75212
2019,Querétaro,22,Peñamiller,22013,10680,10981,21661
2019,Querétaro,22,Pinal de Amoles,22002,13544,14433,27977
2019,Querétaro,22,Querétaro,22014,477433,484037,961470
2019,Querétaro,22,San Joaquín,22015,4753,5423,10176
2019,Querétaro,22,San Juan del Río,22016,145462,150617,296079
2019,Querétaro,22,Tequisquiapan,22017,37979,39361,77340
2019,Querétaro,22,Tolimán,22018,15200,15788,30988
2019,Quintana Roo,23,Bacalar,23010,21987,21939,43926
2019,Quintana Roo,23,Benito Juárez,23005,415187,410460,825647
2019,Quintana Roo,23,Cozumel,23001,49418,49295,98713
2019,Quintana Roo,23,Felipe Carrillo Puerto,23002,45722,45288,91010
2019,Quintana Roo,23,Isla Mujeres,23003,11580,10727,22307
2019,Quintana Roo,23,José María Morelos,23006,21511,20451,41962
2019,Quintana Roo,23,Lázaro Cárdenas,23007,15671,15007,30678
2019,Quintana Roo,23,Othón P. Blanco,23004,128021,132924,260945
2019,Quintana Roo,23,Solidaridad,23008,121838,111503,233341
2019,Quintana Roo,23,Tulum,23009,18892,17120,36012
2019,San Luis Potosí,24,Ahualulco,24001,8942,10043,18985
2019,San Luis Potosí,24,Alaquines,24002,4252,4385,8637
2019,San Luis Potosí,24,Aquismón,24003,25610,25044,50654
2019,San Luis Potosí,24,Armadillo de los Infante,24004,2116,2195,4311
2019,San Luis Potosí,24,Axtla de Terrazas,24053,19085,19473,38558
2019,San Luis Potosí,24,Catorce,24006,5161,4983,10144
2019,San Luis Potosí,24,Cedral,24007,9767,10194,19961
2019,San Luis Potosí,24,Cerritos,24008,10945,11634,22579
2019,San Luis Potosí,24,Cerro de San Pedro,24009,2377,2335,4712
2019,San Luis Potosí,24,Charcas,24015,10726,11126,21852
2019,San Luis Potosí,24,Ciudad Fernández,24011,22998,24263,47261
2019,San Luis Potosí,24,Ciudad Valles,24013,90144,96202,186346
2019,San Luis Potosí,24,Ciudad del Maíz,24010,17498,17700,35198
2019,San Luis Potosí,24,Coxcatlán,24014,8191,8079,16270
2019,San Luis Potosí,24,Cárdenas,24005,9403,10226,19629
2019,San Luis Potosí,24,Ebano,24016,22266,23130,45396
2019,San Luis Potosí,24,El Naranjo,24058,11522,11379,22901
2019,San Luis Potosí,24,Guadalcázar,24017,13904,13640,27544
2019,San Luis Potosí,24,Huehuetlán,24018,8200,8429,16629
2019,San Luis Potosí,24,Lagunillas,24019,2814,2945,5759
2019,San Luis Potosí,24,Matehuala,24020,50181,53079,103260
2019,San Luis Potosí,24,Matlapa,24057,16003,16071,32074
2019,San Luis Potosí,24,Mexquitic de Carmona,24021,28181,30762,58943
2019,San Luis Potosí,24,Moctezuma,24022,9711,10547,20258
2019,San Luis Potosí,24,Rayón,24023,7877,8315,16192
2019,San Luis Potosí,24,Rioverde,24024,47668,50750,98418
2019,San Luis Potosí,24,Salinas,24025,15860,17119,32979
2019,San Luis Potosí,24,San Antonio,24026,4984,4768,9752
2019,San Luis Potosí,24,San Ciro de Acosta,24027,5175,5565,10740
2019,San Luis Potosí,24,San Luis Potosí,24028,418313,446605,864918
2019,San Luis Potosí,24,San Martín Chalchicuautla,24029,10977,11086,22063
2019,San Luis Potosí,24,San Nicolás Tolentino,24030,2550,2843,5393
2019,San Luis Potosí,24,San Vicente Tancuayalab,24034,7713,7731,15444
2019,San Luis Potosí,24,Santa Catarina,24031,5954,6285,12239
2019,San Luis Potosí,24,Santa María del Río,24032,19851,21793,41644
2019,San Luis Potosí,24,Santo Domingo,24033,6240,6320,12560
2019,San Luis Potosí,24,Soledad de Graciano Sánchez,24035,158085,166080,324165
2019,San Luis Potosí,24,Tamasopo,24036,15827,15557,31384
2019,San Luis Potosí,24,Tamazunchale,24037,49401,50197,99598
2019,San Luis Potosí,24,Tampacán,24038,8150,8004,16154
2019,San Luis Potosí,24,Tampamolón Corona,24039,7920,8056,15976
2019,San Luis Potosí,24,Tamuín,24040,20006,20496,40502
2019,San Luis Potosí,24,Tancanhuitz,24012,10675,10946,21621
2019,San Luis Potosí,24,Tanlajás,24041,10387,10151,20538
2019,San Luis Potosí,24,Tanquián de Escobedo,24042,7719,8042,15761
2019,San Luis Potosí,24,Tierra Nueva,24043,4482,5098,9580
2019,San Luis Potosí,24,Vanegas,24044,4032,3962,7994
2019,San Luis Potosí,24,Venado,24045,7449,7715,15164
2019,San Luis Potosí,24,Villa Hidalgo,24051,7671,7817,15488
2019,San Luis Potosí,24,Villa Juárez,24052,5195,5358,10553
2019,San Luis Potosí,24,Villa de Arista,24056,7954,8037,15991
2019,San Luis Potosí,24,Villa de Arriaga,24046,9145,9288,18433
2019,San Luis Potosí,24,Villa de Guadalupe,24047,5078,5065,10143
2019,San Luis Potosí,24,Villa de Ramos,24049,18913,20001,38914
2019,San Luis Potosí,24,Villa de Reyes,24050,25444,25725,51169
2019,San Luis Potosí,24,Villa de la Paz,24048,2797,2769,5566
2019,San Luis Potosí,24,Xilitla,24054,26631,27449,54080
2019,San Luis Potosí,24,Zaragoza,24055,13298,13684,26982
2019,Sinaloa,25,Ahome,25001,234304,241936,476240
2019,Sinaloa,25,Angostura,25002,25135,24976,50111
2019,Sinaloa,25,Badiraguato,25003,16629,15428,32057
2019,Sinaloa,25,Choix,25007,17705,16762,34467
2019,Sinaloa,25,Concordia,25004,14865,14405,29270
2019,Sinaloa,25,Cosalá,25005,8820,8395,17215
2019,Sinaloa,25,Culiacán,25006,469565,485775,955340
2019,Sinaloa,25,El Fuerte,25010,54341,53052,107393
2019,Sinaloa,25,Elota,25008,30457,28313,58770
2019,Sinaloa,25,Escuinapa,25009,31500,30609,62109
2019,Sinaloa,25,Guasave,25011,155901,158076,313977
2019,Sinaloa,25,Mazatlán,25012,260691,266814,527505
2019,Sinaloa,25,Mocorito,25013,24762,23336,48098
2019,Sinaloa,25,Navolato,25018,80962,77936,158898
2019,Sinaloa,25,Rosario,25014,28745,27732,56477
2019,Sinaloa,25,Salvador Alvarado,25015,42216,44183,86399
2019,Sinaloa,25,San Ignacio,25016,11594,10775,22369
2019,Sinaloa,25,Sinaloa,25017,47807,46510,94317
2019,Sonora,26,Aconchi,26001,1570,1418,2988
2019,Sonora,26,Agua Prieta,26002,44189,43561,87750
2019,Sonora,26,Alamos,26003,14313,13361,27674
2019,Sonora,26,Altar,26004,5092,5105,10197
2019,Sonora,26,Arivechi,26005,652,626,1278
2019,Sonora,26,Arizpe,26006,1512,1438,2950
2019,Sonora,26,Atil,26007,327,309,636
2019,Sonora,26,Bacadéhuachi,26008,642,573,1215
2019,Sonora,26,Bacanora,26009,442,405,847
2019,Sonora,26,Bacerac,26010,782,736,1518
2019,Sonora,26,Bacoachi,26011,857,857,1714
2019,Sonora,26,Banámichi,26013,892,875,1767
2019,Sonora,26,Bavispe,26015,844,758,1602
2019,Sonora,26,Baviácora,26014,1871,1775,3646
2019,Sonora,26,Benito Juárez,26071,11823,11809,23632
2019,Sonora,26,Benjamín Hill,26016,2721,2828,5549
2019,Sonora,26,Bácum,26012,12413,12260,24673
2019,Sonora,26,Caborca,26017,45862,45227,91089
2019,Sonora,26,Cajeme,26018,226683,236940,463623
2019,Sonora,26,Cananea,26019,18680,19084,37764
2019,Sonora,26,Carbó,26020,2747,2529,5276
2019,Sonora,26,Cucurpe,26022,581,471,1052
2019,Sonora,26,Cumpas,26023,3360,3322,6682
2019,Sonora,26,Divisaderos,26024,410,397,807
2019,Sonora,26,Empalme,26025,29832,30196,60028
2019,Sonora,26,Etchojoa,26026,33484,32399,65883
2019,Sonora,26,Fronteras,26027,4721,4553,9274
2019,Sonora,26,General Plutarco Elías Calles,26070,9198,8985,18183
2019,Sonora,26,Granados,26028,587,571,1158
2019,Sonora,26,Guaymas,26029,83765,85065,168830
2019,Sonora,26,Hermosillo,26030,460852,472181,933033
2019,Sonora,26,Huachinera,26031,714,676,1390
2019,Sonora,26,Huatabampo,26033,43176,43001,86177
2019,Sonora,26,Huásabas,26032,519,461,980
2019,Sonora,26,Huépac,26034,555,526,1081
2019,Sonora,26,Imuris,26035,6872,6815,13687
2019,Sonora,26,La Colorada,26021,1159,939,2098
2019,Sonora,26,Magdalena,26036,16601,16860,33461
2019,Sonora,26,Mazatán,26037,704,617,1321
2019,Sonora,26,Moctezuma,26038,2637,2694,5331
2019,Sonora,26,Naco,26039,3372,3337,6709
2019,Sonora,26,Nacozari de García,26041,7086,7058,14144
2019,Sonora,26,Navojoa,26042,85833,89402,175235
2019,Sonora,26,Nogales,26043,125052,125405,250457
2019,Sonora,26,Nácori Chico,26040,1122,1029,2151
2019,Sonora,26,Onavas,26044,264,223,487
2019,Sonora,26,Opodepe,26045,1548,1374,2922
2019,Sonora,26,Oquitoa,26046,201,228,429
2019,Sonora,26,Pitiquito,26047,5210,4892,10102
2019,Sonora,26,Puerto Peñasco,26048,36059,34818,70877
2019,Sonora,26,Quiriego,26049,1666,1451,3117
2019,Sonora,26,Rayón,26050,858,779,1637
2019,Sonora,26,Rosario,26051,2842,2607,5449
2019,Sonora,26,Sahuaripa,26052,3128,2958,6086
2019,Sonora,26,San Felipe de Jesús,26053,224,217,441
2019,Sonora,26,San Ignacio Río Muerto,26072,7972,7555,15527
2019,Sonora,26,San Javier,26054,373,288,661
2019,Sonora,26,San Luis Río Colorado,26055,102762,101722,204484
2019,Sonora,26,San Miguel de Horcasitas,26056,5349,4587,9936
2019,Sonora,26,San Pedro de la Cueva,26057,870,760,1630
2019,Sonora,26,Santa Ana,26058,8686,8924,17610
2019,Sonora,26,Santa Cruz,26059,994,1025,2019
2019,Sonora,26,Soyopa,26061,797,662,1459
2019,Sonora,26,Suaqui Grande,26062,654,558,1212
2019,Sonora,26,Sáric,26060,901,855,1756
2019,Sonora,26,Tepache,26063,771,706,1477
2019,Sonora,26,Trincheras,26064,953,794,1747
2019,Sonora,26,Tubutama,26065,690,655,1345
2019,Sonora,26,Ures,26066,4851,4643,9494
2019,Sonora,26,Villa Hidalgo,26067,872,809,1681
2019,Sonora,26,Villa Pesqueira,26068,688,574,1262
2019,Sonora,26,Yécora,26069,3206,3159,6365
2019,Tabasco,27,Balancán,27001,31817,31926,63743
2019,Tabasco,27,Centla,27003,58351,58302,116653
2019,Tabasco,27,Centro,27004,357784,373244,731028
2019,Tabasco,27,Comalcalco,27005,106189,109114,215303
2019,Tabasco,27,Cunduacán,27006,72111,74269,146380
2019,Tabasco,27,Cárdenas,27002,134384,139221,273605
2019,Tabasco,27,Emiliano Zapata,27007,15671,17020,32691
2019,Tabasco,27,Huimanguillo,27008,98210,100637,198847
2019,Tabasco,27,Jalapa,27009,20484,20373,40857
2019,Tabasco,27,Jalpa de Méndez,27010,46482,46731,93213
2019,Tabasco,27,Jonuta,27011,16385,16201,32586
2019,Tabasco,27,Macuspana,27012,86130,89185,175315
2019,Tabasco,27,Nacajuca,27013,71916,74676,146592
2019,Tabasco,27,Paraíso,27014,50155,50517,100672
2019,Tabasco,27,Tacotalpa,27015,25884,25755,51639
2019,Tabasco,27,Teapa,27016,30368,31428,61796
2019,Tabasco,27,Tenosique,27017,30905,32547,63452
2019,Tamaulipas,28,Abasolo,28001,6341,6356,12697
2019,Tamaulipas,28,Aldama,28002,15493,15254,30747
2019,Tamaulipas,28,Altamira,28003,125202,126532,251734
2019,Tamaulipas,28,Antiguo Morelos,28004,5124,5150,10274
2019,Tamaulipas,28,Burgos,28005,2448,2271,4719
2019,Tamaulipas,28,Bustamante,28006,4362,4016,8378
2019,Tamaulipas,28,Camargo,28007,8291,8057,16348
2019,Tamaulipas,28,Casas,28008,2313,2084,4397
2019,Tamaulipas,28,Ciudad Madero,28009,105895,115750,221645
2019,Tamaulipas,28,Cruillas,28010,1018,992,2010
2019,Tamaulipas,28,El Mante,28021,60656,64116,124772
2019,Tamaulipas,28,González,28012,22893,23181,46074
2019,Tamaulipas,28,Guerrero,28014,2452,2285,4737
2019,Tamaulipas,28,Gustavo Díaz Ordaz,28015,8366,8158,16524
2019,Tamaulipas,28,Gómez Farías,28011,4930,4689,9619
2019,Tamaulipas,28,Güémez,28013,8520,7891,16411
2019,Tamaulipas,28,Hidalgo,28016,12504,11885,24389
2019,Tamaulipas,28,Jaumave,28017,8246,7976,16222
2019,Tamaulipas,28,Jiménez,28018,4274,4256,8530
2019,Tamaulipas,28,Llera,28019,9046,8765,17811
2019,Tamaulipas,28,Mainero,28020,1352,1314,2666
2019,Tamaulipas,28,Matamoros,28022,267620,275004,542624
2019,Tamaulipas,28,Mier,28024,2219,2298,4517
2019,Tamaulipas,28,Miguel Alemán,28025,14379,14469,28848
2019,Tamaulipas,28,Miquihuana,28026,1981,1803,3784
2019,Tamaulipas,28,Méndez,28023,2195,2005,4200
2019,Tamaulipas,28,Nuevo Laredo,28027,209541,209160,418701
2019,Tamaulipas,28,Nuevo Morelos,28028,1940,1769,3709
2019,Tamaulipas,28,Ocampo,28029,7340,7062,14402
2019,Tamaulipas,28,Padilla,28030,7413,7291,14704
2019,Tamaulipas,28,Palmillas,28031,928,898,1826
2019,Tamaulipas,28,Reynosa,28032,339652,339577,679229
2019,Tamaulipas,28,Río Bravo,28033,66198,65801,131999
2019,Tamaulipas,28,San Carlos,28034,4936,4465,9401
2019,Tamaulipas,28,San Fernando,28035,29704,29393,59097
2019,Tamaulipas,28,San Nicolás,28036,578,516,1094
2019,Tamaulipas,28,Soto la Marina,28037,13491,12851,26342
2019,Tamaulipas,28,Tampico,28038,159478,172886,332364
2019,Tamaulipas,28,Tula,28039,15254,15350,30604
2019,Tamaulipas,28,Valle Hermoso,28040,33325,34334,67659
2019,Tamaulipas,28,Victoria,28041,177915,185662,363577
2019,Tamaulipas,28,Villagrán,28042,3378,3160,6538
2019,Tamaulipas,28,Xicoténcatl,28043,12499,12488,24987
2019,Tlaxcala,29,Acuamanala de Miguel Hidalgo,29022,3403,3388,6791
2019,Tlaxcala,29,Altzayanca,29004,9199,9164,18363
2019,Tlaxcala,29,Amaxac de Guerrero,29001,5838,6002,11840
2019,Tlaxcala,29,Apetatitlán de Antonio Carvajal,29002,7795,8295,16090
2019,Tlaxcala,29,Apizaco,29005,40423,44244,84667
2019,Tlaxcala,29,Atlangatepec,29003,3410,3550,6960
2019,Tlaxcala,29,Benito Juárez,29045,3153,3240,6393
2019,Tlaxcala,29,Calpulalpan,29006,25099,26374,51473
2019,Tlaxcala,29,Chiautempan,29010,36968,39515,76483
2019,Tlaxcala,29,Contla de Juan Cuamatzi,29018,20166,20681,40847
2019,Tlaxcala,29,Cuapiaxtla,29008,8107,8076,16183
2019,Tlaxcala,29,Cuaxomulco,29009,2817,2842,5659
2019,Tlaxcala,29,El Carmen Tequexquitla,29007,8933,9153,18086
2019,Tlaxcala,29,Emiliano Zapata,29046,2342,2449,4791
2019,Tlaxcala,29,Españita,29012,4627,4705,9332
2019,Tlaxcala,29,Huamantla,29013,48674,50461,99135
2019,Tlaxcala,29,Hueyotlipan,29014,7649,7805,15454
2019,Tlaxcala,29,Ixtacuixtla de Mariano Matamoros,29015,20074,21210,41284
2019,Tlaxcala,29,Ixtenco,29016,3698,3981,7679
2019,Tlaxcala,29,La Magdalena Tlaltelulco,29048,9533,10228,19761
2019,Tlaxcala,29,Lázaro Cárdenas,29047,1610,1640,3250
2019,Tlaxcala,29,Mazatecochco de José María Morelos,29017,5692,5785,11477
2019,Tlaxcala,29,Muñoz de Domingo Arenas,29011,2456,2421,4877
2019,Tlaxcala,29,Nanacamilpa de Mariano Arista,29021,9395,9821,19216
2019,Tlaxcala,29,Natívitas,29023,13041,13941,26982
2019,Tlaxcala,29,Panotla,29024,13907,14847,28754
2019,Tlaxcala,29,Papalotla de Xicohténcatl,29041,15587,16629,32216
2019,Tlaxcala,29,San Damián Texóloc,29049,2966,2982,5948
2019,Tlaxcala,29,San Francisco Tetlanohcan,29050,5593,5836,11429
2019,Tlaxcala,29,San Jerónimo Zacualpan,29051,1924,2133,4057
2019,Tlaxcala,29,San José Teacalco,29052,3104,3252,6356
2019,Tlaxcala,29,San Juan Huactzinco,29053,3815,4160,7975
2019,Tlaxcala,29,San Lorenzo Axocomanitla,29054,2876,3089,5965
2019,Tlaxcala,29,San Lucas Tecopilco,29055,1596,1693,3289
2019,Tlaxcala,29,San Pablo del Monte,29025,40766,40931,81697
2019,Tlaxcala,29,Sanctórum de Lázaro Cárdenas,29020,5140,5235,10375
2019,Tlaxcala,29,Santa Ana Nopalucan,29056,4054,4180,8234
2019,Tlaxcala,29,Santa Apolonia Teacalco,29057,2315,2575,4890
2019,Tlaxcala,29,Santa Catarina Ayometla,29058,4519,4868,9387
2019,Tlaxcala,29,Santa Cruz Quilehtla,29059,3777,3783,7560
2019,Tlaxcala,29,Santa Cruz Tlaxcala,29026,10691,11028,21719
2019,Tlaxcala,29,Santa Isabel Xiloxoxtla,29060,2588,2714,5302
2019,Tlaxcala,29,Tenancingo,29027,6765,6996,13761
2019,Tlaxcala,29,Teolocholco,29028,12506,13247,25753
2019,Tlaxcala,29,Tepetitla de Lardizábal,29019,10814,11612,22426
2019,Tlaxcala,29,Tepeyanco,29029,6701,7305,14006
2019,Tlaxcala,29,Terrenate,29030,8080,7996,16076
2019,Tlaxcala,29,Tetla de la Solidaridad,29031,16992,17437,34429
2019,Tlaxcala,29,Tetlatlahuca,29032,7258,7678,14936
2019,Tlaxcala,29,Tlaxcala,29033,48914,53589,102503
2019,Tlaxcala,29,Tlaxco,29034,22265,23045,45310
2019,Tlaxcala,29,Tocatlán,29035,3093,3157,6250
2019,Tlaxcala,29,Totolac,29036,11463,12422,23885
2019,Tlaxcala,29,Tzompantepec,29038,8796,9397,18193
2019,Tlaxcala,29,Xaloztoc,29039,12788,12699,25487
2019,Tlaxcala,29,Xaltocan,29040,5523,5900,11423
2019,Tlaxcala,29,Xicohtzinco,29042,6947,7625,14572
2019,Tlaxcala,29,Yauhquemehcan,29043,19928,21186,41114
2019,Tlaxcala,29,Zacatelco,29044,22246,24141,46387
2019,Tlaxcala,29,Ziltlaltépec de Trinidad Sánchez Santos,29037,4513,4897,9410
2019,Veracruz,30,Acajete,30001,4658,4429,9087
2019,Veracruz,30,Acatlán,30002,1634,1688,3322
2019,Veracruz,30,Acayucan,30003,43774,47095,90869
2019,Veracruz,30,Actopan,30004,22349,23145,45494
2019,Veracruz,30,Acula,30005,2830,2820,5650
2019,Veracruz,30,Acultzingo,30006,11676,12075,23751
2019,Veracruz,30,Agua Dulce,30204,24492,25903,50395
2019,Veracruz,30,Alpatláhuac,30008,5242,5263,10505
2019,Veracruz,30,Alto Lucero de Gutiérrez Barrios,30009,15307,15238,30545
2019,Veracruz,30,Altotonga,30010,32816,35092,67908
2019,Veracruz,30,Alvarado,30011,27899,28402,56301
2019,Veracruz,30,Amatitlán,30012,4117,4293,8410
2019,Veracruz,30,Amatlán de los Reyes,30014,23015,24624,47639
2019,Veracruz,30,Angel R. Cabada,30015,17395,18370,35765
2019,Veracruz,30,Apazapan,30017,2118,2144,4262
2019,Veracruz,30,Aquila,30018,948,1016,1964
2019,Veracruz,30,Astacinga,30019,3108,3535,6643
2019,Veracruz,30,Atlahuilco,30020,5489,5759,11248
2019,Veracruz,30,Atoyac,30021,12102,12826,24928
2019,Veracruz,30,Atzacan,30022,10981,11287,22268
2019,Veracruz,30,Atzalan,30023,26193,26341,52534
2019,Veracruz,30,Ayahualulco,30025,13859,13968,27827
2019,Veracruz,30,Banderilla,30026,11623,12898,24521
2019,Veracruz,30,Benito Juárez,30027,8963,9381,18344
2019,Veracruz,30,Boca del Río,30028,71634,80468,152102
2019,Veracruz,30,Calcahualco,30029,6768,6712,13480
2019,Veracruz,30,Camarón de Tejeda,30007,3397,3385,6782
2019,Veracruz,30,Camerino Z. Mendoza,30030,21096,23607,44703
2019,Veracruz,30,Carlos A. Carrillo,30208,12386,13430,25816
2019,Veracruz,30,Carrillo Puerto,30031,8681,9025,17706
2019,Veracruz,30,Castillo de Teayo,30157,10425,10241,20666
2019,Veracruz,30,Catemaco,30032,25154,26824,51978
2019,Veracruz,30,Cazones de Herrera,30033,12087,12793,24880
2019,Veracruz,30,Cerro Azul,30034,13443,14904,28347
2019,Veracruz,30,Chacaltianguis,30054,6329,6703,13032
2019,Veracruz,30,Chalma,30055,6926,7143,14069
2019,Veracruz,30,Chiconamel,30056,3404,3619,7023
2019,Veracruz,30,Chiconquiaco,30057,7323,7398,14721
2019,Veracruz,30,Chicontepec,30058,28544,29923,58467
2019,Veracruz,30,Chinameca,30059,8283,8682,16965
2019,Veracruz,30,Chinampa de Gorostiza,30060,8558,8791,17349
2019,Veracruz,30,Chocamán,30062,10888,10954,21842
2019,Veracruz,30,Chontla,30063,7577,7639,15216
2019,Veracruz,30,Chumatlán,30064,1985,2092,4077
2019,Veracruz,30,Citlaltépetl,30035,6068,6344,12412
2019,Veracruz,30,Coacoatzintla,30036,5312,5559,10871
2019,Veracruz,30,Coahuitlán,30037,4335,4464,8799
2019,Veracruz,30,Coatepec,30038,46982,50302,97284
2019,Veracruz,30,Coatzacoalcos,30039,163568,173549,337117
2019,Veracruz,30,Coatzintla,30040,28835,30307,59142
2019,Veracruz,30,Coetzala,30041,1165,1195,2360
2019,Veracruz,30,Colipa,30042,2898,3015,5913
2019,Veracruz,30,Comapa,30043,10721,10285,21006
2019,Veracruz,30,Cosamaloapan de Carpio,30045,28540,31010,59550
2019,Veracruz,30,Cosautlán de Carvajal,30046,8467,8570,17037
2019,Veracruz,30,Coscomatepec,30047,29723,30637,60360
2019,Veracruz,30,Cosoleacaque,30048,70012,74899,144911
2019,Veracruz,30,Cotaxtla,30049,10915,10955,21870
2019,Veracruz,30,Coxquihui,30050,8518,8878,17396
2019,Veracruz,30,Coyutla,30051,11299,12130,23429
2019,Veracruz,30,Cuichapa,30052,6071,6693,12764
2019,Veracruz,30,Cuitláhuac,30053,14023,15294,29317
2019,Veracruz,30,Córdoba,30044,106925,120209,227134
2019,Veracruz,30,El Higo,30205,10213,10278,20491
2019,Veracruz,30,Emiliano Zapata,30065,40013,42787,82800
2019,Veracruz,30,Espinal,30066,13864,14512,28376
2019,Veracruz,30,Filomeno Mata,30067,9653,9582,19235
2019,Veracruz,30,Fortín,30068,33095,36633,69728
2019,Veracruz,30,Gutiérrez Zamora,30069,12150,13671,25821
2019,Veracruz,30,Hidalgotitlán,30070,9964,9674,19638
2019,Veracruz,30,Huatusco,30071,30532,32570,63102
2019,Veracruz,30,Huayacocotla,30072,10884,11569,22453
2019,Veracruz,30,Hueyapan de Ocampo,30073,21959,23131,45090
2019,Veracruz,30,Huiloapan de Cuauhtémoc,30074,3670,3918,7588
2019,Veracruz,30,Ignacio de la Llave,30075,8733,9467,18200
2019,Veracruz,30,Ilamatlán,30076,6795,7407,14202
2019,Veracruz,30,Isla,30077,22148,23133,45281
2019,Veracruz,30,Ixcatepec,30078,7052,7029,14081
2019,Veracruz,30,Ixhuacán de los Reyes,30079,6024,5899,11923
2019,Veracruz,30,Ixhuatlancillo,30081,12917,13992,26909
2019,Veracruz,30,Ixhuatlán de Madero,30083,27459,28690,56149
2019,Veracruz,30,Ixhuatlán del Café,30080,11889,11942,23831
2019,Veracruz,30,Ixhuatlán del Sureste,30082,8243,8198,16441
2019,Veracruz,30,Ixmatlahuacan,30084,3001,3053,6054
2019,Veracruz,30,Ixtaczoquitlán,30085,35074,37136,72210
2019,Veracruz,30,Jalacingo,30086,22623,23524,46147
2019,Veracruz,30,Jalcomulco,30088,2701,2649,5350
2019,Veracruz,30,Jamapa,30090,5826,6054,11880
2019,Veracruz,30,Jesús Carranza,30091,15018,15121,30139
2019,Veracruz,30,Jilotepec,30093,8497,8925,17422
2019,Veracruz,30,José Azueta,30169,11833,12274,24107
2019,Veracruz,30,Juan Rodríguez Clara,30094,20174,20661,40835
2019,Veracruz,30,Juchique de Ferrer,30095,8251,8421,16672
2019,Veracruz,30,Jáltipan,30089,20847,22717,43564
2019,Veracruz,30,La Antigua,30016,13700,14654,28354
2019,Veracruz,30,La Perla,30127,14078,14570,28648
2019,Veracruz,30,Landero y Coss,30096,807,852,1659
2019,Veracruz,30,Las Choapas,30061,41537,43043,84580
2019,Veracruz,30,Las Minas,30107,1591,1521,3112
2019,Veracruz,30,Las Vigas de Ramírez,30132,10216,10257,20473
2019,Veracruz,30,Lerdo de Tejada,30097,9779,11132,20911
2019,Veracruz,30,Los Reyes,30137,3056,3094,6150
2019,Veracruz,30,Magdalena,30098,1605,1614,3219
2019,Veracruz,30,Maltrata,30099,9051,9666,18717
2019,Veracruz,30,Manlio Fabio Altamirano,30100,12170,12518,24688
2019,Veracruz,30,Mariano Escobedo,30101,18470,19832,38302
2019,Veracruz,30,Martínez de la Torre,30102,53349,57758,111107
2019,Veracruz,30,Mecatlán,30103,6362,6532,12894
2019,Veracruz,30,Mecayapan,30104,8525,8910,17435
2019,Veracruz,30,Medellín,30105,39205,42371,81576
2019,Veracruz,30,Miahuatlán,30106,2411,2486,4897
2019,Veracruz,30,Minatitlán,30108,79340,84433,163773
2019,Veracruz,30,Misantla,30109,32949,34534,67483
2019,Veracruz,30,Mixtla de Altamirano,30110,6110,5983,12093
2019,Veracruz,30,Moloacán,30111,8773,9251,18024
2019,Veracruz,30,Nanchital de Lázaro Cárdenas del Rio,30206,15094,15949,31043
2019,Veracruz,30,Naolinco,30112,11160,11648,22808
2019,Veracruz,30,Naranjal,30113,2333,2471,4804
2019,Veracruz,30,Naranjos Amatlán,30013,14217,15719,29936
2019,Veracruz,30,Nautla,30114,5612,5818,11430
2019,Veracruz,30,Nogales,30115,18891,20590,39481
2019,Veracruz,30,Oluta,30116,8265,8895,17160
2019,Veracruz,30,Omealca,30117,12090,12928,25018
2019,Veracruz,30,Orizaba,30118,61703,71998,133701
2019,Veracruz,30,Otatitlán,30119,2846,3098,5944
2019,Veracruz,30,Oteapan,30120,8317,8608,16925
2019,Veracruz,30,Ozuluama de Mascareñas,30121,12499,11923,24422
2019,Veracruz,30,Pajapan,30122,9063,8987,18050
2019,Veracruz,30,Papantla,30124,82343,84080,166423
2019,Veracruz,30,Paso de Ovejas,30126,17579,17680,35259
2019,Veracruz,30,Paso del Macho,30125,16389,16741,33130
2019,Veracruz,30,Perote,30128,38106,38330,76436
2019,Veracruz,30,Platón Sánchez,30129,9355,9711,19066
2019,Veracruz,30,Playa Vicente,30130,19096,20761,39857
2019,Veracruz,30,Poza Rica de Hidalgo,30131,102536,113396,215932
2019,Veracruz,30,Pueblo Viejo,30133,30432,30258,60690
2019,Veracruz,30,Puente Nacional,30134,11699,12044,23743
2019,Veracruz,30,Pánuco,30123,52552,52862,105414
2019,Veracruz,30,Rafael Delgado,30135,11910,12256,24166
2019,Veracruz,30,Rafael Lucio,30136,4092,4315,8407
2019,Veracruz,30,Río Blanco,30138,20894,23491,44385
2019,Veracruz,30,Saltabarranca,30139,3140,3345,6485
2019,Veracruz,30,San Andrés Tenejapan,30140,1505,1565,3070
2019,Veracruz,30,San Andrés Tuxtla,30141,82971,89360,172331
2019,Veracruz,30,San Juan Evangelista,30142,17425,18021,35446
2019,Veracruz,30,San Rafael,30211,15397,15957,31354
2019,Veracruz,30,Santiago Sochiapan,30212,7222,7694,14916
2019,Veracruz,30,Santiago Tuxtla,30143,29102,31248,60350
2019,Veracruz,30,Sayula de Alemán,30144,16806,17362,34168
2019,Veracruz,30,Sochiapa,30146,1916,1901,3817
2019,Veracruz,30,Soconusco,30145,8244,8666,16910
2019,Veracruz,30,Soledad Atzompa,30147,12004,12087,24091
2019,Veracruz,30,Soledad de Doblado,30148,14402,14671,29073
2019,Veracruz,30,Soteapan,30149,17634,18188,35822
2019,Veracruz,30,Tamalín,30150,6121,6077,12198
2019,Veracruz,30,Tamiahua,30151,12266,12153,24419
2019,Veracruz,30,Tampico Alto,30152,6746,6291,13037
2019,Veracruz,30,Tancoco,30153,2952,3113,6065
2019,Veracruz,30,Tantima,30154,6932,6696,13628
2019,Veracruz,30,Tantoyuca,30155,53848,54810,108658
2019,Veracruz,30,Tatahuicapan de Juárez,30209,7889,8234,16123
2019,Veracruz,30,Tatatila,30156,3205,2928,6133
2019,Veracruz,30,Tecolutla,30158,12490,12853,25343
2019,Veracruz,30,Tehuipango,30159,13135,13900,27035
2019,Veracruz,30,Tempoal,30161,18379,18899,37278
2019,Veracruz,30,Tenampa,30162,3442,3593,7035
2019,Veracruz,30,Tenochtitlán,30163,2610,2807,5417
2019,Veracruz,30,Teocelo,30164,8502,8975,17477
2019,Veracruz,30,Tepatlaxco,30165,4541,4308,8849
2019,Veracruz,30,Tepetlán,30166,5130,4961,10091
2019,Veracruz,30,Tepetzintla,30167,7583,7762,15345
2019,Veracruz,30,Tequila,30168,7814,8046,15860
2019,Veracruz,30,Texcatepec,30170,5603,5860,11463
2019,Veracruz,30,Texhuacán,30171,2651,2952,5603
2019,Veracruz,30,Texistepec,30172,10854,10827,21681
2019,Veracruz,30,Tezonapa,30173,29144,29784,58928
2019,Veracruz,30,Tierra Blanca,30174,52905,56921,109826
2019,Veracruz,30,Tihuatlán,30175,49181,51053,100234
2019,Veracruz,30,Tlachichilco,30180,5952,6156,12108
2019,Veracruz,30,Tlacojalpan,30176,2537,2617,5154
2019,Veracruz,30,Tlacolulan,30177,5972,5769,11741
2019,Veracruz,30,Tlacotalpan,30178,6787,7321,14108
2019,Veracruz,30,Tlacotepec de Mejía,30179,2051,2088,4139
2019,Veracruz,30,Tlalixcoyan,30181,19645,20264,39909
2019,Veracruz,30,Tlalnelhuayocan,30182,9620,9936,19556
2019,Veracruz,30,Tlaltetela,30024,8292,8064,16356
2019,Veracruz,30,Tlapacoyan,30183,31471,33232,64703
2019,Veracruz,30,Tlaquilpa,30184,3734,4256,7990
2019,Veracruz,30,Tlilapan,30185,2712,2830,5542
2019,Veracruz,30,Tomatlán,30186,3590,3697,7287
2019,Veracruz,30,Tonayán,30187,2912,3071,5983
2019,Veracruz,30,Totutla,30188,9063,9128,18191
2019,Veracruz,30,Tres Valles,30207,23640,24900,48540
2019,Veracruz,30,Tuxpan,30189,82157,86122,168279
2019,Veracruz,30,Tuxtilla,30190,1161,1188,2349
2019,Veracruz,30,Ursulo Galván,30191,15678,16570,32248
2019,Veracruz,30,Uxpanapa,30210,15320,14962,30282
2019,Veracruz,30,Vega de Alatorre,30192,10264,10958,21222
2019,Veracruz,30,Veracruz,30193,299166,323108,622274
2019,Veracruz,30,Villa Aldama,30194,6096,6202,12298
2019,Veracruz,30,Xalapa,30087,240584,269704,510288
2019,Veracruz,30,Xico,30092,19822,20264,40086
2019,Veracruz,30,Xoxocotla,30195,2897,2756,5653
2019,Veracruz,30,Yanga,30196,8856,10000,18856
2019,Veracruz,30,Yecuatla,30197,6139,6359,12498
2019,Veracruz,30,Zacualpan,30198,3615,3868,7483
2019,Veracruz,30,Zaragoza,30199,5788,6039,11827
2019,Veracruz,30,Zentla,30200,7057,6919,13976
2019,Veracruz,30,Zongolica,30201,22624,23007,45631
2019,Veracruz,30,Zontecomatlán de López y Fuentes,30202,7520,7665,15185
2019,Veracruz,30,Zozocolco de Hidalgo,30203,7637,7932,15569
2019,Veracruz,30,Álamo Temapache,30160,54701,55359,110060
2019,Yucatán,31,Abalá,31001,3567,3400,6967
2019,Yucatán,31,Acanceh,31002,8616,8597,17213
2019,Yucatán,31,Akil,31003,5778,5990,11768
2019,Yucatán,31,Baca,31004,3134,3195,6329
2019,Yucatán,31,Bokobá,31005,1187,1135,2322
2019,Yucatán,31,Buctzotz,31006,4756,4725,9481
2019,Yucatán,31,Cacalchén,31007,3940,3743,7683
2019,Yucatán,31,Calotmul,31008,2158,2136,4294
2019,Yucatán,31,Cansahcab,31009,2466,2492,4958
2019,Yucatán,31,Cantamayec,31010,1387,1273,2660
2019,Yucatán,31,Celestún,31011,4186,3980,8166
2019,Yucatán,31,Cenotillo,31012,1998,2147,4145
2019,Yucatán,31,Chacsinkín,31016,1599,1568,3167
2019,Yucatán,31,Chankom,31017,2472,2389,4861
2019,Yucatán,31,Chapab,31018,1684,1673,3357
2019,Yucatán,31,Chemax,31019,19442,19117,38559
2019,Yucatán,31,Chichimilá,31021,4471,4405,8876
2019,Yucatán,31,Chicxulub Pueblo,31020,2445,2305,4750
2019,Yucatán,31,Chikindzonot,31022,2247,2176,4423
2019,Yucatán,31,Chocholá,31023,2560,2466,5026
2019,Yucatán,31,Chumayel,31024,1703,1768,3471
2019,Yucatán,31,Conkal,31013,5863,5830,11693
2019,Yucatán,31,Cuncunul,31014,870,839,1709
2019,Yucatán,31,Cuzamá,31015,2795,2712,5507
2019,Yucatán,31,Dzemul,31026,1981,1953,3934
2019,Yucatán,31,Dzidzantún,31027,4462,4351,8813
2019,Yucatán,31,Dzilam González,31029,3338,3158,6496
2019,Yucatán,31,Dzilam de Bravo,31028,1472,1391,2863
2019,Yucatán,31,Dzitás,31030,2044,1946,3990
2019,Yucatán,31,Dzoncauich,31031,1406,1425,2831
2019,Yucatán,31,Dzán,31025,2751,2882,5633
2019,Yucatán,31,Espita,31032,8698,8429,17127
2019,Yucatán,31,Halachó,31033,10829,10574,21403
2019,Yucatán,31,Hocabá,31034,3286,3265,6551
2019,Yucatán,31,Hoctún,31035,3121,3185,6306
2019,Yucatán,31,Homún,31036,4159,4002,8161
2019,Yucatán,31,Huhí,31037,2810,2703,5513
2019,Yucatán,31,Hunucmá,31038,17233,17260,34493
2019,Yucatán,31,Ixil,31039,2220,2125,4345
2019,Yucatán,31,Izamal,31040,14181,14403,28584
2019,Yucatán,31,Kanasín,31041,52852,53551,106403
2019,Yucatán,31,Kantunil,31042,2838,2943,5781
2019,Yucatán,31,Kaua,31043,1671,1596,3267
2019,Yucatán,31,Kinchil,31044,3830,3741,7571
2019,Yucatán,31,Kopomá,31045,1391,1305,2696
2019,Yucatán,31,Mama,31046,1583,1750,3333
2019,Yucatán,31,Maní,31047,2905,3031,5936
2019,Yucatán,31,Maxcanú,31048,12149,11949,24098
2019,Yucatán,31,Mayapán,31049,1994,1858,3852
2019,Yucatán,31,Mocochá,31051,1756,1716,3472
2019,Yucatán,31,Motul,31052,19164,19428,38592
2019,Yucatán,31,Muna,31053,6611,6856,13467
2019,Yucatán,31,Muxupip,31054,1491,1552,3043
2019,Yucatán,31,Mérida,31050,459910,492893,952803
2019,Yucatán,31,Opichén,31055,3645,3516,7161
2019,Yucatán,31,Oxkutzcab,31056,15707,17154,32861
2019,Yucatán,31,Panabá,31057,4103,4101,8204
2019,Yucatán,31,Peto,31058,13228,13408,26636
2019,Yucatán,31,Progreso,31059,31078,31269,62347
2019,Yucatán,31,Quintana Roo,31060,512,509,1021
2019,Yucatán,31,Río Lagartos,31061,1939,1841,3780
2019,Yucatán,31,Sacalum,31062,2632,2477,5109
2019,Yucatán,31,Samahil,31063,2756,2732,5488
2019,Yucatán,31,San Felipe,31065,1061,995,2056
2019,Yucatán,31,Sanahcat,31064,905,903,1808
2019,Yucatán,31,Santa Elena,31066,2073,2176,4249
2019,Yucatán,31,Seyé,31067,5265,5019,10284
2019,Yucatán,31,Sinanché,31068,1744,1601,3345
2019,Yucatán,31,Sotuta,31069,4786,4605,9391
2019,Yucatán,31,Sucilá,31070,2123,2051,4174
2019,Yucatán,31,Sudzal,31071,953,856,1809
2019,Yucatán,31,Suma,31072,994,955,1949
2019,Yucatán,31,Tahdziú,31073,2732,2570,5302
2019,Yucatán,31,Tahmek,31074,2005,1933,3938
2019,Yucatán,31,Teabo,31075,3451,3500,6951
2019,Yucatán,31,Tecoh,31076,9347,9241,18588
2019,Yucatán,31,Tekal de Venegas,31077,1427,1389,2816
2019,Yucatán,31,Tekantó,31078,2008,2012,4020
2019,Yucatán,31,Tekax,31079,22183,22821,45004
2019,Yucatán,31,Tekit,31080,5527,5352,10879
2019,Yucatán,31,Tekom,31081,1703,1706,3409
2019,Yucatán,31,Telchac Pueblo,31082,2017,1989,4006
2019,Yucatán,31,Telchac Puerto,31083,997,904,1901
2019,Yucatán,31,Temax,31084,3847,3815,7662
2019,Yucatán,31,Temozón,31085,8352,8094,16446
2019,Yucatán,31,Tepakán,31086,1201,1146,2347
2019,Yucatán,31,Tetiz,31087,2665,2700,5365
2019,Yucatán,31,Teya,31088,1027,1047,2074
2019,Yucatán,31,Ticul,31089,21022,21525,42547
2019,Yucatán,31,Timucuy,31090,3991,3800,7791
2019,Yucatán,31,Tinum,31091,6445,6197,12642
2019,Yucatán,31,Tixcacalcupul,31092,3803,3733,7536
2019,Yucatán,31,Tixkokob,31093,9494,9640,19134
2019,Yucatán,31,Tixmehuac,31094,2593,2557,5150
2019,Yucatán,31,Tixpéhual,31095,2897,2972,5869
2019,Yucatán,31,Tizimín,31096,40572,41379,81951
2019,Yucatán,31,Tunkás,31097,1900,1826,3726
2019,Yucatán,31,Tzucacab,31098,7870,7684,15554
2019,Yucatán,31,Uayma,31099,2205,2101,4306
2019,Yucatán,31,Ucú,31100,1973,1942,3915
2019,Yucatán,31,Umán,31101,28956,28854,57810
2019,Yucatán,31,Valladolid,31102,42301,42938,85239
2019,Yucatán,31,Xocchel,31103,1876,1799,3675
2019,Yucatán,31,Yaxcabá,31104,8331,7837,16168
2019,Yucatán,31,Yaxkukul,31105,1660,1673,3333
2019,Yucatán,31,Yobaín,31106,1225,1173,2398
2019,Zacatecas,32,Apozol,32001,3070,3265,6335
2019,Zacatecas,32,Apulco,32002,2410,2669,5079
2019,Zacatecas,32,Atolinga,32003,1269,1348,2617
2019,Zacatecas,32,Benito Juárez,32004,2183,2112,4295
2019,Zacatecas,32,Calera,32005,23541,23440,46981
2019,Zacatecas,32,Cañitas de Felipe Pescador,32006,4296,4400,8696
2019,Zacatecas,32,Chalchihuites,32009,5720,6040,11760
2019,Zacatecas,32,Concepción del Oro,32007,7000,6826,13826
2019,Zacatecas,32,Cuauhtémoc,32008,6434,6729,13163
2019,Zacatecas,32,El Plateado de Joaquín Amaro,32015,666,676,1342
2019,Zacatecas,32,El Salvador,32041,1297,1248,2545
2019,Zacatecas,32,Fresnillo,32010,119180,121749,240929
2019,Zacatecas,32,Genaro Codina,32012,4157,4363,8520
2019,Zacatecas,32,General Enrique Estrada,32013,3261,3324,6585
2019,Zacatecas,32,General Francisco R. Murguía,32014,10993,11731,22724
2019,Zacatecas,32,General Pánfilo Natera,32016,11866,12313,24179
2019,Zacatecas,32,Guadalupe,32017,96260,100527,196787
2019,Zacatecas,32,Huanusco,32018,2083,2178,4261
2019,Zacatecas,32,Jalpa,32019,12381,12925,25306
2019,Zacatecas,32,Jerez,32020,30415,32142,62557
2019,Zacatecas,32,Jiménez del Teul,32021,2228,2260,4488
2019,Zacatecas,32,Juan Aldama,32022,11004,11622,22626
2019,Zacatecas,32,Juchipila,32023,6315,6960,13275
2019,Zacatecas,32,Loreto,32024,27808,28160,55968
2019,Zacatecas,32,Luis Moya,32025,6882,6944,13826
2019,Zacatecas,32,Mazapil,32026,9637,8707,18344
2019,Zacatecas,32,Melchor Ocampo,32027,1637,1438,3075
2019,Zacatecas,32,Mezquital del Oro,32028,1245,1357,2602
2019,Zacatecas,32,Miguel Auza,32029,12132,12568,24700
2019,Zacatecas,32,Momax,32030,1229,1317,2546
2019,Zacatecas,32,Monte Escobedo,32031,4780,4870,9650
2019,Zacatecas,32,Morelos,32032,6508,6514,13022
2019,Zacatecas,32,Moyahua de Estrada,32033,1990,2238,4228
2019,Zacatecas,32,Nochistlán de Mejía,32034,13906,15309,29215
2019,Zacatecas,32,Noria de Ángeles,32035,8615,8867,17482
2019,Zacatecas,32,Ojocaliente,32036,22045,23001,45046
2019,Zacatecas,32,Pinos,32038,37478,38977,76455
2019,Zacatecas,32,Pánuco,32037,9345,9292,18637
2019,Zacatecas,32,Río Grande,32039,32570,34580,67150
2019,Zacatecas,32,Sain Alto,32040,11274,11868,23142
2019,Zacatecas,32,Santa María de la Paz,32058,1414,1435,2849
2019,Zacatecas,32,Sombrerete,32042,32127,32955,65082
2019,Zacatecas,32,Susticacán,32043,680,739,1419
2019,Zacatecas,32,Tabasco,32044,7969,8349,16318
2019,Zacatecas,32,Tepechitlán,32045,4373,4751,9124
2019,Zacatecas,32,Tepetongo,32046,3613,3831,7444
2019,Zacatecas,32,Teúl de González Ortega,32047,2550,2670,5220
2019,Zacatecas,32,Tlaltenango de Sánchez Román,32048,13708,14173,27881
2019,Zacatecas,32,Trancoso,32057,9969,10143,20112
2019,Zacatecas,32,Trinidad García de la Cadena,32011,1488,1537,3025
2019,Zacatecas,32,Valparaíso,32049,17085,17541,34626
2019,Zacatecas,32,Vetagrande,32050,5161,5281,10442
2019,Zacatecas,32,Villa García,32052,9929,10085,20014
2019,Zacatecas,32,Villa González Ortega,32053,6718,7135,13853
2019,Zacatecas,32,Villa Hidalgo,32054,9978,10090,20068
2019,Zacatecas,32,Villa de Cos,32051,18585,18309,36894
2019,Zacatecas,32,Villanueva,32055,15502,16146,31648
2019,Zacatecas,32,Zacatecas,32056,75290,79320,154610
2020,Aguascalientes,01,Aguascalientes,01001,471961,490016,961977
2020,Aguascalientes,01,Asientos,01002,25309,25555,50864
2020,Aguascalientes,01,Calvillo,01003,29733,31027,60760
2020,Aguascalientes,01,Cosío,01004,8304,8614,16918
2020,Aguascalientes,01,El Llano,01010,11128,10819,21947
2020,Aguascalientes,01,Jesús María,01005,65378,64806,130184
2020,Aguascalientes,01,Pabellón de Arteaga,01006,24464,25568,50032
2020,Aguascalientes,01,Rincón de Romos,01007,28794,29187,57981
2020,Aguascalientes,01,San Francisco de los Romo,01011,25690,25878,51568
2020,Aguascalientes,01,San José de Gracia,01008,4683,4978,9661
2020,Aguascalientes,01,Tepezalá,01009,11190,11553,22743
2020,Baja California,02,Ensenada,02001,267864,268279,536143
2020,Baja California,02,Mexicali,02002,542778,544700,1087478
2020,Baja California,02,Playas de Rosarito,02005,54015,53844,107859
2020,Baja California,02,Tecate,02003,58707,55150,113857
2020,Baja California,02,Tijuana,02004,892283,897248,1789531
2020,Baja California Sur,03,Comondú,03001,42109,40942,83051
2020,Baja California Sur,03,La Paz,03003,150537,151424,301961
2020,Baja California Sur,03,Loreto,03009,11302,10355,21657
2020,Baja California Sur,03,Los Cabos,03008,169962,160350,330312
2020,Baja California Sur,03,Mulegé,03002,35112,32615,67727
2020,Campeche,04,Calakmul,04010,16120,15603,31723
2020,Campeche,04,Calkiní,04001,31152,32146,63298
2020,Campeche,04,Campeche,04002,153137,164287,317424
2020,Campeche,04,Candelaria,04011,24654,24068,48722
2020,Campeche,04,Carmen,04003,137161,138317,275478
2020,Campeche,04,Champotón,04004,50122,49823,99945
2020,Campeche,04,Escárcega,04009,31348,32147,63495
2020,Campeche,04,Hecelchakán,04005,17301,17382,34683
2020,Campeche,04,Hopelchén,04006,22497,21554,44051
2020,Campeche,04,Palizada,04007,4993,4875,9868
2020,Campeche,04,Tenabo,04008,6119,5811,11930
2020,Chiapas,07,Acacoyagua,07001,9955,9901,19856
2020,Chiapas,07,Acala,07002,17118,17376,34494
2020,Chiapas,07,Acapetahua,07003,15547,15522,31069
2020,Chiapas,07,Aldama,07113,3438,3714,7152
2020,Chiapas,07,Altamirano,07004,18108,17874,35982
2020,Chiapas,07,Amatenango de la Frontera,07006,16445,17415,33860
2020,Chiapas,07,Amatenango del Valle,07007,5184,5595,10779
2020,Chiapas,07,Amatán,07005,11067,10769,21836
2020,Chiapas,07,Angel Albino Corzo,07008,15415,15510,30925
2020,Chiapas,07,Arriaga,07009,21422,22842,44264
2020,Chiapas,07,Bejucal de Ocampo,07010,4180,4144,8324
2020,Chiapas,07,Bella Vista,07011,10925,11103,22028
2020,Chiapas,07,Benemérito de las Américas,07114,10906,10697,21603
2020,Chiapas,07,Berriozábal,07012,28431,28540,56971
2020,Chiapas,07,Bochil,07013,18877,19224,38101
2020,Chiapas,07,Cacahoatán,07015,24593,25846,50439
2020,Chiapas,07,Catazajá,07016,9595,9411,19006
2020,Chiapas,07,Chalchihuitán,07022,8927,9089,18016
2020,Chiapas,07,Chamula,07023,44091,51266,95357
2020,Chiapas,07,Chanal,07024,6644,6688,13332
2020,Chiapas,07,Chapultenango,07025,4127,4121,8248
2020,Chiapas,07,Chenalhó,07026,21496,21957,43453
2020,Chiapas,07,Chiapa de Corzo,07027,54670,56553,111223
2020,Chiapas,07,Chiapilla,07028,3268,3138,6406
2020,Chiapas,07,Chicoasén,07029,2802,2803,5605
2020,Chiapas,07,Chicomuselo,07030,18934,19188,38122
2020,Chiapas,07,Chilón,07031,69239,70784,140023
2020,Chiapas,07,Cintalapa,07017,46675,46843,93518
2020,Chiapas,07,Coapilla,07018,4958,5077,10035
2020,Chiapas,07,Comitán de Domínguez,07019,81411,89087,170498
2020,Chiapas,07,Copainalá,07021,11751,12279,24030
2020,Chiapas,07,El Bosque,07014,11773,12601,24374
2020,Chiapas,07,El Porvenir,07070,7734,7767,15501
2020,Chiapas,07,Escuintla,07032,17038,17590,34628
2020,Chiapas,07,Francisco León,07033,4197,4081,8278
2020,Chiapas,07,Frontera Comalapa,07034,39190,41615,80805
2020,Chiapas,07,Frontera Hidalgo,07035,7685,8056,15741
2020,Chiapas,07,Huehuetán,07037,18571,19614,38185
2020,Chiapas,07,Huitiupán,07039,12664,12497,25161
2020,Chiapas,07,Huixtla,07040,28569,30640,59209
2020,Chiapas,07,Huixtán,07038,12605,13011,25616
2020,Chiapas,07,Ixhuatán,07042,6074,6243,12317
2020,Chiapas,07,Ixtacomitán,07043,5842,5935,11777
2020,Chiapas,07,Ixtapa,07044,14807,14971,29778
2020,Chiapas,07,Ixtapangajoya,07045,3035,2953,5988
2020,Chiapas,07,Jiquipilas,07046,21304,21988,43292
2020,Chiapas,07,Jitotol,07047,11469,11150,22619
2020,Chiapas,07,Juárez,07048,11627,11900,23527
2020,Chiapas,07,La Concordia,07020,25416,25119,50535
2020,Chiapas,07,La Grandeza,07036,3899,3983,7882
2020,Chiapas,07,La Independencia,07041,24332,25270,49602
2020,Chiapas,07,La Libertad,07050,2668,2756,5424
2020,Chiapas,07,La Trinitaria,07099,41631,43713,85344
2020,Chiapas,07,Larráinzar,07049,12647,13078,25725
2020,Chiapas,07,Las Margaritas,07052,66762,67997,134759
2020,Chiapas,07,Las Rosas,07075,15283,15591,30874
2020,Chiapas,07,Mapastepec,07051,25497,26378,51875
2020,Chiapas,07,Maravilla Tenejapa,07115,7000,6755,13755
2020,Chiapas,07,Marqués de Comillas,07116,6202,6024,12226
2020,Chiapas,07,Mazapa de Madero,07053,4204,4348,8552
2020,Chiapas,07,Mazatán,07054,15700,16156,31856
2020,Chiapas,07,Metapa,07055,2985,3206,6191
2020,Chiapas,07,Mitontic,07056,6606,6680,13286
2020,Chiapas,07,Montecristo de Guerrero,07117,4242,4125,8367
2020,Chiapas,07,Motozintla,07057,39137,40595,79732
2020,Chiapas,07,Nicolás Ruíz,07058,2429,2297,4726
2020,Chiapas,07,Ocosingo,07059,119232,120090,239322
2020,Chiapas,07,Ocotepec,07060,6757,7016,13773
2020,Chiapas,07,Ocozocoautla de Espinosa,07061,49565,50753,100318
2020,Chiapas,07,Ostuacán,07062,10049,9920,19969
2020,Chiapas,07,Osumacinta,07063,2055,2055,4110
2020,Chiapas,07,Oxchuc,07064,26002,25729,51731
2020,Chiapas,07,Palenque,07065,64740,66751,131491
2020,Chiapas,07,Pantelhó,07066,11964,12143,24107
2020,Chiapas,07,Pantepec,07067,6643,6727,13370
2020,Chiapas,07,Pichucalco,07068,16993,17347,34340
2020,Chiapas,07,Pijijiapan,07069,28689,29478,58167
2020,Chiapas,07,Pueblo Nuevo Solistahuacán,07072,16884,18260,35144
2020,Chiapas,07,Rayón,07073,5242,5322,10564
2020,Chiapas,07,Reforma,07074,24519,24961,49480
2020,Chiapas,07,Sabanilla,07076,14763,14585,29348
2020,Chiapas,07,Salto de Agua,07077,34217,34562,68779
2020,Chiapas,07,San Andrés Duraznal,07118,2846,2999,5845
2020,Chiapas,07,San Cristóbal de las Casas,07078,110067,121278,231345
2020,Chiapas,07,San Fernando,07079,21667,21272,42939
2020,Chiapas,07,San Juan Cancuc,07112,18500,19311,37811
2020,Chiapas,07,San Lucas,07110,3945,3951,7896
2020,Chiapas,07,Santiago el Pinar,07119,2006,1969,3975
2020,Chiapas,07,Siltepec,07080,20073,19463,39536
2020,Chiapas,07,Simojovel,07081,23836,24210,48046
2020,Chiapas,07,Sitalá,07082,7725,7799,15524
2020,Chiapas,07,Socoltenango,07083,10033,10128,20161
2020,Chiapas,07,Solosuchiapa,07084,4419,4393,8812
2020,Chiapas,07,Soyaló,07085,5906,5843,11749
2020,Chiapas,07,Suchiapa,07086,13275,13235,26510
2020,Chiapas,07,Suchiate,07087,20663,21538,42201
2020,Chiapas,07,Sunuapa,07088,1321,1280,2601
2020,Chiapas,07,Tapachula,07089,184092,200220,384312
2020,Chiapas,07,Tapalapa,07090,2117,2229,4346
2020,Chiapas,07,Tapilula,07091,6932,7265,14197
2020,Chiapas,07,Tecpatán,07092,22544,22903,45447
2020,Chiapas,07,Tenejapa,07093,23253,24468,47721
2020,Chiapas,07,Teopisca,07094,22959,24258,47217
2020,Chiapas,07,Tila,07096,42846,42661,85507
2020,Chiapas,07,Tonalá,07097,48295,49544,97839
2020,Chiapas,07,Totolapa,07098,3965,3929,7894
2020,Chiapas,07,Tumbalá,07100,18283,19098,37381
2020,Chiapas,07,Tuxtla Chico,07102,22302,23598,45900
2020,Chiapas,07,Tuxtla Gutiérrez,07101,315757,346834,662591
2020,Chiapas,07,Tuzantán,07103,17171,17696,34867
2020,Chiapas,07,Tzimol,07104,8243,8631,16874
2020,Chiapas,07,Unión Juárez,07105,8160,8620,16780
2020,Chiapas,07,Venustiano Carranza,07106,35372,35620,70992
2020,Chiapas,07,Villa Comaltitlán,07071,15569,15953,31522
2020,Chiapas,07,Villa Corzo,07107,42147,43637,85784
2020,Chiapas,07,Villaflores,07108,56660,59031,115691
2020,Chiapas,07,Yajalón,07109,20384,21271,41655
2020,Chiapas,07,Zinacantán,07111,21002,23822,44824
2020,Chihuahua,08,Ahumada,08001,6552,6401,12953
2020,Chihuahua,08,Aldama,08002,13029,13168,26197
2020,Chihuahua,08,Allende,08003,4782,4671,9453
2020,Chihuahua,08,Aquiles Serdán,08004,9830,9220,19050
2020,Chihuahua,08,Ascensión,08005,13376,13033,26409
2020,Chihuahua,08,Bachíniva,08006,3433,3296,6729
2020,Chihuahua,08,Balleza,08007,9050,8775,17825
2020,Chihuahua,08,Batopilas,08008,6462,6477,12939
2020,Chihuahua,08,Bocoyna,08009,14613,15222,29835
2020,Chihuahua,08,Buenaventura,08010,12616,12385,25001
2020,Chihuahua,08,Camargo,08011,27122,28133,55255
2020,Chihuahua,08,Carichí,08012,5071,5012,10083
2020,Chihuahua,08,Casas Grandes,08013,6203,5940,12143
2020,Chihuahua,08,Chihuahua,08019,462646,486749,949395
2020,Chihuahua,08,Chínipas,08020,4485,4056,8541
2020,Chihuahua,08,Coronado,08014,1230,1134,2364
2020,Chihuahua,08,Coyame del Sotol,08015,997,822,1819
2020,Chihuahua,08,Cuauhtémoc,08017,88071,93481,181552
2020,Chihuahua,08,Cusihuiriachi,08018,2638,2460,5098
2020,Chihuahua,08,Delicias,08021,78321,81924,160245
2020,Chihuahua,08,Dr. Belisario Domínguez,08022,1402,1368,2770
2020,Chihuahua,08,El Tule,08064,932,898,1830
2020,Chihuahua,08,Galeana,08023,3532,3524,7056
2020,Chihuahua,08,Gran Morelos,08026,1423,1364,2787
2020,Chihuahua,08,Guachochi,08027,24413,25513,49926
2020,Chihuahua,08,Guadalupe,08028,2512,2568,5080
2020,Chihuahua,08,Guadalupe y Calvo,08029,29631,29027,58658
2020,Chihuahua,08,Guazapares,08030,4404,4199,8603
2020,Chihuahua,08,Guerrero,08031,21343,21066,42409
2020,Chihuahua,08,Gómez Farías,08025,4801,4798,9599
2020,Chihuahua,08,Hidalgo del Parral,08032,57031,60593,117624
2020,Chihuahua,08,Huejotitán,08033,537,533,1070
2020,Chihuahua,08,Ignacio Zaragoza,08034,3775,3713,7488
2020,Chihuahua,08,Janos,08035,6151,5627,11778
2020,Chihuahua,08,Jiménez,08036,22701,23008,45709
2020,Chihuahua,08,Julimes,08038,2504,2409,4913
2020,Chihuahua,08,Juárez,08037,732486,732444,1464930
2020,Chihuahua,08,La Cruz,08016,2168,2058,4226
2020,Chihuahua,08,López,08039,2247,2095,4342
2020,Chihuahua,08,Madera,08040,15569,15367,30936
2020,Chihuahua,08,Maguarichi,08041,891,840,1731
2020,Chihuahua,08,Manuel Benavides,08042,846,716,1562
2020,Chihuahua,08,Matachí,08043,1665,1641,3306
2020,Chihuahua,08,Matamoros,08044,2470,2377,4847
2020,Chihuahua,08,Meoqui,08045,23900,24342,48242
2020,Chihuahua,08,Morelos,08046,4199,4110,8309
2020,Chihuahua,08,Moris,08047,2854,2666,5520
2020,Chihuahua,08,Namiquipa,08048,13103,12493,25596
2020,Chihuahua,08,Nonoava,08049,1455,1376,2831
2020,Chihuahua,08,Nuevo Casas Grandes,08050,32944,34376,67320
2020,Chihuahua,08,Ocampo,08051,4162,3827,7989
2020,Chihuahua,08,Ojinaga,08052,15091,14905,29996
2020,Chihuahua,08,Praxedis G. Guerrero,08053,2591,2549,5140
2020,Chihuahua,08,Riva Palacio,08054,4220,4070,8290
2020,Chihuahua,08,Rosales,08055,9285,9109,18394
2020,Chihuahua,08,Rosario,08056,1113,1069,2182
2020,Chihuahua,08,San Francisco de Borja,08057,1256,1189,2445
2020,Chihuahua,08,San Francisco de Conchos,08058,1466,1364,2830
2020,Chihuahua,08,San Francisco del Oro,08059,2762,2740,5502
2020,Chihuahua,08,Santa Bárbara,08060,5750,5822,11572
2020,Chihuahua,08,Santa Isabel,08024,2125,2168,4293
2020,Chihuahua,08,Satevó,08061,1745,1636,3381
2020,Chihuahua,08,Saucillo,08062,17122,16928,34050
2020,Chihuahua,08,Temósachic,08063,3588,3413,7001
2020,Chihuahua,08,Urique,08065,11298,10959,22257
2020,Chihuahua,08,Uruachi,08066,3390,3240,6630
2020,Chihuahua,08,Valle de Zaragoza,08067,2887,2764,5651
2020,Ciudad de México,09,Azcapotzalco,09002,192126,216315,408441
2020,Ciudad de México,09,Benito Juárez,09014,199754,233954,433708
2020,Ciudad de México,09,Coyoacán,09003,292111,329841,621952
2020,Ciudad de México,09,Cuajimalpa de Morelos,09004,95869,103940,199809
2020,Ciudad de México,09,Cuauhtémoc,09015,260463,288143,548606
2020,Ciudad de México,09,Gustavo A. Madero,09005,565150,611817,1176967
2020,Ciudad de México,09,Iztacalco,09006,186604,207217,393821
2020,Ciudad de México,09,Iztapalapa,09007,881091,934460,1815551
2020,Ciudad de México,09,La Magdalena Contreras,09008,117879,127268,245147
2020,Ciudad de México,09,Miguel Hidalgo,09016,175605,204019,379624
2020,Ciudad de México,09,Milpa Alta,09009,68127,71244,139371
2020,Ciudad de México,09,Tlalpan,09012,326680,355554,682234
2020,Ciudad de México,09,Tláhuac,09011,176595,189991,366586
2020,Ciudad de México,09,Venustiano Carranza,09017,204087,229144,433231
2020,Ciudad de México,09,Xochimilco,09013,204989,213071,418060
2020,Ciudad de México,09,Álvaro Obregón,09010,360280,395257,755537
2020,Coahuila,05,Abasolo,05001,567,563,1130
2020,Coahuila,05,Acuña,05002,82049,81108,163157
2020,Coahuila,05,Allende,05003,12213,12492,24705
2020,Coahuila,05,Arteaga,05004,13043,12434,25477
2020,Coahuila,05,Candela,05005,1021,924,1945
2020,Coahuila,05,Castaños,05006,15311,15257,30568
2020,Coahuila,05,Cuatro Ciénegas,05007,7398,7225,14623
2020,Coahuila,05,Escobedo,05008,1711,1642,3353
2020,Coahuila,05,Francisco I. Madero,05009,32225,32258,64483
2020,Coahuila,05,Frontera,05010,44235,43707,87942
2020,Coahuila,05,General Cepeda,05011,7040,6461,13501
2020,Coahuila,05,Guerrero,05012,1042,922,1964
2020,Coahuila,05,Hidalgo,05013,969,919,1888
2020,Coahuila,05,Jiménez,05014,5588,5406,10994
2020,Coahuila,05,Juárez,05015,897,825,1722
2020,Coahuila,05,Lamadrid,05016,1023,961,1984
2020,Coahuila,05,Matamoros,05017,59847,59645,119492
2020,Coahuila,05,Monclova,05018,125097,126249,251346
2020,Coahuila,05,Morelos,05019,4786,4644,9430
2020,Coahuila,05,Múzquiz,05020,38274,37373,75647
2020,Coahuila,05,Nadadores,05021,3604,3548,7152
2020,Coahuila,05,Nava,05022,16990,16111,33101
2020,Coahuila,05,Ocampo,05023,6035,5593,11628
2020,Coahuila,05,Parras,05024,24903,23791,48694
2020,Coahuila,05,Piedras Negras,05025,89097,88158,177255
2020,Coahuila,05,Progreso,05026,1890,1764,3654
2020,Coahuila,05,Ramos Arizpe,05027,52672,50580,103252
2020,Coahuila,05,Sabinas,05028,34862,34638,69500
2020,Coahuila,05,Sacramento,05029,1327,1287,2614
2020,Coahuila,05,Saltillo,05030,433742,435442,869184
2020,Coahuila,05,San Buenaventura,05031,12928,12892,25820
2020,Coahuila,05,San Juan de Sabinas,05032,23269,24046,47315
2020,Coahuila,05,San Pedro,05033,58678,58692,117370
2020,Coahuila,05,Sierra Mojada,05034,4022,3718,7740
2020,Coahuila,05,Torreón,05035,364287,379960,744247
2020,Coahuila,05,Viesca,05036,12111,11670,23781
2020,Coahuila,05,Villa Unión,05037,3524,3335,6859
2020,Coahuila,05,Zaragoza,05038,7140,7063,14203
2020,Colima,06,Armería,06001,16293,16070,32363
2020,Colima,06,Colima,06002,82415,86773,169188
2020,Colima,06,Comala,06003,12037,11865,23902
2020,Colima,06,Coquimatlán,06004,11195,10972,22167
2020,Colima,06,Cuauhtémoc,06005,16485,16344,32829
2020,Colima,06,Ixtlahuacán,06006,3065,3013,6078
2020,Colima,06,Manzanillo,06007,102703,100603,203306
2020,Colima,06,Minatitlán,06008,5031,4639,9670
2020,Colima,06,Tecomán,06009,67943,66688,134631
2020,Colima,06,Villa de Álvarez,06010,73691,77328,151019
2020,Durango,10,Canatlán,10001,17185,17564,34749
2020,Durango,10,Canelas,10002,2524,2292,4816
2020,Durango,10,Coneto de Comonfort,10003,2301,2348,4649
2020,Durango,10,Cuencamé,10004,18894,18585,37479
2020,Durango,10,Durango,10005,336922,358675,695597
2020,Durango,10,El Oro,10018,6115,6166,12281
2020,Durango,10,General Simón Bolívar,10006,5345,5467,10812
2020,Durango,10,Guadalupe Victoria,10008,18728,19064,37792
2020,Durango,10,Guanaceví,10009,5427,5085,10512
2020,Durango,10,Gómez Palacio,10007,183240,186520,369760
2020,Durango,10,Hidalgo,10010,2112,2053,4165
2020,Durango,10,Indé,10011,2700,2692,5392
2020,Durango,10,Lerdo,10012,82025,82738,164763
2020,Durango,10,Mapimí,10013,14158,14143,28301
2020,Durango,10,Mezquital,10014,19993,20600,40593
2020,Durango,10,Nazas,10015,6918,6959,13877
2020,Durango,10,Nombre de Dios,10016,10397,10484,20881
2020,Durango,10,Nuevo Ideal,10039,14367,14495,28862
2020,Durango,10,Ocampo,10017,5280,5053,10333
2020,Durango,10,Otáez,10019,2862,2651,5513
2020,Durango,10,Peñón Blanco,10021,5798,5740,11538
2020,Durango,10,Poanas,10022,13283,13652,26935
2020,Durango,10,Pueblo Nuevo,10023,26411,26595,53006
2020,Durango,10,Pánuco de Coronado,10020,6362,6545,12907
2020,Durango,10,Rodeo,10024,7220,7187,14407
2020,Durango,10,San Bernardo,10025,1832,1627,3459
2020,Durango,10,San Dimas,10026,10379,9735,20114
2020,Durango,10,San Juan de Guadalupe,10027,2916,3001,5917
2020,Durango,10,San Juan del Río,10028,6569,6741,13310
2020,Durango,10,San Luis del Cordero,10029,1148,1110,2258
2020,Durango,10,San Pedro del Gallo,10030,845,786,1631
2020,Durango,10,Santa Clara,10031,3745,3764,7509
2020,Durango,10,Santiago Papasquiaro,10032,25583,25542,51125
2020,Durango,10,Súchil,10033,3241,3525,6766
2020,Durango,10,Tamazula,10034,14279,13089,27368
2020,Durango,10,Tepehuanes,10035,5762,5783,11545
2020,Durango,10,Tlahualilo,10036,12604,12342,24946
2020,Durango,10,Topia,10037,5082,4767,9849
2020,Durango,10,Vicente Guerrero,10038,11300,11979,23279
2020,Estado de México,15,Acambay de Ruíz Castañeda,15001,33704,35816,69520
2020,Estado de México,15,Acolman,15002,93359,92897,186256
2020,Estado de México,15,Aculco,15003,25747,26426,52173
2020,Estado de México,15,Almoloya de Alquisiras,15004,7486,8159,15645
2020,Estado de México,15,Almoloya de Juárez,15005,93109,95015,188124
2020,Estado de México,15,Almoloya del Río,15006,5875,6294,12169
2020,Estado de México,15,Amanalco,15007,12668,13183,25851
2020,Estado de México,15,Amatepec,15008,13779,14635,28414
2020,Estado de México,15,Amecameca,15009,26363,28185,54548
2020,Estado de México,15,Apaxco,15010,15593,15983,31576
2020,Estado de México,15,Atenco,15011,34677,35339,70016
2020,Estado de México,15,Atizapán,15012,6081,6430,12511
2020,Estado de México,15,Atizapán de Zaragoza,15013,270692,286416,557108
2020,Estado de México,15,Atlacomulco,15014,51561,55817,107378
2020,Estado de México,15,Atlautla,15015,15964,16710,32674
2020,Estado de México,15,Axapusco,15016,14926,15114,30040
2020,Estado de México,15,Ayapango,15017,5436,5645,11081
2020,Estado de México,15,Calimaya,15018,29431,30878,60309
2020,Estado de México,15,Capulhuac,15019,18568,19628,38196
2020,Estado de México,15,Chalco,15025,194391,202953,397344
2020,Estado de México,15,Chapa de Mota,15026,14878,15450,30328
2020,Estado de México,15,Chapultepec,15027,6381,6605,12986
2020,Estado de México,15,Chiautla,15028,15624,16179,31803
2020,Estado de México,15,Chicoloapan,15029,110199,116712,226911
2020,Estado de México,15,Chiconcuac,15030,13596,13974,27570
2020,Estado de México,15,Chimalhuacán,15031,353892,366315,720207
2020,Estado de México,15,Coacalco de Berriozábal,15020,149796,160947,310743
2020,Estado de México,15,Coatepec Harinas,15021,20087,21630,41717
2020,Estado de México,15,Cocotitlán,15022,7519,7868,15387
2020,Estado de México,15,Coyotepec,15023,21885,22316,44201
2020,Estado de México,15,Cuautitlán,15024,86484,88520,175004
2020,Estado de México,15,Cuautitlán Izcalli,15121,281372,295818,577190
2020,Estado de México,15,Donato Guerra,15032,17799,18359,36158
2020,Estado de México,15,Ecatepec de Morelos,15033,843444,864310,1707754
2020,Estado de México,15,Ecatzingo,15034,4968,5122,10090
2020,Estado de México,15,El Oro,15064,19211,20340,39551
2020,Estado de México,15,Huehuetoca,15035,72636,74690,147326
2020,Estado de México,15,Hueypoxtla,15036,23553,23189,46742
2020,Estado de México,15,Huixquilucan,15037,139991,150240,290231
2020,Estado de México,15,Isidro Fabela,15038,6199,6313,12512
2020,Estado de México,15,Ixtapaluca,15039,270304,280730,551034
2020,Estado de México,15,Ixtapan de la Sal,15040,18446,19842,38288
2020,Estado de México,15,Ixtapan del Oro,15041,3686,3597,7283
2020,Estado de México,15,Ixtlahuaca,15042,78922,84362,163284
2020,Estado de México,15,Jaltenco,15044,14168,15011,29179
2020,Estado de México,15,Jilotepec,15045,46674,48219,94893
2020,Estado de México,15,Jilotzingo,15046,10084,10629,20713
2020,Estado de México,15,Jiquipilco,15047,38422,40841,79263
2020,Estado de México,15,Jocotitlán,15048,34052,36419,70471
2020,Estado de México,15,Joquicingo,15049,7179,7531,14710
2020,Estado de México,15,Juchitepec,15050,13426,13815,27241
2020,Estado de México,15,La Paz,15070,152820,156776,309596
2020,Estado de México,15,Lerma,15051,78924,81024,159948
2020,Estado de México,15,Luvianos,15123,14778,15006,29784
2020,Estado de México,15,Malinalco,15052,14532,14983,29515
2020,Estado de México,15,Melchor Ocampo,15053,29950,31222,61172
2020,Estado de México,15,Metepec,15054,119319,126736,246055
2020,Estado de México,15,Mexicaltzingo,15055,6657,7087,13744
2020,Estado de México,15,Morelos,15056,15261,16571,31832
2020,Estado de México,15,Naucalpan de Juárez,15057,442322,467865,910187
2020,Estado de México,15,Nextlalpan,15059,21588,22052,43640
2020,Estado de México,15,Nezahualcóyotl,15058,547767,588019,1135786
2020,Estado de México,15,Nicolás Romero,15060,216256,224808,441064
2020,Estado de México,15,Nopaltepec,15061,4864,4889,9753
2020,Estado de México,15,Ocoyoacac,15062,35290,36421,71711
2020,Estado de México,15,Ocuilan,15063,17947,18682,36629
2020,Estado de México,15,Otumba,15065,19227,18959,38186
2020,Estado de México,15,Otzoloapan,15066,2138,2098,4236
2020,Estado de México,15,Otzolotepec,15067,44837,45968,90805
2020,Estado de México,15,Ozumba,15068,14986,16168,31154
2020,Estado de México,15,Papalotla,15069,2128,2239,4367
2020,Estado de México,15,Polotitlán,15071,7373,7693,15066
2020,Estado de México,15,Rayón,15072,7191,7417,14608
2020,Estado de México,15,San Antonio la Isla,15073,15626,16056,31682
2020,Estado de México,15,San Felipe del Progreso,15074,65733,73480,139213
2020,Estado de México,15,San José del Rincón,15124,49103,49854,98957
2020,Estado de México,15,San Martín de las Pirámides,15075,14396,14749,29145
2020,Estado de México,15,San Mateo Atenco,15076,39773,41130,80903
2020,Estado de México,15,San Simón de Guerrero,15077,3177,3379,6556
2020,Estado de México,15,Santo Tomás,15078,5055,5207,10262
2020,Estado de México,15,Soyaniquilpan de Juárez,15079,7091,7248,14339
2020,Estado de México,15,Sultepec,15080,13344,14854,28198
2020,Estado de México,15,Tecámac,15081,244379,256206,500585
2020,Estado de México,15,Tejupilco,15082,38299,41496,79795
2020,Estado de México,15,Temamatla,15083,6633,7057,13690
2020,Estado de México,15,Temascalapa,15084,20829,20856,41685
2020,Estado de México,15,Temascalcingo,15085,32300,35008,67308
2020,Estado de México,15,Temascaltepec,15086,16840,17508,34348
2020,Estado de México,15,Temoaya,15087,53254,56182,109436
2020,Estado de México,15,Tenancingo,15088,51215,54091,105306
2020,Estado de México,15,Tenango del Aire,15089,6590,6754,13344
2020,Estado de México,15,Tenango del Valle,15090,45119,46929,92048
2020,Estado de México,15,Teoloyucan,15091,34419,35047,69466
2020,Estado de México,15,Teotihuacán,15092,30026,30966,60992
2020,Estado de México,15,Tepetlaoxtoc,15093,16386,16722,33108
2020,Estado de México,15,Tepetlixpa,15094,10424,10713,21137
2020,Estado de México,15,Tepotzotlán,15095,51294,53041,104335
2020,Estado de México,15,Tequixquiac,15096,19709,19949,39658
2020,Estado de México,15,Texcaltitlán,15097,9744,10405,20149
2020,Estado de México,15,Texcalyacac,15098,2818,2893,5711
2020,Estado de México,15,Texcoco,15099,127458,134557,262015
2020,Estado de México,15,Tezoyuca,15100,23127,23400,46527
2020,Estado de México,15,Tianguistenco,15101,40135,42322,82457
2020,Estado de México,15,Timilpan,15102,8083,8736,16819
2020,Estado de México,15,Tlalmanalco,15103,24780,26590,51370
2020,Estado de México,15,Tlalnepantla de Baz,15104,366112,390425,756537
2020,Estado de México,15,Tlatlaya,15105,18376,19155,37531
2020,Estado de México,15,Toluca,15106,458622,490328,948950
2020,Estado de México,15,Tonanitla,15125,5408,5552,10960
2020,Estado de México,15,Tonatico,15107,6572,6987,13559
2020,Estado de México,15,Tultepec,15108,78949,81994,160943
2020,Estado de México,15,Tultitlán,15109,273196,283297,556493
2020,Estado de México,15,Valle de Bravo,15110,34430,35762,70192
2020,Estado de México,15,Valle de Chalco Solidaridad,15122,206394,213306,419700
2020,Estado de México,15,Villa Guerrero,15113,35296,36414,71710
2020,Estado de México,15,Villa Victoria,15114,54904,55558,110462
2020,Estado de México,15,Villa de Allende,15111,26923,27926,54849
2020,Estado de México,15,Villa del Carbón,15112,25441,25173,50614
2020,Estado de México,15,Xalatlaco,15043,15638,16482,32120
2020,Estado de México,15,Xonacatlán,15115,27338,27193,54531
2020,Estado de México,15,Zacazonapan,15116,2188,2170,4358
2020,Estado de México,15,Zacualpan,15117,7663,8417,16080
2020,Estado de México,15,Zinacantepec,15118,99609,102379,201988
2020,Estado de México,15,Zumpahuacán,15119,8595,9367,17962
2020,Estado de México,15,Zumpango,15120,104980,112186,217166
2020,Guanajuato,11,Abasolo,11001,46322,49259,95581
2020,Guanajuato,11,Acámbaro,11002,57204,61763,118967
2020,Guanajuato,11,Apaseo el Alto,11004,35267,36942,72209
2020,Guanajuato,11,Apaseo el Grande,11005,48102,50934,99036
2020,Guanajuato,11,Atarjea,11006,2727,2832,5559
2020,Guanajuato,11,Celaya,11007,258259,272561,530820
2020,Guanajuato,11,Comonfort,11009,41355,45836,87191
2020,Guanajuato,11,Coroneo,11010,6154,6844,12998
2020,Guanajuato,11,Cortazar,11011,49309,52010,101319
2020,Guanajuato,11,Cuerámaro,11012,14426,15533,29959
2020,Guanajuato,11,Doctor Mora,11013,12352,13254,25606
2020,Guanajuato,11,Dolores Hidalgo Cuna de la Independencia Nacional,11014,76171,84600,160771
2020,Guanajuato,11,Guanajuato,11015,97129,100906,198035
2020,Guanajuato,11,Huanímaro,11016,10725,11887,22612
2020,Guanajuato,11,Irapuato,11017,298113,312587,610700
2020,Guanajuato,11,Jaral del Progreso,11018,20219,20935,41154
2020,Guanajuato,11,Jerécuaro,11019,23970,27362,51332
2020,Guanajuato,11,León,11020,834256,845354,1679610
2020,Guanajuato,11,Manuel Doblado,11008,19379,21229,40608
2020,Guanajuato,11,Moroleón,11021,26031,28347,54378
2020,Guanajuato,11,Ocampo,11022,11985,12773,24758
2020,Guanajuato,11,Pueblo Nuevo,11024,5979,6641,12620
2020,Guanajuato,11,Purísima del Rincón,11025,43070,42942,86012
2020,Guanajuato,11,Pénjamo,11023,76471,83497,159968
2020,Guanajuato,11,Romita,11026,30417,32186,62603
2020,Guanajuato,11,Salamanca,11027,143112,150181,293293
2020,Guanajuato,11,Salvatierra,11028,51073,55905,106978
2020,Guanajuato,11,San Diego de la Unión,11029,19396,22192,41588
2020,Guanajuato,11,San Felipe,11030,57486,60931,118417
2020,Guanajuato,11,San Francisco del Rincón,11031,61522,64382,125904
2020,Guanajuato,11,San José Iturbide,11032,40569,42993,83562
2020,Guanajuato,11,San Luis de la Paz,11033,60885,66793,127678
2020,Guanajuato,11,San Miguel de Allende,11003,88036,94998,183034
2020,Guanajuato,11,Santa Catarina,11034,2667,2917,5584
2020,Guanajuato,11,Santa Cruz de Juventino Rosas,11035,42805,45839,88644
2020,Guanajuato,11,Santiago Maravatío,11036,3484,3843,7327
2020,Guanajuato,11,Silao de la Victoria,11037,99337,101683,201020
2020,Guanajuato,11,Tarandacuao,11038,6188,6790,12978
2020,Guanajuato,11,Tarimoro,11039,17780,18794,36574
2020,Guanajuato,11,Tierra Blanca,11040,9813,10425,20238
2020,Guanajuato,11,Uriangato,11041,32564,34620,67184
2020,Guanajuato,11,Valle de Santiago,11042,73078,80016,153094
2020,Guanajuato,11,Victoria,11043,10219,11302,21521
2020,Guanajuato,11,Villagrán,11044,30825,32093,62918
2020,Guanajuato,11,Xichú,11045,5886,6399,12285
2020,Guanajuato,11,Yuriria,11046,35186,38762,73948
2020,Guerrero,12,Acapulco de Juárez,12001,405234,435561,840795
2020,Guerrero,12,Acatepec,12076,18933,19805,38738
2020,Guerrero,12,Ahuacuotzingo,12002,12807,14559,27366
2020,Guerrero,12,Ajuchitlán del Progreso,12003,18811,20084,38895
2020,Guerrero,12,Alcozauca de Guerrero,12004,9405,10707,20112
2020,Guerrero,12,Alpoyeca,12005,3278,3681,6959
2020,Guerrero,12,Apaxtla,12006,5625,6094,11719
2020,Guerrero,12,Arcelia,12007,15786,16761,32547
2020,Guerrero,12,Atenango del Río,12008,4263,4651,8914
2020,Guerrero,12,Atlamajalcingo del Monte,12009,2503,2781,5284
2020,Guerrero,12,Atlixtac,12010,13599,14537,28136
2020,Guerrero,12,Atoyac de Álvarez,12011,30729,31845,62574
2020,Guerrero,12,Ayutla de los Libres,12012,34375,35867,70242
2020,Guerrero,12,Azoyú,12013,6380,6784,13164
2020,Guerrero,12,Benito Juárez,12014,7761,8165,15926
2020,Guerrero,12,Buenavista de Cuéllar,12015,6697,7040,13737
2020,Guerrero,12,Chilapa de Álvarez,12028,63291,70008,133299
2020,Guerrero,12,Chilpancingo de los Bravo,12029,136084,148246,284330
2020,Guerrero,12,Coahuayutla de José María Izazaga,12016,6467,6194,12661
2020,Guerrero,12,Cochoapa el Grande,12078,9198,10139,19337
2020,Guerrero,12,Cocula,12017,6769,7281,14050
2020,Guerrero,12,Copala,12018,7191,7450,14641
2020,Guerrero,12,Copalillo,12019,7179,7917,15096
2020,Guerrero,12,Copanatoyac,12020,9928,10851,20779
2020,Guerrero,12,Coyuca de Benítez,12021,38741,40190,78931
2020,Guerrero,12,Coyuca de Catalán,12022,20473,19935,40408
2020,Guerrero,12,Cuajinicuilapa,12023,13983,13936,27919
2020,Guerrero,12,Cualác,12024,3760,4047,7807
2020,Guerrero,12,Cuautepec,12025,8251,8318,16569
2020,Guerrero,12,Cuetzala del Progreso,12026,4355,4596,8951
2020,Guerrero,12,Cutzamala de Pinzón,12027,10003,10381,20384
2020,Guerrero,12,Eduardo Neri,12075,25898,27026,52924
2020,Guerrero,12,Florencio Villarreal,12030,10637,10890,21527
2020,Guerrero,12,General Canuto A. Neri,12031,2852,3084,5936
2020,Guerrero,12,General Heliodoro Castillo,12032,18928,18912,37840
2020,Guerrero,12,Huamuxtitlán,12033,7408,8355,15763
2020,Guerrero,12,Huitzuco de los Figueroa,12034,18562,20134,38696
2020,Guerrero,12,Iguala de la Independencia,12035,76314,81827,158141
2020,Guerrero,12,Igualapa,12036,5704,5910,11614
2020,Guerrero,12,Iliatenco,12081,5392,5925,11317
2020,Guerrero,12,Ixcateopan de Cuauhtémoc,12037,3066,3385,6451
2020,Guerrero,12,José Joaquín de Herrera,12079,8869,9036,17905
2020,Guerrero,12,Juan R. Escudero,12039,12512,13230,25742
2020,Guerrero,12,Juchitán,12080,3997,3927,7924
2020,Guerrero,12,La Unión de Isidoro Montes de Oca,12068,13766,13202,26968
2020,Guerrero,12,Leonardo Bravo,12040,13282,13575,26857
2020,Guerrero,12,Malinaltepec,12041,13275,14891,28166
2020,Guerrero,12,Marquelia,12077,7093,7176,14269
2020,Guerrero,12,Metlatónoc,12043,8877,10218,19095
2020,Guerrero,12,Mochitlán,12044,6462,6734,13196
2020,Guerrero,12,Mártir de Cuilapan,12042,9204,10102,19306
2020,Guerrero,12,Olinalá,12045,12670,13702,26372
2020,Guerrero,12,Ometepec,12046,34063,35790,69853
2020,Guerrero,12,Pedro Ascencio Alquisiras,12047,3257,3792,7049
2020,Guerrero,12,Petatlán,12048,22494,22895,45389
2020,Guerrero,12,Pilcaya,12049,6431,6839,13270
2020,Guerrero,12,Pungarabato,12050,18816,19993,38809
2020,Guerrero,12,Quechultenango,12051,18046,18935,36981
2020,Guerrero,12,San Luis Acatlán,12052,22251,22870,45121
2020,Guerrero,12,San Marcos,12053,24997,25862,50859
2020,Guerrero,12,San Miguel Totolapan,12054,13894,14395,28289
2020,Guerrero,12,Taxco de Alarcón,12055,54002,58559,112561
2020,Guerrero,12,Tecoanapa,12056,23463,24130,47593
2020,Guerrero,12,Teloloapan,12058,27864,31259,59123
2020,Guerrero,12,Tepecoacuilco de Trujano,12059,15799,17115,32914
2020,Guerrero,12,Tetipac,12060,7230,7660,14890
2020,Guerrero,12,Tixtla de Guerrero,12061,21371,23108,44479
2020,Guerrero,12,Tlacoachistlahuaca,12062,11397,12824,24221
2020,Guerrero,12,Tlacoapa,12063,4957,5463,10420
2020,Guerrero,12,Tlalchapa,12064,6353,6358,12711
2020,Guerrero,12,Tlalixtaquilla de Maldonado,12065,3657,3969,7626
2020,Guerrero,12,Tlapa de Comonfort,12066,44383,49191,93574
2020,Guerrero,12,Tlapehuala,12067,10958,11748,22706
2020,Guerrero,12,Técpan de Galeana,12057,33241,33733,66974
2020,Guerrero,12,Xalpatláhuac,12069,5651,6604,12255
2020,Guerrero,12,Xochihuehuetlán,12070,3461,3937,7398
2020,Guerrero,12,Xochistlahuaca,12071,14672,15550,30222
2020,Guerrero,12,Zapotitlán Tablas,12072,5984,6603,12587
2020,Guerrero,12,Zihuatanejo de Azueta,12038,64584,66212,130796
2020,Guerrero,12,Zirándaro,12073,9309,8919,18228
2020,Guerrero,12,Zitlala,12074,11264,12607,23871
2020,Hidalgo,13,Acatlán,13001,10666,11453,22119
2020,Hidalgo,13,Acaxochitlán,13002,22222,24012,46234
2020,Hidalgo,13,Actopan,13003,29087,32224,61311
2020,Hidalgo,13,Agua Blanca de Iturbide,13004,4607,5098,9705
2020,Hidalgo,13,Ajacuba,13005,9720,10162,19882
2020,Hidalgo,13,Alfajayucan,13006,10711,11367,22078
2020,Hidalgo,13,Almoloya,13007,6530,6605,13135
2020,Hidalgo,13,Apan,13008,23048,24988,48036
2020,Hidalgo,13,Atitalaquia,13010,15948,16278,32226
2020,Hidalgo,13,Atlapexco,13011,10439,11223,21662
2020,Hidalgo,13,Atotonilco de Tula,13013,19950,21089,41039
2020,Hidalgo,13,Atotonilco el Grande,13012,13913,15556,29469
2020,Hidalgo,13,Calnali,13014,9003,9677,18680
2020,Hidalgo,13,Cardonal,13015,9507,10346,19853
2020,Hidalgo,13,Chapantongo,13017,7135,7524,14659
2020,Hidalgo,13,Chapulhuacán,13018,12803,12657,25460
2020,Hidalgo,13,Chilcuautla,13019,9630,10008,19638
2020,Hidalgo,13,Cuautepec de Hinojosa,13016,29755,32606,62361
2020,Hidalgo,13,El Arenal,13009,9668,10531,20199
2020,Hidalgo,13,Eloxochitlán,13020,1390,1582,2972
2020,Hidalgo,13,Emiliano Zapata,13021,7508,8295,15803
2020,Hidalgo,13,Epazoyucan,13022,7804,8249,16053
2020,Hidalgo,13,Francisco I. Madero,13023,18592,20287,38879
2020,Hidalgo,13,Huasca de Ocampo,13024,9114,9963,19077
2020,Hidalgo,13,Huautla,13025,11132,12061,23193
2020,Hidalgo,13,Huazalingo,13026,7330,7679,15009
2020,Hidalgo,13,Huehuetla,13027,13226,14087,27313
2020,Hidalgo,13,Huejutla de Reyes,13028,68712,70971,139683
2020,Hidalgo,13,Huichapan,13029,23851,25941,49792
2020,Hidalgo,13,Ixmiquilpan,13030,47067,52668,99735
2020,Hidalgo,13,Jacala de Ledezma,13031,6851,7627,14478
2020,Hidalgo,13,Jaltocán,13032,6317,6489,12806
2020,Hidalgo,13,Juárez Hidalgo,13033,1634,1778,3412
2020,Hidalgo,13,La Misión,13040,5374,5541,10915
2020,Hidalgo,13,Lolotla,13034,5006,5250,10256
2020,Hidalgo,13,Metepec,13035,5861,6647,12508
2020,Hidalgo,13,Metztitlán,13037,10513,11681,22194
2020,Hidalgo,13,Mineral de la Reforma,13051,88752,97155,185907
2020,Hidalgo,13,Mineral del Chico,13038,4691,4974,9665
2020,Hidalgo,13,Mineral del Monte,13039,7508,8229,15737
2020,Hidalgo,13,Mixquiahuala de Juárez,13041,23999,25932,49931
2020,Hidalgo,13,Molango de Escamilla,13042,6133,6385,12518
2020,Hidalgo,13,Nicolás Flores,13043,3479,3915,7394
2020,Hidalgo,13,Nopala de Villagrán,13044,8903,9219,18122
2020,Hidalgo,13,Omitlán de Juárez,13045,5040,5515,10555
2020,Hidalgo,13,Pachuca de Soto,13048,133883,146429,280312
2020,Hidalgo,13,Pacula,13047,2486,2868,5354
2020,Hidalgo,13,Pisaflores,13049,9414,9415,18829
2020,Hidalgo,13,Progreso de Obregón,13050,12020,13355,25375
2020,Hidalgo,13,San Agustín Metzquititlán,13036,4943,5390,10333
2020,Hidalgo,13,San Agustín Tlaxiaca,13052,19154,20026,39180
2020,Hidalgo,13,San Bartolo Tutotepec,13053,9937,10145,20082
2020,Hidalgo,13,San Felipe Orizatlán,13046,20521,21228,41749
2020,Hidalgo,13,San Salvador,13054,18355,19638,37993
2020,Hidalgo,13,Santiago Tulantepec de Lugo Guerrero,13056,19169,20929,40098
2020,Hidalgo,13,Santiago de Anaya,13055,8969,9417,18386
2020,Hidalgo,13,Singuilucan,13057,8572,8805,17377
2020,Hidalgo,13,Tasquillo,13058,8082,9525,17607
2020,Hidalgo,13,Tecozautla,13059,19417,21098,40515
2020,Hidalgo,13,Tenango de Doria,13060,9338,10308,19646
2020,Hidalgo,13,Tepeapulco,13061,28463,30313,58776
2020,Hidalgo,13,Tepehuacán de Guerrero,13062,16680,16139,32819
2020,Hidalgo,13,Tepeji del Río de Ocampo,13063,46176,47475,93651
2020,Hidalgo,13,Tepetitlán,13064,5745,6047,11792
2020,Hidalgo,13,Tetepango,13065,6240,6293,12533
2020,Hidalgo,13,Tezontepec de Aldama,13067,28177,28826,57003
2020,Hidalgo,13,Tianguistengo,13068,7846,8198,16044
2020,Hidalgo,13,Tizayuca,13069,67725,69440,137165
2020,Hidalgo,13,Tlahuelilpan,13070,10211,10531,20742
2020,Hidalgo,13,Tlahuiltepa,13071,5428,5505,10933
2020,Hidalgo,13,Tlanalapa,13072,5406,5759,11165
2020,Hidalgo,13,Tlanchinol,13073,20910,21265,42175
2020,Hidalgo,13,Tlaxcoapan,13074,15164,15563,30727
2020,Hidalgo,13,Tolcayuca,13075,8604,9094,17698
2020,Hidalgo,13,Tula de Allende,13076,57790,61034,118824
2020,Hidalgo,13,Tulancingo de Bravo,13077,80442,89182,169624
2020,Hidalgo,13,Villa de Tezontepec,13066,6596,6848,13444
2020,Hidalgo,13,Xochiatipan,13078,10342,10892,21234
2020,Hidalgo,13,Xochicoatlán,13079,4079,4210,8289
2020,Hidalgo,13,Yahualica,13080,12806,13325,26131
2020,Hidalgo,13,Zacualtipán de Ángeles,13081,17978,19650,37628
2020,Hidalgo,13,Zapotlán de Juárez,13082,9817,10585,20402
2020,Hidalgo,13,Zempoala,13083,24578,25962,50540
2020,Hidalgo,13,Zimapán,13084,19700,22886,42586
2020,Jalisco,14,Acatic,14001,11294,11739,23033
2020,Jalisco,14,Acatlán de Juárez,14002,12467,11664,24131
2020,Jalisco,14,Ahualulco de Mercado,14003,12205,12591,24796
2020,Jalisco,14,Amacueca,14004,2848,2992,5840
2020,Jalisco,14,Amatitán,14005,8186,8265,16451
2020,Jalisco,14,Ameca,14006,31852,33127,64979
2020,Jalisco,14,Arandas,14008,38820,41624,80444
2020,Jalisco,14,Atemajac de Brizuela,14010,3551,3598,7149
2020,Jalisco,14,Atengo,14011,3075,2846,5921
2020,Jalisco,14,Atenguillo,14012,2096,2161,4257
2020,Jalisco,14,Atotonilco el Alto,14013,31841,32905,64746
2020,Jalisco,14,Atoyac,14014,4187,4534,8721
2020,Jalisco,14,Autlán de Navarro,14015,32288,33268,65556
2020,Jalisco,14,Ayotlán,14016,19898,20783,40681
2020,Jalisco,14,Ayutla,14017,6691,6688,13379
2020,Jalisco,14,Bolaños,14019,4091,4102,8193
2020,Jalisco,14,Cabo Corrientes,14020,5775,5325,11100
2020,Jalisco,14,Casimiro Castillo,14021,11603,11627,23230
2020,Jalisco,14,Cañadas de Obregón,14117,2171,2270,4441
2020,Jalisco,14,Chapala,14030,26818,28010,54828
2020,Jalisco,14,Chimaltitán,14031,1767,1815,3582
2020,Jalisco,14,Chiquilistlán,14032,3258,3212,6470
2020,Jalisco,14,Cihuatlán,14022,22331,21777,44108
2020,Jalisco,14,Cocula,14024,13936,14631,28567
2020,Jalisco,14,Colotlán,14025,9321,9971,19292
2020,Jalisco,14,Concepción de Buenos Aires,14026,3348,3213,6561
2020,Jalisco,14,Cuautitlán de García Barragán,14027,9709,9430,19139
2020,Jalisco,14,Cuautla,14028,1112,1190,2302
2020,Jalisco,14,Cuquío,14029,9259,10114,19373
2020,Jalisco,14,Degollado,14033,11070,11778,22848
2020,Jalisco,14,Ejutla,14034,1063,995,2058
2020,Jalisco,14,El Arenal,14009,10438,10584,21022
2020,Jalisco,14,El Grullo,14037,12834,13492,26326
2020,Jalisco,14,El Limón,14054,2950,2946,5896
2020,Jalisco,14,El Salto,14070,99624,100535,200159
2020,Jalisco,14,Encarnación de Díaz,14035,27601,29654,57255
2020,Jalisco,14,Etzatlán,14036,10360,10816,21176
2020,Jalisco,14,Guachinango,14038,2308,2228,4536
2020,Jalisco,14,Guadalajara,14039,731725,771780,1503505
2020,Jalisco,14,Gómez Farías,14079,7436,7916,15352
2020,Jalisco,14,Hostotipaquillo,14040,5892,5096,10988
2020,Jalisco,14,Huejuquilla el Alto,14042,4544,4905,9449
2020,Jalisco,14,Huejúcar,14041,2952,3245,6197
2020,Jalisco,14,Ixtlahuacán de los Membrillos,14044,29681,30289,59970
2020,Jalisco,14,Ixtlahuacán del Río,14045,9882,10501,20383
2020,Jalisco,14,Jalostotitlán,14046,17815,18266,36081
2020,Jalisco,14,Jamay,14047,13253,13251,26504
2020,Jalisco,14,Jesús María,14048,9339,11056,20395
2020,Jalisco,14,Jilotlán de los Dolores,14049,5183,4966,10149
2020,Jalisco,14,Jocotepec,14050,24558,24861,49419
2020,Jalisco,14,Juanacatlán,14051,9605,9598,19203
2020,Jalisco,14,Juchitlán,14052,2922,3099,6021
2020,Jalisco,14,La Barca,14018,33893,36038,69931
2020,Jalisco,14,La Huerta,14043,13253,12798,26051
2020,Jalisco,14,La Manzanilla de la Paz,14057,1941,2092,4033
2020,Jalisco,14,Lagos de Moreno,14053,85993,89703,175696
2020,Jalisco,14,Magdalena,14055,12056,12061,24117
2020,Jalisco,14,Mascota,14058,7690,7945,15635
2020,Jalisco,14,Mazamitla,14059,7182,7780,14962
2020,Jalisco,14,Mexticacán,14060,2521,2949,5470
2020,Jalisco,14,Mezquitic,14061,10083,10668,20751
2020,Jalisco,14,Mixtlán,14062,1898,1874,3772
2020,Jalisco,14,Ocotlán,14063,52201,53858,106059
2020,Jalisco,14,Ojuelos de Jalisco,14064,16625,17436,34061
2020,Jalisco,14,Pihuamo,14065,6054,5963,12017
2020,Jalisco,14,Poncitlán,14066,27248,27943,55191
2020,Jalisco,14,Puerto Vallarta,14067,151524,147910,299434
2020,Jalisco,14,Quitupan,14069,4157,4640,8797
2020,Jalisco,14,San Cristóbal de la Barranca,14071,1569,1586,3155
2020,Jalisco,14,San Diego de Alejandría,14072,3712,3987,7699
2020,Jalisco,14,San Gabriel,14113,8518,8858,17376
2020,Jalisco,14,San Ignacio Cerro Gordo,14125,9805,10397,20202
2020,Jalisco,14,San Juan de los Lagos,14073,36847,37348,74195
2020,Jalisco,14,San Juanito de Escobedo,14007,5014,4947,9961
2020,Jalisco,14,San Julián,14074,8082,8917,16999
2020,Jalisco,14,San Marcos,14075,2055,1999,4054
2020,Jalisco,14,San Martín Hidalgo,14077,14390,15103,29493
2020,Jalisco,14,San Martín de Bolaños,14076,1636,1623,3259
2020,Jalisco,14,San Miguel el Alto,14078,17111,17970,35081
2020,Jalisco,14,San Pedro Tlaquepaque,14098,352775,355793,708568
2020,Jalisco,14,San Sebastián del Oeste,14080,3127,2827,5954
2020,Jalisco,14,Santa María de los Ángeles,14081,1615,1792,3407
2020,Jalisco,14,Santa María del Oro,14056,1116,1108,2224
2020,Jalisco,14,Sayula,14082,18991,20393,39384
2020,Jalisco,14,Tala,14083,42535,43119,85654
2020,Jalisco,14,Talpa de Allende,14084,8076,7958,16034
2020,Jalisco,14,Tamazula de Gordiano,14085,20123,21007,41130
2020,Jalisco,14,Tapalpa,14086,10122,10525,20647
2020,Jalisco,14,Tecalitlán,14087,8669,9053,17722
2020,Jalisco,14,Techaluta de Montenegro,14089,1965,2029,3994
2020,Jalisco,14,Tecolotlán,14088,9250,9233,18483
2020,Jalisco,14,Tenamaxtlán,14090,3761,3739,7500
2020,Jalisco,14,Teocaltiche,14091,21072,23116,44188
2020,Jalisco,14,Teocuitatlán de Corona,14092,5488,5680,11168
2020,Jalisco,14,Tepatitlán de Morelos,14093,74255,76878,151133
2020,Jalisco,14,Tequila,14094,22275,22514,44789
2020,Jalisco,14,Teuchitlán,14095,5064,5263,10327
2020,Jalisco,14,Tizapán el Alto,14096,10996,11542,22538
2020,Jalisco,14,Tlajomulco de Zúñiga,14097,319484,324691,644175
2020,Jalisco,14,Tolimán,14099,5420,5506,10926
2020,Jalisco,14,Tomatlán,14100,19430,18483,37913
2020,Jalisco,14,Tonalá,14101,289204,288464,577668
2020,Jalisco,14,Tonaya,14102,3142,3275,6417
2020,Jalisco,14,Tonila,14103,4200,4226,8426
2020,Jalisco,14,Totatiche,14104,2337,2354,4691
2020,Jalisco,14,Tototlán,14105,12194,12491,24685
2020,Jalisco,14,Tuxcacuesco,14106,2366,2262,4628
2020,Jalisco,14,Tuxcueca,14107,3234,3447,6681
2020,Jalisco,14,Tuxpan,14108,18054,19172,37226
2020,Jalisco,14,Unión de San Antonio,14109,9292,9939,19231
2020,Jalisco,14,Unión de Tula,14110,6990,7454,14444
2020,Jalisco,14,Valle de Guadalupe,14111,3731,3756,7487
2020,Jalisco,14,Valle de Juárez,14112,2874,3028,5902
2020,Jalisco,14,Villa Corona,14114,9442,9680,19122
2020,Jalisco,14,Villa Guerrero,14115,2900,2982,5882
2020,Jalisco,14,Villa Hidalgo,14116,10545,11250,21795
2020,Jalisco,14,Villa Purificación,14068,6038,5624,11662
2020,Jalisco,14,Yahualica de González Gallo,14118,11462,12495,23957
2020,Jalisco,14,Zacoalco de Torres,14119,15102,15330,30432
2020,Jalisco,14,Zapopan,14120,705495,727865,1433360
2020,Jalisco,14,Zapotiltic,14121,15343,15974,31317
2020,Jalisco,14,Zapotitlán de Vadillo,14122,3756,3723,7479
2020,Jalisco,14,Zapotlanejo,14124,35741,36698,72439
2020,Jalisco,14,Zapotlán del Rey,14123,9646,9701,19347
2020,Jalisco,14,Zapotlán el Grande,14023,55614,58330,113944
2020,Michoacán,16,Acuitzio,16001,5791,6228,12019
2020,Michoacán,16,Aguililla,16002,7736,7571,15307
2020,Michoacán,16,Angamacutiro,16004,7520,8331,15851
2020,Michoacán,16,Angangueo,16005,5718,6050,11768
2020,Michoacán,16,Apatzingán,16006,66491,67464,133955
2020,Michoacán,16,Aporo,16007,1661,1771,3432
2020,Michoacán,16,Aquila,16008,13293,12854,26147
2020,Michoacán,16,Ario,16009,18832,19824,38656
2020,Michoacán,16,Arteaga,16010,11360,11459,22819
2020,Michoacán,16,Briseñas,16011,5833,6127,11960
2020,Michoacán,16,Buenavista,16012,25275,24175,49450
2020,Michoacán,16,Carácuaro,16013,4837,4815,9652
2020,Michoacán,16,Charapan,16021,6103,6903,13006
2020,Michoacán,16,Charo,16022,12063,11210,23273
2020,Michoacán,16,Chavinda,16023,5259,5526,10785
2020,Michoacán,16,Cherán,16024,9643,10373,20016
2020,Michoacán,16,Chilchota,16025,19800,21338,41138
2020,Michoacán,16,Chinicuila,16026,2614,2402,5016
2020,Michoacán,16,Chucándiro,16027,2083,2484,4567
2020,Michoacán,16,Churintzio,16028,2513,2832,5345
2020,Michoacán,16,Churumuco,16029,7958,7944,15902
2020,Michoacán,16,Coahuayana,16014,7868,7287,15155
2020,Michoacán,16,Coalcomán de Vázquez Pallares,16015,9121,9329,18450
2020,Michoacán,16,Coeneo,16016,10033,11703,21736
2020,Michoacán,16,Cojumatlán de Régules,16074,5359,5576,10935
2020,Michoacán,16,Contepec,16017,17445,18432,35877
2020,Michoacán,16,Copándaro,16018,4477,5010,9487
2020,Michoacán,16,Cotija,16019,9341,10333,19674
2020,Michoacán,16,Cuitzeo,16020,14894,16440,31334
2020,Michoacán,16,Ecuandureo,16030,6025,7143,13168
2020,Michoacán,16,Epitacio Huerta,16031,8563,8956,17519
2020,Michoacán,16,Erongarícuaro,16032,7768,8337,16105
2020,Michoacán,16,Gabriel Zamora,16033,11911,11976,23887
2020,Michoacán,16,Hidalgo,16034,62922,66192,129114
2020,Michoacán,16,Huandacareo,16036,5836,6653,12489
2020,Michoacán,16,Huaniqueo,16037,3860,4552,8412
2020,Michoacán,16,Huetamo,16038,20846,21776,42622
2020,Michoacán,16,Huiramba,16039,4549,4701,9250
2020,Michoacán,16,Indaparapeo,16040,8543,9052,17595
2020,Michoacán,16,Irimbo,16041,7591,8325,15916
2020,Michoacán,16,Ixtlán,16042,6665,6858,13523
2020,Michoacán,16,Jacona,16043,35344,37325,72669
2020,Michoacán,16,Jiménez,16044,6388,6962,13350
2020,Michoacán,16,Jiquilpan,16045,16544,18181,34725
2020,Michoacán,16,José Sixto Verduzco,16113,13064,14440,27504
2020,Michoacán,16,Jungapeo,16047,11093,11265,22358
2020,Michoacán,16,Juárez,16046,7455,7835,15290
2020,Michoacán,16,La Huacana,16035,17707,17877,35584
2020,Michoacán,16,La Piedad,16069,52886,57499,110385
2020,Michoacán,16,Lagunillas,16048,2886,2976,5862
2020,Michoacán,16,Los Reyes,16075,35807,37392,73199
2020,Michoacán,16,Lázaro Cárdenas,16052,96519,95634,192153
2020,Michoacán,16,Madero,16049,9471,9298,18769
2020,Michoacán,16,Maravatío,16050,44551,48125,92676
2020,Michoacán,16,Marcos Castellanos,16051,7009,7508,14517
2020,Michoacán,16,Morelia,16053,397914,427671,825585
2020,Michoacán,16,Morelos,16054,3554,4312,7866
2020,Michoacán,16,Múgica,16055,23683,24181,47864
2020,Michoacán,16,Nahuatzen,16056,14516,15390,29906
2020,Michoacán,16,Nocupétaro,16057,4216,4285,8501
2020,Michoacán,16,Nuevo Parangaricutiro,16058,10231,10613,20844
2020,Michoacán,16,Nuevo Urecho,16059,4234,4246,8480
2020,Michoacán,16,Numarán,16060,4901,5389,10290
2020,Michoacán,16,Ocampo,16061,12705,12713,25418
2020,Michoacán,16,Pajacuarán,16062,9833,10505,20338
2020,Michoacán,16,Panindícuaro,16063,7778,8758,16536
2020,Michoacán,16,Paracho,16065,18784,20557,39341
2020,Michoacán,16,Parácuaro,16064,14148,13844,27992
2020,Michoacán,16,Penjamillo,16067,8291,9461,17752
2020,Michoacán,16,Peribán,16068,14774,14602,29376
2020,Michoacán,16,Puruándiro,16071,33259,37113,70372
2020,Michoacán,16,Purépero,16070,7877,8226,16103
2020,Michoacán,16,Pátzcuaro,16066,47125,50997,98122
2020,Michoacán,16,Queréndaro,16072,6997,7359,14356
2020,Michoacán,16,Quiroga,16073,13911,15207,29118
2020,Michoacán,16,Sahuayo,16076,39802,41569,81371
2020,Michoacán,16,Salvador Escalante,16079,25105,26547,51652
2020,Michoacán,16,San Lucas,16077,9392,9544,18936
2020,Michoacán,16,Santa Ana Maya,16078,6130,6994,13124
2020,Michoacán,16,Senguio,16080,9668,10312,19980
2020,Michoacán,16,Susupuato,16081,4556,4605,9161
2020,Michoacán,16,Tacámbaro,16082,39672,41433,81105
2020,Michoacán,16,Tancítaro,16083,16556,16151,32707
2020,Michoacán,16,Tangamandapio,16084,14903,16042,30945
2020,Michoacán,16,Tangancícuaro,16085,17115,18190,35305
2020,Michoacán,16,Tanhuato,16086,7941,8345,16286
2020,Michoacán,16,Taretan,16087,7642,7823,15465
2020,Michoacán,16,Tarímbaro,16088,57213,61819,119032
2020,Michoacán,16,Tepalcatepec,16089,12597,12314,24911
2020,Michoacán,16,Tingambato,16090,7718,8160,15878
2020,Michoacán,16,Tingüindín,16091,7376,7961,15337
2020,Michoacán,16,Tiquicheo de Nicolás Romero,16092,6988,7094,14082
2020,Michoacán,16,Tlalpujahua,16093,14384,15947,30331
2020,Michoacán,16,Tlazazalca,16094,3224,3430,6654
2020,Michoacán,16,Tocumbo,16095,6241,6352,12593
2020,Michoacán,16,Tumbiscatío,16096,3558,3434,6992
2020,Michoacán,16,Turicato,16097,15893,16695,32588
2020,Michoacán,16,Tuxpan,16098,13727,14744,28471
2020,Michoacán,16,Tuzantla,16099,7937,8027,15964
2020,Michoacán,16,Tzintzuntzan,16100,7189,7950,15139
2020,Michoacán,16,Tzitzio,16101,4577,4449,9026
2020,Michoacán,16,Uruapan,16102,172252,182475,354727
2020,Michoacán,16,Venustiano Carranza,16103,12800,13274,26074
2020,Michoacán,16,Villamar,16104,8374,9086,17460
2020,Michoacán,16,Vista Hermosa,16105,10648,11029,21677
2020,Michoacán,16,Yurécuaro,16106,16155,16981,33136
2020,Michoacán,16,Zacapu,16107,38483,41326,79809
2020,Michoacán,16,Zamora,16108,101152,106833,207985
2020,Michoacán,16,Zinapécuaro,16110,23754,25717,49471
2020,Michoacán,16,Zináparo,16109,1542,1801,3343
2020,Michoacán,16,Ziracuaretiro,16111,9032,9219,18251
2020,Michoacán,16,Zitácuaro,16112,82440,89575,172015
2020,Michoacán,16,Álvaro Obregón,16003,11068,11837,22905
2020,Morelos,17,Amacuzac,17001,9204,9657,18861
2020,Morelos,17,Atlatlahucan,17002,11839,12314,24153
2020,Morelos,17,Axochiapan,17003,18873,19363,38236
2020,Morelos,17,Ayala,17004,44058,46985,91043
2020,Morelos,17,Coatlán del Río,17005,5169,5310,10479
2020,Morelos,17,Cuautla,17006,100489,107738,208227
2020,Morelos,17,Cuernavaca,17007,188236,211190,399426
2020,Morelos,17,Emiliano Zapata,17008,52480,54165,106645
2020,Morelos,17,Huitzilac,17009,10160,10212,20372
2020,Morelos,17,Jantetelco,17010,8982,9379,18361
2020,Morelos,17,Jiutepec,17011,110368,117281,227649
2020,Morelos,17,Jojutla,17012,29642,31724,61366
2020,Morelos,17,Jonacatepec,17013,8050,8682,16732
2020,Morelos,17,Mazatepec,17014,5233,5458,10691
2020,Morelos,17,Miacatlán,17015,13769,14494,28263
2020,Morelos,17,Ocuituco,17016,9718,9965,19683
2020,Morelos,17,Puente de Ixtla,17017,34777,36140,70917
2020,Morelos,17,Temixco,17018,60599,63213,123812
2020,Morelos,17,Temoac,17033,8240,8714,16954
2020,Morelos,17,Tepalcingo,17019,14125,14746,28871
2020,Morelos,17,Tepoztlán,17020,25257,26116,51373
2020,Morelos,17,Tetecala,17021,4153,4173,8326
2020,Morelos,17,Tetela del Volcán,17022,10699,11316,22015
2020,Morelos,17,Tlalnepantla,17023,3910,3804,7714
2020,Morelos,17,Tlaltizapán de Zapata,17024,27108,28445,55553
2020,Morelos,17,Tlaquiltenango,17025,17854,18293,36147
2020,Morelos,17,Tlayacapan,17026,9471,9658,19129
2020,Morelos,17,Totolapan,17027,6315,6487,12802
2020,Morelos,17,Xochitepec,17028,37813,36878,74691
2020,Morelos,17,Yautepec,17029,53526,56388,109914
2020,Morelos,17,Yecapixtla,17030,27861,28473,56334
2020,Morelos,17,Zacatepec,17031,18828,20309,39137
2020,Morelos,17,Zacualpan,17032,4979,5203,10182
2020,Nayarit,18,Acaponeta,18001,20277,20145,40422
2020,Nayarit,18,Ahuacatlán,18002,8657,8569,17226
2020,Nayarit,18,Amatlán de Cañas,18003,6485,6251,12736
2020,Nayarit,18,Bahía de Banderas,18020,88919,85591,174510
2020,Nayarit,18,Compostela,18004,41147,40773,81920
2020,Nayarit,18,Del Nayar,18009,22720,22597,45317
2020,Nayarit,18,Huajicori,18005,6902,6638,13540
2020,Nayarit,18,Ixtlán del Río,18006,15407,16363,31770
2020,Nayarit,18,Jala,18007,9934,10082,20016
2020,Nayarit,18,La Yesca,18019,7694,7268,14962
2020,Nayarit,18,Rosamorada,18010,18970,18123,37093
2020,Nayarit,18,Ruíz,18011,13645,13283,26928
2020,Nayarit,18,San Blas,18012,25319,22705,48024
2020,Nayarit,18,San Pedro Lagunillas,18013,4177,4054,8231
2020,Nayarit,18,Santa María del Oro,18014,13052,12458,25510
2020,Nayarit,18,Santiago Ixcuintla,18015,53965,52073,106038
2020,Nayarit,18,Tecuala,18016,21895,21148,43043
2020,Nayarit,18,Tepic,18017,217989,227900,445889
2020,Nayarit,18,Tuxpan,18018,16628,16730,33358
2020,Nayarit,18,Xalisco,18008,30419,31619,62038
2020,Nuevo León,19,Abasolo,19001,1461,1457,2918
2020,Nuevo León,19,Agualeguas,19002,1333,1266,2599
2020,Nuevo León,19,Allende,19004,19302,18995,38297
2020,Nuevo León,19,Anáhuac,19005,9951,10025,19976
2020,Nuevo León,19,Apodaca,19006,335580,330154,665734
2020,Nuevo León,19,Aramberri,19007,8991,8809,17800
2020,Nuevo León,19,Bustamante,19008,2198,2186,4384
2020,Nuevo León,19,Cadereyta Jiménez,19009,53890,51255,105145
2020,Nuevo León,19,Cerralvo,19011,4296,4028,8324
2020,Nuevo León,19,China,19013,6130,5832,11962
2020,Nuevo León,19,Ciénega de Flores,19012,25765,24798,50563
2020,Nuevo León,19,Doctor Arroyo,19014,19089,18770,37859
2020,Nuevo León,19,Doctor Coss,19015,942,903,1845
2020,Nuevo León,19,Doctor González,19016,1684,1610,3294
2020,Nuevo León,19,El Carmen,19010,23908,23418,47326
2020,Nuevo León,19,Galeana,19017,22746,22243,44989
2020,Nuevo León,19,García,19018,151182,149563,300745
2020,Nuevo León,19,General Bravo,19020,3147,2980,6127
2020,Nuevo León,19,General Escobedo,19021,233747,232578,466325
2020,Nuevo León,19,General Terán,19022,8117,8166,16283
2020,Nuevo León,19,General Treviño,19023,583,611,1194
2020,Nuevo León,19,General Zaragoza,19024,3415,3189,6604
2020,Nuevo León,19,General Zuazua,19025,46354,45559,91913
2020,Nuevo León,19,Guadalupe,19026,360152,350261,710413
2020,Nuevo León,19,Hidalgo,19047,7993,7909,15902
2020,Nuevo León,19,Higueras,19028,891,821,1712
2020,Nuevo León,19,Hualahuises,19029,3837,3909,7746
2020,Nuevo León,19,Iturbide,19030,2068,1911,3979
2020,Nuevo León,19,Juárez,19031,200652,196212,396864
2020,Nuevo León,19,Lampazos de Naranjo,19032,2932,2851,5783
2020,Nuevo León,19,Linares,19033,44282,44407,88689
2020,Nuevo León,19,Los Aldamas,19003,762,744,1506
2020,Nuevo León,19,Los Herreras,19027,989,1009,1998
2020,Nuevo León,19,Los Ramones,19042,2633,2568,5201
2020,Nuevo León,19,Marín,19034,3202,2997,6199
2020,Nuevo León,19,Melchor Ocampo,19035,545,526,1071
2020,Nuevo León,19,Mier y Noriega,19036,3839,3762,7601
2020,Nuevo León,19,Mina,19037,3009,2873,5882
2020,Nuevo León,19,Montemorelos,19038,33891,33766,67657
2020,Nuevo León,19,Monterrey,19039,551689,573146,1124835
2020,Nuevo León,19,Parás,19040,547,536,1083
2020,Nuevo León,19,Pesquería,19041,56520,56063,112583
2020,Nuevo León,19,Rayones,19043,1546,1441,2987
2020,Nuevo León,19,Sabinas Hidalgo,19044,19260,19836,39096
2020,Nuevo León,19,Salinas Victoria,19045,31591,30277,61868
2020,Nuevo León,19,San Nicolás de los Garza,19046,233413,240750,474163
2020,Nuevo León,19,San Pedro Garza García,19019,65002,72612,137614
2020,Nuevo León,19,Santa Catarina,19048,161982,160069,322051
2020,Nuevo León,19,Santiago,19049,23601,23354,46955
2020,Nuevo León,19,Vallecillo,19050,1053,889,1942
2020,Nuevo León,19,Villaldama,19051,2292,2275,4567
2020,Oaxaca,20,Abejones,20001,444,589,1033
2020,Oaxaca,20,Acatlán de Pérez Figueroa,20002,23276,24340,47616
2020,Oaxaca,20,Asunción Cacalotepec,20003,1054,1122,2176
2020,Oaxaca,20,Asunción Cuyotepeji,20004,478,551,1029
2020,Oaxaca,20,Asunción Ixtaltepec,20005,7871,7960,15831
2020,Oaxaca,20,Asunción Nochixtlán,20006,9279,10376,19655
2020,Oaxaca,20,Asunción Ocotlán,20007,1113,1383,2496
2020,Oaxaca,20,Asunción Tlacolulita,20008,393,411,804
2020,Oaxaca,20,Ayoquezco de Aldama,20398,2083,2353,4436
2020,Oaxaca,20,Ayotzintepec,20009,3697,3755,7452
2020,Oaxaca,20,Calihualá,20011,583,614,1197
2020,Oaxaca,20,Candelaria Loxicha,20012,5248,5581,10829
2020,Oaxaca,20,Capulálpam de Méndez,20247,729,893,1622
2020,Oaxaca,20,Chahuites,20025,5975,6059,12034
2020,Oaxaca,20,Chalcatongo de Hidalgo,20026,4405,5022,9427
2020,Oaxaca,20,Chiquihuitlán de Benito Juárez,20027,1110,1308,2418
2020,Oaxaca,20,Ciudad Ixtepec,20014,14557,15811,30368
2020,Oaxaca,20,Ciénega de Zimatlán,20013,1481,1615,3096
2020,Oaxaca,20,Coatecas Altas,20015,2223,2515,4738
2020,Oaxaca,20,Coicoyán de las Flores,20016,4871,5501,10372
2020,Oaxaca,20,Concepción Buenavista,20018,400,426,826
2020,Oaxaca,20,Concepción Pápalo,20019,1539,1539,3078
2020,Oaxaca,20,Constancia del Rosario,20020,1890,2196,4086
2020,Oaxaca,20,Cosolapa,20021,7820,8434,16254
2020,Oaxaca,20,Cosoltepec,20022,363,427,790
2020,Oaxaca,20,Cuilápam de Guerrero,20023,11054,11707,22761
2020,Oaxaca,20,Cuyamecalco Villa de Zaragoza,20024,1921,1883,3804
2020,Oaxaca,20,El Barrio de la Soledad,20010,7169,7726,14895
2020,Oaxaca,20,El Espinal,20030,4463,4658,9121
2020,Oaxaca,20,Eloxochitlán de Flores Magón,20029,2098,2345,4443
2020,Oaxaca,20,Fresnillo de Trujano,20032,511,549,1060
2020,Oaxaca,20,Guadalupe Etla,20033,1337,1485,2822
2020,Oaxaca,20,Guadalupe de Ramírez,20034,652,673,1325
2020,Oaxaca,20,Guelatao de Juárez,20035,282,288,570
2020,Oaxaca,20,Guevea de Humboldt,20036,2677,2802,5479
2020,Oaxaca,20,Heroica Ciudad de Ejutla de Crespo,20028,10354,11559,21913
2020,Oaxaca,20,Heroica Ciudad de Huajuapan de León,20039,38483,42788,81271
2020,Oaxaca,20,Heroica Ciudad de Juchitán de Zaragoza,20043,50385,52856,103241
2020,Oaxaca,20,Heroica Ciudad de Tlaxiaco,20397,20036,22643,42679
2020,Oaxaca,20,Huautepec,20040,3008,3441,6449
2020,Oaxaca,20,Huautla de Jiménez,20041,15118,17341,32459
2020,Oaxaca,20,Ixpantepec Nieves,20065,528,656,1184
2020,Oaxaca,20,Ixtlán de Juárez,20042,4193,4328,8521
2020,Oaxaca,20,La Compañía,20017,1613,1786,3399
2020,Oaxaca,20,La Pe,20069,1326,1419,2745
2020,Oaxaca,20,La Reforma,20076,1580,1744,3324
2020,Oaxaca,20,La Trinidad Vista Hermosa,20556,116,143,259
2020,Oaxaca,20,Loma Bonita,20044,21285,23299,44584
2020,Oaxaca,20,Magdalena Apasco,20045,4403,4897,9300
2020,Oaxaca,20,Magdalena Jaltepec,20046,1523,1788,3311
2020,Oaxaca,20,Magdalena Mixtepec,20048,688,713,1401
2020,Oaxaca,20,Magdalena Ocotlán,20049,580,629,1209
2020,Oaxaca,20,Magdalena Peñasco,20050,1687,1957,3644
2020,Oaxaca,20,Magdalena Teitipac,20051,2308,2474,4782
2020,Oaxaca,20,Magdalena Tequisistlán,20052,3101,3260,6361
2020,Oaxaca,20,Magdalena Tlacotepec,20053,621,681,1302
2020,Oaxaca,20,Magdalena Yodocono de Porfirio Díaz,20562,777,824,1601
2020,Oaxaca,20,Magdalena Zahuatlán,20054,200,227,427
2020,Oaxaca,20,Mariscala de Juárez,20055,1765,1917,3682
2020,Oaxaca,20,Matías Romero Avendaño,20057,19613,21077,40690
2020,Oaxaca,20,Mazatlán Villa de Flores,20058,6703,6813,13516
2020,Oaxaca,20,Mesones Hidalgo,20037,2088,2466,4554
2020,Oaxaca,20,Miahuatlán de Porfirio Díaz,20059,21815,23864,45679
2020,Oaxaca,20,Mixistlán de la Reforma,20060,1283,1430,2713
2020,Oaxaca,20,Monjas,20061,1304,1542,2846
2020,Oaxaca,20,Mártires de Tacubaya,20056,719,778,1497
2020,Oaxaca,20,Natividad,20062,293,333,626
2020,Oaxaca,20,Nazareno Etla,20063,2013,2221,4234
2020,Oaxaca,20,Nejapa de Madero,20064,3787,3942,7729
2020,Oaxaca,20,Nuevo Zoquiápam,20504,807,880,1687
2020,Oaxaca,20,Oaxaca de Juárez,20067,121070,137566,258636
2020,Oaxaca,20,Ocotlán de Morelos,20068,10982,11954,22936
2020,Oaxaca,20,Pinotepa de Don Luis,20070,3556,3645,7201
2020,Oaxaca,20,Pluma Hidalgo,20071,1462,1534,2996
2020,Oaxaca,20,Putla Villa de Guerrero,20073,16252,18316,34568
2020,Oaxaca,20,Reforma de Pineda,20075,1403,1493,2896
2020,Oaxaca,20,Reyes Etla,20077,1979,2108,4087
2020,Oaxaca,20,Rojas de Cuauhtémoc,20078,549,611,1160
2020,Oaxaca,20,Salina Cruz,20079,44500,48077,92577
2020,Oaxaca,20,San Agustín Amatengo,20080,690,785,1475
2020,Oaxaca,20,San Agustín Atenango,20081,836,964,1800
2020,Oaxaca,20,San Agustín Chayuco,20082,1940,2156,4096
2020,Oaxaca,20,San Agustín Etla,20084,2036,2242,4278
2020,Oaxaca,20,San Agustín Loxicha,20085,12592,13092,25684
2020,Oaxaca,20,San Agustín Tlacotepec,20086,419,561,980
2020,Oaxaca,20,San Agustín Yatareni,20087,2156,2454,4610
2020,Oaxaca,20,San Agustín de las Juntas,20083,4976,5175,10151
2020,Oaxaca,20,San Andrés Cabecera Nueva,20088,1416,1451,2867
2020,Oaxaca,20,San Andrés Dinicuiti,20089,1068,1131,2199
2020,Oaxaca,20,San Andrés Huaxpaltepec,20090,3103,3278,6381
2020,Oaxaca,20,San Andrés Huayápam,20091,2701,2954,5655
2020,Oaxaca,20,San Andrés Ixtlahuaca,20092,781,885,1666
2020,Oaxaca,20,San Andrés Lagunas,20093,233,272,505
2020,Oaxaca,20,San Andrés Nuxiño,20094,867,947,1814
2020,Oaxaca,20,San Andrés Paxtlán,20095,2246,2256,4502
2020,Oaxaca,20,San Andrés Sinaxtla,20096,365,413,778
2020,Oaxaca,20,San Andrés Solaga,20097,865,914,1779
2020,Oaxaca,20,San Andrés Teotilálpam,20098,2204,2386,4590
2020,Oaxaca,20,San Andrés Tepetlapa,20099,244,281,525
2020,Oaxaca,20,San Andrés Yaá,20100,209,253,462
2020,Oaxaca,20,San Andrés Zabache,20101,326,409,735
2020,Oaxaca,20,San Andrés Zautla,20102,2349,2489,4838
2020,Oaxaca,20,San Antonino Castillo Velasco,20103,3020,3310,6330
2020,Oaxaca,20,San Antonino Monte Verde,20105,3442,4014,7456
2020,Oaxaca,20,San Antonino el Alto,20104,1373,1415,2788
2020,Oaxaca,20,San Antonio Acutla,20106,122,147,269
2020,Oaxaca,20,San Antonio Huitepec,20108,2113,2450,4563
2020,Oaxaca,20,San Antonio Nanahuatípam,20109,636,643,1279
2020,Oaxaca,20,San Antonio Sinicahua,20110,757,874,1631
2020,Oaxaca,20,San Antonio Tepetlapa,20111,2144,2316,4460
2020,Oaxaca,20,San Antonio de la Cal,20107,12119,13483,25602
2020,Oaxaca,20,San Baltazar Chichicápam,20112,1219,1391,2610
2020,Oaxaca,20,San Baltazar Loxicha,20113,1501,1571,3072
2020,Oaxaca,20,San Baltazar Yatzachi el Bajo,20114,317,361,678
2020,Oaxaca,20,San Bartolo Coyotepec,20115,4835,5351,10186
2020,Oaxaca,20,San Bartolo Soyaltepec,20121,299,375,674
2020,Oaxaca,20,San Bartolo Yautepec,20122,336,342,678
2020,Oaxaca,20,San Bartolomé Ayautla,20116,2260,2400,4660
2020,Oaxaca,20,San Bartolomé Loxicha,20117,1194,1229,2423
2020,Oaxaca,20,San Bartolomé Quialana,20118,1052,1489,2541
2020,Oaxaca,20,San Bartolomé Yucuañe,20119,159,232,391
2020,Oaxaca,20,San Bartolomé Zoogocho,20120,133,183,316
2020,Oaxaca,20,San Bernardo Mixtepec,20123,1336,1454,2790
2020,Oaxaca,20,San Blas Atempa,20124,9519,9410,18929
2020,Oaxaca,20,San Carlos Yautepec,20125,6324,6238,12562
2020,Oaxaca,20,San Cristóbal Amatlán,20126,2541,2878,5419
2020,Oaxaca,20,San Cristóbal Amoltepec,20127,524,623,1147
2020,Oaxaca,20,San Cristóbal Lachirioag,20128,623,677,1300
2020,Oaxaca,20,San Cristóbal Suchixtlahuaca,20129,182,193,375
2020,Oaxaca,20,San Dionisio Ocotepec,20131,5194,5925,11119
2020,Oaxaca,20,San Dionisio Ocotlán,20132,591,609,1200
2020,Oaxaca,20,San Dionisio del Mar,20130,2741,2629,5370
2020,Oaxaca,20,San Esteban Atatlahuca,20133,1901,1993,3894
2020,Oaxaca,20,San Felipe Jalapa de Díaz,20134,14061,14987,29048
2020,Oaxaca,20,San Felipe Tejalápam,20135,3908,4277,8185
2020,Oaxaca,20,San Felipe Usila,20136,5775,6254,12029
2020,Oaxaca,20,San Francisco Cahuacuá,20137,1741,1768,3509
2020,Oaxaca,20,San Francisco Cajonos,20138,209,237,446
2020,Oaxaca,20,San Francisco Chapulapa,20139,1029,1111,2140
2020,Oaxaca,20,San Francisco Chindúa,20140,407,434,841
2020,Oaxaca,20,San Francisco Huehuetlán,20142,490,620,1110
2020,Oaxaca,20,San Francisco Ixhuatán,20143,4606,4690,9296
2020,Oaxaca,20,San Francisco Jaltepetongo,20144,504,520,1024
2020,Oaxaca,20,San Francisco Lachigoló,20145,2228,2318,4546
2020,Oaxaca,20,San Francisco Logueche,20146,1415,1611,3026
2020,Oaxaca,20,San Francisco Nuxaño,20147,199,188,387
2020,Oaxaca,20,San Francisco Ozolotepec,20148,958,1015,1973
2020,Oaxaca,20,San Francisco Sola,20149,839,934,1773
2020,Oaxaca,20,San Francisco Telixtlahuaca,20150,6509,6973,13482
2020,Oaxaca,20,San Francisco Teopan,20151,181,164,345
2020,Oaxaca,20,San Francisco Tlapancingo,20152,1047,1310,2357
2020,Oaxaca,20,San Francisco del Mar,20141,4096,3995,8091
2020,Oaxaca,20,San Gabriel Mixtepec,20153,2462,2625,5087
2020,Oaxaca,20,San Ildefonso Amatlán,20154,1201,1374,2575
2020,Oaxaca,20,San Ildefonso Sola,20155,509,498,1007
2020,Oaxaca,20,San Ildefonso Villa Alta,20156,1719,1818,3537
2020,Oaxaca,20,San Jacinto Amilpas,20157,8701,9592,18293
2020,Oaxaca,20,San Jacinto Tlacotepec,20158,1098,1162,2260
2020,Oaxaca,20,San Jerónimo Coatlán,20159,2674,2827,5501
2020,Oaxaca,20,San Jerónimo Silacayoapilla,20160,691,723,1414
2020,Oaxaca,20,San Jerónimo Sosola,20161,1267,1421,2688
2020,Oaxaca,20,San Jerónimo Taviche,20162,958,1044,2002
2020,Oaxaca,20,San Jerónimo Tecóatl,20163,786,883,1669
2020,Oaxaca,20,San Jerónimo Tlacochahuaya,20550,2702,3043,5745
2020,Oaxaca,20,San Jorge Nuchita,20164,1348,1589,2937
2020,Oaxaca,20,San José Ayuquila,20165,737,857,1594
2020,Oaxaca,20,San José Chiltepec,20166,6104,6469,12573
2020,Oaxaca,20,San José Estancia Grande,20168,542,550,1092
2020,Oaxaca,20,San José Independencia,20169,1842,1983,3825
2020,Oaxaca,20,San José Lachiguiri,20170,1618,2002,3620
2020,Oaxaca,20,San José Tenango,20171,9113,9839,18952
2020,Oaxaca,20,San José del Peñasco,20167,1083,1122,2205
2020,Oaxaca,20,San José del Progreso,20072,3433,3638,7071
2020,Oaxaca,20,San Juan Achiutla,20172,203,214,417
2020,Oaxaca,20,San Juan Atepec,20173,726,814,1540
2020,Oaxaca,20,San Juan Bautista Atatlahuca,20175,800,852,1652
2020,Oaxaca,20,San Juan Bautista Coixtlahuaca,20176,1309,1449,2758
2020,Oaxaca,20,San Juan Bautista Cuicatlán,20177,5023,5318,10341
2020,Oaxaca,20,San Juan Bautista Guelache,20178,3716,4147,7863
2020,Oaxaca,20,San Juan Bautista Jayacatlán,20179,783,767,1550
2020,Oaxaca,20,San Juan Bautista Lo de Soto,20180,1313,1340,2653
2020,Oaxaca,20,San Juan Bautista Suchitepec,20181,209,249,458
2020,Oaxaca,20,San Juan Bautista Tlachichilco,20183,667,773,1440
2020,Oaxaca,20,San Juan Bautista Tlacoatzintepec,20182,1063,1185,2248
2020,Oaxaca,20,San Juan Bautista Tuxtepec,20184,81919,88669,170588
2020,Oaxaca,20,San Juan Bautista Valle Nacional,20559,11168,12202,23370
2020,Oaxaca,20,San Juan Cacahuatepec,20185,4528,4736,9264
2020,Oaxaca,20,San Juan Chicomezúchil,20191,157,187,344
2020,Oaxaca,20,San Juan Chilateca,20192,732,853,1585
2020,Oaxaca,20,San Juan Cieneguilla,20186,287,311,598
2020,Oaxaca,20,San Juan Coatzóspam,20187,1098,1078,2176
2020,Oaxaca,20,San Juan Colorado,20188,5009,5320,10329
2020,Oaxaca,20,San Juan Comaltepec,20189,1434,1503,2937
2020,Oaxaca,20,San Juan Cotzocón,20190,11940,12579,24519
2020,Oaxaca,20,San Juan Diuxi,20195,549,562,1111
2020,Oaxaca,20,San Juan Evangelista Analco,20196,210,225,435
2020,Oaxaca,20,San Juan Guelavía,20197,1651,1754,3405
2020,Oaxaca,20,San Juan Guichicovi,20198,14481,16334,30815
2020,Oaxaca,20,San Juan Ihualtepec,20199,295,347,642
2020,Oaxaca,20,San Juan Juquila Mixes,20200,1877,2096,3973
2020,Oaxaca,20,San Juan Juquila Vijanos,20201,967,1055,2022
2020,Oaxaca,20,San Juan Lachao,20202,2402,2566,4968
2020,Oaxaca,20,San Juan Lachigalla,20203,1657,1775,3432
2020,Oaxaca,20,San Juan Lajarcia,20204,303,370,673
2020,Oaxaca,20,San Juan Lalana,20205,8581,8998,17579
2020,Oaxaca,20,San Juan Mazatlán,20207,9540,9686,19226
2020,Oaxaca,20,San Juan Mixtepec Distrito 08,20208,3319,3799,7118
2020,Oaxaca,20,San Juan Mixtepec Distrito 26,20209,289,412,701
2020,Oaxaca,20,San Juan Ozolotepec,20211,1401,1379,2780
2020,Oaxaca,20,San Juan Petlapa,20212,1472,1569,3041
2020,Oaxaca,20,San Juan Quiahije,20213,1941,2204,4145
2020,Oaxaca,20,San Juan Quiotepec,20214,1051,1084,2135
2020,Oaxaca,20,San Juan Sayultepec,20215,385,454,839
2020,Oaxaca,20,San Juan Tabaá,20216,660,721,1381
2020,Oaxaca,20,San Juan Tamazola,20217,1502,1577,3079
2020,Oaxaca,20,San Juan Teita,20218,310,323,633
2020,Oaxaca,20,San Juan Teitipac,20219,1290,1415,2705
2020,Oaxaca,20,San Juan Tepeuxila,20220,1414,1329,2743
2020,Oaxaca,20,San Juan Teposcolula,20221,628,667,1295
2020,Oaxaca,20,San Juan Yaeé,20222,734,828,1562
2020,Oaxaca,20,San Juan Yatzona,20223,211,272,483
2020,Oaxaca,20,San Juan Yucuita,20224,278,337,615
2020,Oaxaca,20,San Juan de los Cués,20206,1235,1262,2497
2020,Oaxaca,20,San Juan del Estado,20193,1331,1438,2769
2020,Oaxaca,20,San Juan del Río,20194,600,718,1318
2020,Oaxaca,20,San Juan Ñumí,20210,2867,3286,6153
2020,Oaxaca,20,San Lorenzo,20225,3058,3299,6357
2020,Oaxaca,20,San Lorenzo Albarradas,20226,1459,1416,2875
2020,Oaxaca,20,San Lorenzo Cacaotepec,20227,7971,8659,16630
2020,Oaxaca,20,San Lorenzo Cuaunecuiltitla,20228,443,400,843
2020,Oaxaca,20,San Lorenzo Texmelúcan,20229,3940,4580,8520
2020,Oaxaca,20,San Lorenzo Victoria,20230,498,512,1010
2020,Oaxaca,20,San Lucas Camotlán,20231,1515,1616,3131
2020,Oaxaca,20,San Lucas Ojitlán,20232,10213,10856,21069
2020,Oaxaca,20,San Lucas Quiaviní,20233,742,1053,1795
2020,Oaxaca,20,San Lucas Zoquiápam,20234,3748,3962,7710
2020,Oaxaca,20,San Luis Amatlán,20235,1739,2038,3777
2020,Oaxaca,20,San Marcial Ozolotepec,20236,740,818,1558
2020,Oaxaca,20,San Marcos Arteaga,20237,650,752,1402
2020,Oaxaca,20,San Martín Huamelúlpam,20239,498,591,1089
2020,Oaxaca,20,San Martín Itunyoso,20240,1024,1296,2320
2020,Oaxaca,20,San Martín Lachilá,20241,494,621,1115
2020,Oaxaca,20,San Martín Peras,20242,6053,6503,12556
2020,Oaxaca,20,San Martín Tilcajete,20243,840,1045,1885
2020,Oaxaca,20,San Martín Toxpalan,20244,1930,2043,3973
2020,Oaxaca,20,San Martín Zacatepec,20245,651,671,1322
2020,Oaxaca,20,San Martín de los Cansecos,20238,439,451,890
2020,Oaxaca,20,San Mateo Cajonos,20246,295,353,648
2020,Oaxaca,20,San Mateo Etlatongo,20250,572,610,1182
2020,Oaxaca,20,San Mateo Nejápam,20251,564,619,1183
2020,Oaxaca,20,San Mateo Peñasco,20252,1029,1187,2216
2020,Oaxaca,20,San Mateo Piñas,20253,975,987,1962
2020,Oaxaca,20,San Mateo Río Hondo,20254,1591,1661,3252
2020,Oaxaca,20,San Mateo Sindihui,20255,996,1110,2106
2020,Oaxaca,20,San Mateo Tlapiltepec,20256,107,127,234
2020,Oaxaca,20,San Mateo Yoloxochitlán,20249,1788,1970,3758
2020,Oaxaca,20,San Mateo Yucutindoo,20566,1563,1596,3159
2020,Oaxaca,20,San Mateo del Mar,20248,8011,7760,15771
2020,Oaxaca,20,San Melchor Betaza,20257,497,571,1068
2020,Oaxaca,20,San Miguel Achiutla,20258,366,409,775
2020,Oaxaca,20,San Miguel Ahuehuetitlán,20259,1180,1305,2485
2020,Oaxaca,20,San Miguel Aloápam,20260,1072,1219,2291
2020,Oaxaca,20,San Miguel Amatitlán,20261,3689,4119,7808
2020,Oaxaca,20,San Miguel Amatlán,20262,495,526,1021
2020,Oaxaca,20,San Miguel Chicahua,20264,997,1226,2223
2020,Oaxaca,20,San Miguel Chimalapa,20265,3660,3457,7117
2020,Oaxaca,20,San Miguel Coatlán,20263,1568,1848,3416
2020,Oaxaca,20,San Miguel Ejutla,20268,475,557,1032
2020,Oaxaca,20,San Miguel Huautla,20270,534,623,1157
2020,Oaxaca,20,San Miguel Mixtepec,20271,1636,1685,3321
2020,Oaxaca,20,San Miguel Panixtlahuaca,20272,3052,3716,6768
2020,Oaxaca,20,San Miguel Peras,20273,1664,1799,3463
2020,Oaxaca,20,San Miguel Piedras,20274,649,685,1334
2020,Oaxaca,20,San Miguel Quetzaltepec,20275,4285,4227,8512
2020,Oaxaca,20,San Miguel Santa Flor,20276,367,363,730
2020,Oaxaca,20,San Miguel Soyaltepec,20278,19643,20833,40476
2020,Oaxaca,20,San Miguel Suchixtepec,20279,1346,1487,2833
2020,Oaxaca,20,San Miguel Tecomatlán,20281,168,144,312
2020,Oaxaca,20,San Miguel Tenango,20282,381,368,749
2020,Oaxaca,20,San Miguel Tequixtepec,20283,509,545,1054
2020,Oaxaca,20,San Miguel Tilquiápam,20284,1421,1798,3219
2020,Oaxaca,20,San Miguel Tlacamama,20285,1863,1922,3785
2020,Oaxaca,20,San Miguel Tlacotepec,20286,1514,1740,3254
2020,Oaxaca,20,San Miguel Tulancingo,20287,127,192,319
2020,Oaxaca,20,San Miguel Yotao,20288,298,327,625
2020,Oaxaca,20,San Miguel del Puerto,20266,4256,4351,8607
2020,Oaxaca,20,San Miguel del Río,20267,142,135,277
2020,Oaxaca,20,San Miguel el Grande,20269,2065,2324,4389
2020,Oaxaca,20,San Nicolás,20289,539,652,1191
2020,Oaxaca,20,San Nicolás Hidalgo,20290,482,561,1043
2020,Oaxaca,20,San Pablo Coatlán,20291,2133,2236,4369
2020,Oaxaca,20,San Pablo Cuatro Venados,20292,675,773,1448
2020,Oaxaca,20,San Pablo Etla,20293,9112,10088,19200
2020,Oaxaca,20,San Pablo Huitzo,20294,3504,3931,7435
2020,Oaxaca,20,San Pablo Huixtepec,20295,4659,5125,9784
2020,Oaxaca,20,San Pablo Macuiltianguis,20296,449,476,925
2020,Oaxaca,20,San Pablo Tijaltepec,20297,1123,1354,2477
2020,Oaxaca,20,San Pablo Villa de Mitla,20298,6318,6881,13199
2020,Oaxaca,20,San Pablo Yaganiza,20299,524,586,1110
2020,Oaxaca,20,San Pedro Amuzgos,20300,3269,3737,7006
2020,Oaxaca,20,San Pedro Apóstol,20301,734,860,1594
2020,Oaxaca,20,San Pedro Atoyac,20302,2174,2434,4608
2020,Oaxaca,20,San Pedro Cajonos,20303,517,623,1140
2020,Oaxaca,20,San Pedro Comitancillo,20305,2116,2321,4437
2020,Oaxaca,20,San Pedro Coxcaltepec Cántaros,20304,367,404,771
2020,Oaxaca,20,San Pedro Huamelula,20307,5119,5140,10259
2020,Oaxaca,20,San Pedro Huilotepec,20308,1621,1650,3271
2020,Oaxaca,20,San Pedro Ixcatlán,20309,5776,6028,11804
2020,Oaxaca,20,San Pedro Ixtlahuaca,20310,4529,4804,9333
2020,Oaxaca,20,San Pedro Jaltepetongo,20311,266,304,570
2020,Oaxaca,20,San Pedro Jicayán,20312,6092,6668,12760
2020,Oaxaca,20,San Pedro Jocotipac,20313,363,440,803
2020,Oaxaca,20,San Pedro Juchatengo,20314,791,877,1668
2020,Oaxaca,20,San Pedro Mixtepec Distrito 22,20318,24975,26220,51195
2020,Oaxaca,20,San Pedro Mixtepec Distrito 26,20319,531,579,1110
2020,Oaxaca,20,San Pedro Molinos,20320,332,370,702
2020,Oaxaca,20,San Pedro Mártir,20315,761,966,1727
2020,Oaxaca,20,San Pedro Mártir Quiechapa,20316,339,388,727
2020,Oaxaca,20,San Pedro Mártir Yucuxaco,20317,598,701,1299
2020,Oaxaca,20,San Pedro Nopala,20321,357,393,750
2020,Oaxaca,20,San Pedro Ocopetatillo,20322,392,455,847
2020,Oaxaca,20,San Pedro Ocotepec,20323,1067,1136,2203
2020,Oaxaca,20,San Pedro Pochutla,20324,24275,25089,49364
2020,Oaxaca,20,San Pedro Quiatoni,20325,5518,5835,11353
2020,Oaxaca,20,San Pedro Sochiápam,20326,2592,2653,5245
2020,Oaxaca,20,San Pedro Tapanatepec,20327,7597,7770,15367
2020,Oaxaca,20,San Pedro Taviche,20328,615,636,1251
2020,Oaxaca,20,San Pedro Teozacoalco,20329,617,662,1279
2020,Oaxaca,20,San Pedro Teutila,20330,2176,2246,4422
2020,Oaxaca,20,San Pedro Tidaá,20331,431,497,928
2020,Oaxaca,20,San Pedro Topiltepec,20332,178,197,375
2020,Oaxaca,20,San Pedro Totolápam,20333,1299,1439,2738
2020,Oaxaca,20,San Pedro Yaneri,20335,465,495,960
2020,Oaxaca,20,San Pedro Yucunama,20341,102,137,239
2020,Oaxaca,20,San Pedro Yólox,20336,877,942,1819
2020,Oaxaca,20,San Pedro el Alto,20306,1839,1942,3781
2020,Oaxaca,20,San Pedro y San Pablo Ayutla,20337,2471,2935,5406
2020,Oaxaca,20,San Pedro y San Pablo Teposcolula,20339,2044,2251,4295
2020,Oaxaca,20,San Pedro y San Pablo Tequixtepec,20340,799,979,1778
2020,Oaxaca,20,San Raymundo Jalpan,20342,1688,2022,3710
2020,Oaxaca,20,San Sebastián Abasolo,20343,951,1037,1988
2020,Oaxaca,20,San Sebastián Coatlán,20344,1359,1443,2802
2020,Oaxaca,20,San Sebastián Ixcapa,20345,2082,2140,4222
2020,Oaxaca,20,San Sebastián Nicananduta,20346,645,855,1500
2020,Oaxaca,20,San Sebastián Río Hondo,20347,1871,1912,3783
2020,Oaxaca,20,San Sebastián Tecomaxtlahuaca,20348,4057,4474,8531
2020,Oaxaca,20,San Sebastián Teitipac,20349,929,1107,2036
2020,Oaxaca,20,San Sebastián Tutla,20350,8959,10313,19272
2020,Oaxaca,20,San Simón Almolongas,20351,1332,1534,2866
2020,Oaxaca,20,San Simón Zahuatlán,20352,2157,2210,4367
2020,Oaxaca,20,San Vicente Coatlán,20534,1845,2217,4062
2020,Oaxaca,20,San Vicente Lachixío,20535,1375,1563,2938
2020,Oaxaca,20,San Vicente Nuñú,20536,205,242,447
2020,Oaxaca,20,Santa Ana,20353,1082,1177,2259
2020,Oaxaca,20,Santa Ana Ateixtlahuaca,20354,268,264,532
2020,Oaxaca,20,Santa Ana Cuauhtémoc,20355,355,385,740
2020,Oaxaca,20,Santa Ana Tavela,20357,407,430,837
2020,Oaxaca,20,Santa Ana Tlapacoyan,20358,987,1073,2060
2020,Oaxaca,20,Santa Ana Yareni,20359,425,498,923
2020,Oaxaca,20,Santa Ana Zegache,20360,1838,2075,3913
2020,Oaxaca,20,Santa Ana del Valle,20356,1041,1107,2148
2020,Oaxaca,20,Santa Catalina Quierí,20361,421,522,943
2020,Oaxaca,20,Santa Catarina Cuixtla,20362,670,840,1510
2020,Oaxaca,20,Santa Catarina Ixtepeji,20363,1307,1412,2719
2020,Oaxaca,20,Santa Catarina Juquila,20364,7924,8395,16319
2020,Oaxaca,20,Santa Catarina Lachatao,20365,547,593,1140
2020,Oaxaca,20,Santa Catarina Loxicha,20366,1960,2013,3973
2020,Oaxaca,20,Santa Catarina Mechoacán,20367,2317,2360,4677
2020,Oaxaca,20,Santa Catarina Minas,20368,992,1025,2017
2020,Oaxaca,20,Santa Catarina Quiané,20369,970,1036,2006
2020,Oaxaca,20,Santa Catarina Quioquitani,20074,264,290,554
2020,Oaxaca,20,Santa Catarina Tayata,20370,311,370,681
2020,Oaxaca,20,Santa Catarina Ticuá,20371,491,604,1095
2020,Oaxaca,20,Santa Catarina Yosonotú,20372,788,953,1741
2020,Oaxaca,20,Santa Catarina Zapoquila,20373,178,206,384
2020,Oaxaca,20,Santa Cruz Acatepec,20374,778,847,1625
2020,Oaxaca,20,Santa Cruz Amilpas,20375,6353,7330,13683
2020,Oaxaca,20,Santa Cruz Itundujia,20377,5744,6217,11961
2020,Oaxaca,20,Santa Cruz Mixtepec,20378,1737,1917,3654
2020,Oaxaca,20,Santa Cruz Nundaco,20379,1410,1653,3063
2020,Oaxaca,20,Santa Cruz Papalutla,20380,1084,1149,2233
2020,Oaxaca,20,Santa Cruz Tacache de Mina,20381,1327,1461,2788
2020,Oaxaca,20,Santa Cruz Tacahua,20382,540,611,1151
2020,Oaxaca,20,Santa Cruz Tayata,20383,308,316,624
2020,Oaxaca,20,Santa Cruz Xitla,20384,2349,2620,4969
2020,Oaxaca,20,Santa Cruz Xoxocotlán,20385,46655,52315,98970
2020,Oaxaca,20,Santa Cruz Zenzontepec,20386,9288,9738,19026
2020,Oaxaca,20,Santa Cruz de Bravo,20376,182,195,377
2020,Oaxaca,20,Santa Gertrudis,20387,1421,1523,2944
2020,Oaxaca,20,Santa Inés Yatzeche,20389,402,543,945
2020,Oaxaca,20,Santa Inés de Zaragoza,20569,781,891,1672
2020,Oaxaca,20,Santa Inés del Monte,20388,1216,1271,2487
2020,Oaxaca,20,Santa Lucía Miahuatlán,20391,1731,1817,3548
2020,Oaxaca,20,Santa Lucía Monteverde,20392,3194,3485,6679
2020,Oaxaca,20,Santa Lucía Ocotlán,20393,1824,2161,3985
2020,Oaxaca,20,Santa Lucía del Camino,20390,25037,27082,52119
2020,Oaxaca,20,Santa Magdalena Jicotlán,20047,43,52,95
2020,Oaxaca,20,Santa María Alotepec,20394,1432,1466,2898
2020,Oaxaca,20,Santa María Apazco,20395,793,990,1783
2020,Oaxaca,20,Santa María Atzompa,20399,17932,19274,37206
2020,Oaxaca,20,Santa María Camotlán,20400,780,903,1683
2020,Oaxaca,20,Santa María Chachoápam,20404,359,410,769
2020,Oaxaca,20,Santa María Chilchotla,20406,10323,10708,21031
2020,Oaxaca,20,Santa María Chimalapa,20407,4762,4618,9380
2020,Oaxaca,20,Santa María Colotepec,20401,12500,12679,25179
2020,Oaxaca,20,Santa María Cortijo,20402,532,572,1104
2020,Oaxaca,20,Santa María Coyotepec,20403,1546,1709,3255
2020,Oaxaca,20,Santa María Ecatepec,20410,1736,1772,3508
2020,Oaxaca,20,Santa María Guelacé,20411,384,471,855
2020,Oaxaca,20,Santa María Guienagati,20412,1638,1639,3277
2020,Oaxaca,20,Santa María Huatulco,20413,22925,23893,46818
2020,Oaxaca,20,Santa María Huazolotitlán,20414,5824,6026,11850
2020,Oaxaca,20,Santa María Ipalapa,20415,2432,2713,5145
2020,Oaxaca,20,Santa María Ixcatlán,20416,239,269,508
2020,Oaxaca,20,Santa María Jacatepec,20417,4545,5080,9625
2020,Oaxaca,20,Santa María Jalapa del Marqués,20418,6608,7008,13616
2020,Oaxaca,20,Santa María Jaltianguis,20419,244,293,537
2020,Oaxaca,20,Santa María Lachixío,20420,929,1081,2010
2020,Oaxaca,20,Santa María Mixtequilla,20421,2352,2485,4837
2020,Oaxaca,20,Santa María Nativitas,20422,284,339,623
2020,Oaxaca,20,Santa María Nduayaco,20423,255,254,509
2020,Oaxaca,20,Santa María Ozolotepec,20424,1923,2047,3970
2020,Oaxaca,20,Santa María Petapa,20427,8263,8849,17112
2020,Oaxaca,20,Santa María Peñoles,20426,4284,4497,8781
2020,Oaxaca,20,Santa María Pápalo,20425,1104,1098,2202
2020,Oaxaca,20,Santa María Quiegolani,20428,1005,992,1997
2020,Oaxaca,20,Santa María Sola,20429,726,793,1519
2020,Oaxaca,20,Santa María Tataltepec,20430,186,200,386
2020,Oaxaca,20,Santa María Tecomavaca,20431,840,904,1744
2020,Oaxaca,20,Santa María Temaxcalapa,20432,465,492,957
2020,Oaxaca,20,Santa María Temaxcaltepec,20433,1265,1422,2687
2020,Oaxaca,20,Santa María Teopoxco,20434,2075,2344,4419
2020,Oaxaca,20,Santa María Tepantlali,20435,1914,1988,3902
2020,Oaxaca,20,Santa María Texcatitlán,20436,491,537,1028
2020,Oaxaca,20,Santa María Tlahuitoltepec,20437,4671,4961,9632
2020,Oaxaca,20,Santa María Tlalixtac,20438,853,907,1760
2020,Oaxaca,20,Santa María Tonameca,20439,13059,13324,26383
2020,Oaxaca,20,Santa María Totolapilla,20440,406,452,858
2020,Oaxaca,20,Santa María Xadani,20441,4601,4523,9124
2020,Oaxaca,20,Santa María Yalina,20442,132,156,288
2020,Oaxaca,20,Santa María Yavesía,20443,229,281,510
2020,Oaxaca,20,Santa María Yolotepec,20444,203,223,426
2020,Oaxaca,20,Santa María Yosoyúa,20445,857,842,1699
2020,Oaxaca,20,Santa María Yucuhiti,20446,3100,3375,6475
2020,Oaxaca,20,Santa María Zacatepec,20447,7770,8768,16538
2020,Oaxaca,20,Santa María Zaniza,20448,1108,1178,2286
2020,Oaxaca,20,Santa María Zoquitlán,20449,1541,1587,3128
2020,Oaxaca,20,Santa María del Rosario,20408,267,247,514
2020,Oaxaca,20,Santa María del Tule,20409,4388,5021,9409
2020,Oaxaca,20,Santa María la Asunción,20396,1498,1886,3384
2020,Oaxaca,20,Santiago Amoltepec,20450,6354,6760,13114
2020,Oaxaca,20,Santiago Apoala,20451,428,500,928
2020,Oaxaca,20,Santiago Apóstol,20452,1832,2276,4108
2020,Oaxaca,20,Santiago Astata,20453,2044,2069,4113
2020,Oaxaca,20,Santiago Atitlán,20454,1593,1535,3128
2020,Oaxaca,20,Santiago Ayuquililla,20455,1334,1469,2803
2020,Oaxaca,20,Santiago Cacaloxtepec,20456,800,874,1674
2020,Oaxaca,20,Santiago Camotlán,20457,1631,1648,3279
2020,Oaxaca,20,Santiago Chazumba,20459,2062,2565,4627
2020,Oaxaca,20,Santiago Choápam,20460,2581,2757,5338
2020,Oaxaca,20,Santiago Comaltepec,20458,470,520,990
2020,Oaxaca,20,Santiago Huajolotitlán,20462,1970,2351,4321
2020,Oaxaca,20,Santiago Huauclilla,20463,259,286,545
2020,Oaxaca,20,Santiago Ihuitlán Plumas,20464,166,207,373
2020,Oaxaca,20,Santiago Ixcuintepec,20465,826,849,1675
2020,Oaxaca,20,Santiago Ixtayutla,20466,6478,6841,13319
2020,Oaxaca,20,Santiago Jamiltepec,20467,9478,10260,19738
2020,Oaxaca,20,Santiago Jocotepec,20468,7136,7338,14474
2020,Oaxaca,20,Santiago Juxtlahuaca,20469,17727,19617,37344
2020,Oaxaca,20,Santiago Lachiguiri,20470,2405,2457,4862
2020,Oaxaca,20,Santiago Lalopa,20471,249,268,517
2020,Oaxaca,20,Santiago Laollaga,20472,1755,1769,3524
2020,Oaxaca,20,Santiago Laxopa,20473,642,715,1357
2020,Oaxaca,20,Santiago Llano Grande,20474,1690,1708,3398
2020,Oaxaca,20,Santiago Matatlán,20475,4806,5446,10252
2020,Oaxaca,20,Santiago Miltepec,20476,212,213,425
2020,Oaxaca,20,Santiago Minas,20477,708,732,1440
2020,Oaxaca,20,Santiago Nacaltepec,20478,859,961,1820
2020,Oaxaca,20,Santiago Nejapilla,20479,112,99,211
2020,Oaxaca,20,Santiago Niltepec,20066,2765,2807,5572
2020,Oaxaca,20,Santiago Nundiche,20480,450,495,945
2020,Oaxaca,20,Santiago Nuyoó,20481,858,947,1805
2020,Oaxaca,20,Santiago Pinotepa Nacional,20482,26981,28254,55235
2020,Oaxaca,20,Santiago Suchilquitongo,20483,5273,5677,10950
2020,Oaxaca,20,Santiago Tamazola,20484,2150,2473,4623
2020,Oaxaca,20,Santiago Tapextla,20485,1613,1569,3182
2020,Oaxaca,20,Santiago Tenango,20487,1063,1053,2116
2020,Oaxaca,20,Santiago Tepetlapa,20488,59,68,127
2020,Oaxaca,20,Santiago Tetepec,20489,2516,2571,5087
2020,Oaxaca,20,Santiago Texcalcingo,20490,1552,1662,3214
2020,Oaxaca,20,Santiago Textitlán,20491,2278,2288,4566
2020,Oaxaca,20,Santiago Tilantongo,20492,1388,1626,3014
2020,Oaxaca,20,Santiago Tillo,20493,262,300,562
2020,Oaxaca,20,Santiago Tlazoyaltepec,20494,2235,2669,4904
2020,Oaxaca,20,Santiago Xanica,20495,1556,1550,3106
2020,Oaxaca,20,Santiago Xiacuí,20496,1025,1128,2153
2020,Oaxaca,20,Santiago Yaitepec,20497,2056,2414,4470
2020,Oaxaca,20,Santiago Yaveo,20498,3560,3544,7104
2020,Oaxaca,20,Santiago Yolomécatl,20499,1015,1196,2211
2020,Oaxaca,20,Santiago Yosondúa,20500,4089,4583,8672
2020,Oaxaca,20,Santiago Yucuyachi,20501,454,492,946
2020,Oaxaca,20,Santiago Zacatepec,20502,2699,2773,5472
2020,Oaxaca,20,Santiago Zoochila,20503,189,213,402
2020,Oaxaca,20,Santiago del Río,20461,269,291,560
2020,Oaxaca,20,Santo Domingo Albarradas,20506,369,427,796
2020,Oaxaca,20,Santo Domingo Armenta,20507,1753,1772,3525
2020,Oaxaca,20,Santo Domingo Chihuitán,20508,776,798,1574
2020,Oaxaca,20,Santo Domingo Ingenio,20505,4152,4148,8300
2020,Oaxaca,20,Santo Domingo Ixcatlán,20510,316,369,685
2020,Oaxaca,20,Santo Domingo Nuxaá,20511,1615,1728,3343
2020,Oaxaca,20,Santo Domingo Ozolotepec,20512,406,444,850
2020,Oaxaca,20,Santo Domingo Petapa,20513,4779,4716,9495
2020,Oaxaca,20,Santo Domingo Roayaga,20514,506,552,1058
2020,Oaxaca,20,Santo Domingo Tehuantepec,20515,33148,34904,68052
2020,Oaxaca,20,Santo Domingo Teojomulco,20516,2512,2660,5172
2020,Oaxaca,20,Santo Domingo Tepuxtepec,20517,2754,3117,5871
2020,Oaxaca,20,Santo Domingo Tlatayápam,20518,65,77,142
2020,Oaxaca,20,Santo Domingo Tomaltepec,20519,1515,1564,3079
2020,Oaxaca,20,Santo Domingo Tonaltepec,20521,110,141,251
2020,Oaxaca,20,Santo Domingo Tonalá,20520,3425,3785,7210
2020,Oaxaca,20,Santo Domingo Xagacía,20522,558,645,1203
2020,Oaxaca,20,Santo Domingo Yanhuitlán,20523,763,855,1618
2020,Oaxaca,20,Santo Domingo Yodohino,20524,150,162,312
2020,Oaxaca,20,Santo Domingo Zanatepec,20525,6292,6349,12641
2020,Oaxaca,20,Santo Domingo de Morelos,20509,5449,6080,11529
2020,Oaxaca,20,Santo Tomás Jalieza,20530,1770,1954,3724
2020,Oaxaca,20,Santo Tomás Mazaltepec,20531,1307,1438,2745
2020,Oaxaca,20,Santo Tomás Ocotepec,20532,1829,2098,3927
2020,Oaxaca,20,Santo Tomás Tamazulapan,20533,1128,1201,2329
2020,Oaxaca,20,Santos Reyes Nopala,20526,8859,9414,18273
2020,Oaxaca,20,Santos Reyes Pápalo,20527,1319,1422,2741
2020,Oaxaca,20,Santos Reyes Tepejillo,20528,431,592,1023
2020,Oaxaca,20,Santos Reyes Yucuná,20529,671,681,1352
2020,Oaxaca,20,Silacayoápam,20537,3219,3653,6872
2020,Oaxaca,20,Sitio de Xitlapehua,20538,337,378,715
2020,Oaxaca,20,Soledad Etla,20539,2894,3036,5930
2020,Oaxaca,20,Tamazulápam del Espíritu Santo,20031,3491,4186,7677
2020,Oaxaca,20,Tanetze de Zaragoza,20541,818,884,1702
2020,Oaxaca,20,Taniche,20542,375,458,833
2020,Oaxaca,20,Tataltepec de Valdés,20543,2934,3065,5999
2020,Oaxaca,20,Teococuilco de Marcos Pérez,20544,447,534,981
2020,Oaxaca,20,Teotitlán de Flores Magón,20545,4910,5428,10338
2020,Oaxaca,20,Teotitlán del Valle,20546,2884,3198,6082
2020,Oaxaca,20,Teotongo,20547,450,536,986
2020,Oaxaca,20,Tepelmeme Villa de Morelos,20548,775,925,1700
2020,Oaxaca,20,Tlacolula de Matamoros,20551,11312,12715,24027
2020,Oaxaca,20,Tlacotepec Plumas,20552,222,244,466
2020,Oaxaca,20,Tlalixtac de Cabrera,20553,5182,5730,10912
2020,Oaxaca,20,Totontepec Villa de Morelos,20554,2677,2900,5577
2020,Oaxaca,20,Trinidad Zaachila,20555,1466,1627,3093
2020,Oaxaca,20,Unión Hidalgo,20557,7797,8264,16061
2020,Oaxaca,20,Valerio Trujano,20558,658,806,1464
2020,Oaxaca,20,Villa Díaz Ordaz,20560,3188,3792,6980
2020,Oaxaca,20,Villa Hidalgo,20038,963,1058,2021
2020,Oaxaca,20,Villa Sola de Vega,20277,6282,6421,12703
2020,Oaxaca,20,Villa Talea de Castro,20280,1130,1238,2368
2020,Oaxaca,20,Villa Tejúpam de la Unión,20486,1236,1321,2557
2020,Oaxaca,20,Villa Tezoatlán de Segura y Luna,20549,5239,6160,11399
2020,Oaxaca,20,Villa de Chilapa de Díaz,20405,973,1240,2213
2020,Oaxaca,20,Villa de Etla,20338,5456,5970,11426
2020,Oaxaca,20,Villa de Tamazulápam del Progreso,20540,3794,4230,8024
2020,Oaxaca,20,Villa de Tututepec de Melchor Ocampo,20334,23135,24146,47281
2020,Oaxaca,20,Villa de Zaachila,20565,22397,24449,46846
2020,Oaxaca,20,Yaxe,20561,1410,1525,2935
2020,Oaxaca,20,Yogana,20563,590,700,1290
2020,Oaxaca,20,Yutanduchi de Guerrero,20564,568,632,1200
2020,Oaxaca,20,Zapotitlán Lagunas,20567,1540,1728,3268
2020,Oaxaca,20,Zapotitlán Palmas,20568,667,827,1494
2020,Oaxaca,20,Zimatlán de Álvarez,20570,9780,11112,20892
2020,Oaxaca,20,Ánimas Trujano,20174,1999,2208,4207
2020,Puebla,21,Acajete,21001,33468,35608,69076
2020,Puebla,21,Acateno,21002,4873,4827,9700
2020,Puebla,21,Acatlán,21003,17439,20279,37718
2020,Puebla,21,Acatzingo,21004,30654,31823,62477
2020,Puebla,21,Acteopan,21005,1469,1663,3132
2020,Puebla,21,Ahuacatlán,21006,7975,8778,16753
2020,Puebla,21,Ahuatlán,21007,1651,1777,3428
2020,Puebla,21,Ahuazotepec,21008,5950,6132,12082
2020,Puebla,21,Ahuehuetitla,21009,880,1013,1893
2020,Puebla,21,Ajalpan,21010,34108,35982,70090
2020,Puebla,21,Albino Zertuche,21011,879,1028,1907
2020,Puebla,21,Aljojuca,21012,3285,3635,6920
2020,Puebla,21,Altepexi,21013,11017,11561,22578
2020,Puebla,21,Amixtlán,21014,2492,2753,5245
2020,Puebla,21,Amozoc,21015,61687,64274,125961
2020,Puebla,21,Aquixtla,21016,4592,4604,9196
2020,Puebla,21,Atempan,21017,14232,15820,30052
2020,Puebla,21,Atexcal,21018,1929,2076,4005
2020,Puebla,21,Atlequizayan,21080,1327,1490,2817
2020,Puebla,21,Atlixco,21019,67970,75933,143903
2020,Puebla,21,Atoyatempan,21020,3592,3826,7418
2020,Puebla,21,Atzala,21021,660,730,1390
2020,Puebla,21,Atzitzihuacán,21022,6019,6931,12950
2020,Puebla,21,Atzitzintla,21023,4799,4928,9727
2020,Puebla,21,Axutla,21024,453,528,981
2020,Puebla,21,Ayotoxco de Guerrero,21025,4475,4630,9105
2020,Puebla,21,Calpan,21026,7288,8057,15345
2020,Puebla,21,Caltepec,21027,1936,2212,4148
2020,Puebla,21,Camocuautla,21028,1381,1408,2789
2020,Puebla,21,Caxhuacan,21029,1878,2054,3932
2020,Puebla,21,Cañada Morelos,21099,9892,10550,20442
2020,Puebla,21,Chalchicomula de Sesma,21045,24067,26100,50167
2020,Puebla,21,Chapulco,21046,3986,4268,8254
2020,Puebla,21,Chiautla,21047,10234,10893,21127
2020,Puebla,21,Chiautzingo,21048,10235,11257,21492
2020,Puebla,21,Chichiquila,21050,13321,14087,27408
2020,Puebla,21,Chiconcuautla,21049,8643,8982,17625
2020,Puebla,21,Chietla,21051,17607,18907,36514
2020,Puebla,21,Chigmecatitlán,21052,578,681,1259
2020,Puebla,21,Chignahuapan,21053,32580,33758,66338
2020,Puebla,21,Chignautla,21054,17602,18642,36244
2020,Puebla,21,Chila,21055,2281,2581,4862
2020,Puebla,21,Chila de la Sal,21056,725,773,1498
2020,Puebla,21,Chilchotla,21058,10507,10477,20984
2020,Puebla,21,Chinantla,21059,1132,1276,2408
2020,Puebla,21,Coatepec,21030,376,419,795
2020,Puebla,21,Coatzingo,21031,1482,1637,3119
2020,Puebla,21,Cohetzala,21032,714,701,1415
2020,Puebla,21,Cohuecan,21033,2472,2702,5174
2020,Puebla,21,Coronango,21034,21164,21987,43151
2020,Puebla,21,Coxcatlán,21035,10404,11423,21827
2020,Puebla,21,Coyomeapan,21036,7098,7742,14840
2020,Puebla,21,Coyotepec,21037,1131,1318,2449
2020,Puebla,21,Cuapiaxtla de Madero,21038,5316,5370,10686
2020,Puebla,21,Cuautempan,21039,4769,5117,9886
2020,Puebla,21,Cuautinchán,21040,5429,5489,10918
2020,Puebla,21,Cuautlancingo,21041,61630,65151,126781
2020,Puebla,21,Cuayuca de Andrade,21042,1592,1704,3296
2020,Puebla,21,Cuetzalan del Progreso,21043,25025,26213,51238
2020,Puebla,21,Cuyoaco,21044,8015,8673,16688
2020,Puebla,21,Domingo Arenas,21060,3760,4176,7936
2020,Puebla,21,Eloxochitlán,21061,6570,6901,13471
2020,Puebla,21,Epatlán,21062,2483,2617,5100
2020,Puebla,21,Esperanza,21063,7634,8160,15794
2020,Puebla,21,Francisco Z. Mena,21064,9062,8922,17984
2020,Puebla,21,General Felipe Ángeles,21065,10520,11373,21893
2020,Puebla,21,Guadalupe,21066,2839,3282,6121
2020,Puebla,21,Guadalupe Victoria,21067,8790,9262,18052
2020,Puebla,21,Hermenegildo Galeana,21068,4051,4106,8157
2020,Puebla,21,Honey,21057,3994,4369,8363
2020,Puebla,21,Huaquechula,21069,12310,14000,26310
2020,Puebla,21,Huatlatlauca,21070,3120,3728,6848
2020,Puebla,21,Huauchinango,21071,52953,58436,111389
2020,Puebla,21,Huehuetla,21072,9707,9956,19663
2020,Puebla,21,Huehuetlán el Chico,21073,4372,4617,8989
2020,Puebla,21,Huehuetlán el Grande,21150,3709,3939,7648
2020,Puebla,21,Huejotzingo,21074,38274,40129,78403
2020,Puebla,21,Hueyapan,21075,6582,6977,13559
2020,Puebla,21,Hueytamalco,21076,13731,14063,27794
2020,Puebla,21,Hueytlalpan,21077,2820,2965,5785
2020,Puebla,21,Huitzilan de Serdán,21078,8056,7870,15926
2020,Puebla,21,Huitziltepec,21079,2793,3014,5807
2020,Puebla,21,Ixcamilpa de Guerrero,21081,1800,1998,3798
2020,Puebla,21,Ixcaquixtla,21082,4495,4916,9411
2020,Puebla,21,Ixtacamaxtitlán,21083,12715,13057,25772
2020,Puebla,21,Ixtepec,21084,3644,3857,7501
2020,Puebla,21,Izúcar de Matamoros,21085,39040,43413,82453
2020,Puebla,21,Jalpan,21086,6173,6657,12830
2020,Puebla,21,Jolalpan,21087,6624,7190,13814
2020,Puebla,21,Jonotla,21088,2368,2465,4833
2020,Puebla,21,Jopala,21089,6735,7053,13788
2020,Puebla,21,Juan C. Bonilla,21090,10784,11771,22555
2020,Puebla,21,Juan Galindo,21091,5343,6079,11422
2020,Puebla,21,Juan N. Méndez,21092,2758,2820,5578
2020,Puebla,21,La Magdalena Tlatlauquitepec,21095,299,295,594
2020,Puebla,21,Lafragua,21093,4063,4180,8243
2020,Puebla,21,Libres,21094,17538,18472,36010
2020,Puebla,21,Los Reyes de Juárez,21118,14338,14833,29171
2020,Puebla,21,Mazapiltepec de Juárez,21096,1490,1515,3005
2020,Puebla,21,Mixtla,21097,1186,1315,2501
2020,Puebla,21,Molcaxac,21098,3085,3489,6574
2020,Puebla,21,Naupan,21100,5020,5474,10494
2020,Puebla,21,Nauzontla,21101,1717,1927,3644
2020,Puebla,21,Nealtican,21102,6324,6866,13190
2020,Puebla,21,Nicolás Bravo,21103,3233,3439,6672
2020,Puebla,21,Nopalucan,21104,16301,16726,33027
2020,Puebla,21,Ocotepec,21105,2429,2637,5066
2020,Puebla,21,Ocoyucan,21106,14063,15913,29976
2020,Puebla,21,Olintla,21107,6041,6331,12372
2020,Puebla,21,Oriental,21108,9410,9942,19352
2020,Puebla,21,Pahuatlán,21109,11055,12247,23302
2020,Puebla,21,Palmar de Bravo,21110,24196,24739,48935
2020,Puebla,21,Pantepec,21111,9468,10046,19514
2020,Puebla,21,Petlalcingo,21112,4778,5461,10239
2020,Puebla,21,Piaxtla,21113,2227,2404,4631
2020,Puebla,21,Puebla,21114,814758,883751,1698509
2020,Puebla,21,Quecholac,21115,26506,27506,54012
2020,Puebla,21,Quimixtlán,21116,11528,11801,23329
2020,Puebla,21,Rafael Lara Grajales,21117,7108,7646,14754
2020,Puebla,21,San Andrés Cholula,21119,76216,77976,154192
2020,Puebla,21,San Antonio Cañada,21120,2770,3101,5871
2020,Puebla,21,San Diego la Mesa Tochimiltzingo,21121,628,639,1267
2020,Puebla,21,San Felipe Teotlalcingo,21122,5336,5689,11025
2020,Puebla,21,San Felipe Tepatlán,21123,2035,2108,4143
2020,Puebla,21,San Gabriel Chilac,21124,7937,8764,16701
2020,Puebla,21,San Gregorio Atzompa,21125,4659,4949,9608
2020,Puebla,21,San Jerónimo Tecuanipan,21126,3158,3481,6639
2020,Puebla,21,San Jerónimo Xayacatlán,21127,1710,1965,3675
2020,Puebla,21,San José Chiapa,21128,4601,4708,9309
2020,Puebla,21,San José Miahuatlán,21129,6760,7388,14148
2020,Puebla,21,San Juan Atenco,21130,1641,1904,3545
2020,Puebla,21,San Juan Atzompa,21131,481,458,939
2020,Puebla,21,San Martín Texmelucan,21132,78478,83960,162438
2020,Puebla,21,San Martín Totoltepec,21133,324,350,674
2020,Puebla,21,San Matías Tlalancaleca,21134,10634,11010,21644
2020,Puebla,21,San Miguel Ixitlán,21135,252,285,537
2020,Puebla,21,San Miguel Xoxtla,21136,6481,6829,13310
2020,Puebla,21,San Nicolás Buenos Aires,21137,5131,5360,10491
2020,Puebla,21,San Nicolás de los Ranchos,21138,6073,6357,12430
2020,Puebla,21,San Pablo Anicano,21139,1804,1974,3778
2020,Puebla,21,San Pedro Cholula,21140,67073,72562,139635
2020,Puebla,21,San Pedro Yeloixtlahuaca,21141,1688,1832,3520
2020,Puebla,21,San Salvador Huixcolotla,21144,7859,8001,15860
2020,Puebla,21,San Salvador el Seco,21142,15718,16512,32230
2020,Puebla,21,San Salvador el Verde,21143,16429,17014,33443
2020,Puebla,21,San Sebastián Tlacotepec,21145,7322,7412,14734
2020,Puebla,21,Santa Catarina Tlaltempan,21146,429,424,853
2020,Puebla,21,Santa Inés Ahuatempan,21147,3209,3503,6712
2020,Puebla,21,Santa Isabel Cholula,21148,4519,4906,9425
2020,Puebla,21,Santiago Miahuatlán,21149,13241,13935,27176
2020,Puebla,21,Santo Tomás Hueyotlipan,21151,4378,4722,9100
2020,Puebla,21,Soltepec,21152,6370,6692,13062
2020,Puebla,21,Tecali de Herrera,21153,11453,12065,23518
2020,Puebla,21,Tecamachalco,21154,39761,42169,81930
2020,Puebla,21,Tecomatlán,21155,2969,3083,6052
2020,Puebla,21,Tehuacán,21156,160694,178383,339077
2020,Puebla,21,Tehuitzingo,21157,5620,6245,11865
2020,Puebla,21,Tenampulco,21158,3695,3832,7527
2020,Puebla,21,Teopantlán,21159,1752,2186,3938
2020,Puebla,21,Teotlalco,21160,1626,1710,3336
2020,Puebla,21,Tepanco de López,21161,10358,11463,21821
2020,Puebla,21,Tepango de Rodríguez,21162,2057,2292,4349
2020,Puebla,21,Tepatlaxco de Hidalgo,21163,8994,9476,18470
2020,Puebla,21,Tepeaca,21164,41078,44516,85594
2020,Puebla,21,Tepemaxalco,21165,559,599,1158
2020,Puebla,21,Tepeojuma,21166,4158,4845,9003
2020,Puebla,21,Tepetzintla,21167,5824,6234,12058
2020,Puebla,21,Tepexco,21168,3499,3697,7196
2020,Puebla,21,Tepexi de Rodríguez,21169,11240,11168,22408
2020,Puebla,21,Tepeyahualco,21170,8925,9082,18007
2020,Puebla,21,Tepeyahualco de Cuauhtémoc,21171,1808,1986,3794
2020,Puebla,21,Tetela de Ocampo,21172,14362,15405,29767
2020,Puebla,21,Teteles de Ávila Castillo,21173,2893,3390,6283
2020,Puebla,21,Teziutlán,21174,49703,55203,104906
2020,Puebla,21,Tianguismanalco,21175,6438,6958,13396
2020,Puebla,21,Tilapa,21176,4385,4709,9094
2020,Puebla,21,Tlachichuca,21179,15183,15780,30963
2020,Puebla,21,Tlacotepec de Benito Juárez,21177,26438,28770,55208
2020,Puebla,21,Tlacuilotepec,21178,8697,8990,17687
2020,Puebla,21,Tlahuapan,21180,21085,21352,42437
2020,Puebla,21,Tlaltenango,21181,3711,3774,7485
2020,Puebla,21,Tlanepantla,21182,2553,2746,5299
2020,Puebla,21,Tlaola,21183,10370,10966,21336
2020,Puebla,21,Tlapacoya,21184,3352,3508,6860
2020,Puebla,21,Tlapanalá,21185,4257,4703,8960
2020,Puebla,21,Tlatlauquitepec,21186,27286,29917,57203
2020,Puebla,21,Tlaxco,21187,2817,2848,5665
2020,Puebla,21,Tochimilco,21188,8970,10020,18990
2020,Puebla,21,Tochtepec,21189,10797,11654,22451
2020,Puebla,21,Totoltepec de Guerrero,21190,580,703,1283
2020,Puebla,21,Tulcingo,21191,4664,5329,9993
2020,Puebla,21,Tuzamapan de Galeana,21192,3304,3463,6767
2020,Puebla,21,Tzicatlacoyan,21193,3676,3751,7427
2020,Puebla,21,Venustiano Carranza,21194,15032,16151,31183
2020,Puebla,21,Vicente Guerrero,21195,12423,13487,25910
2020,Puebla,21,Xayacatlán de Bravo,21196,759,906,1665
2020,Puebla,21,Xicotepec,21197,41538,44531,86069
2020,Puebla,21,Xicotlán,21198,607,669,1276
2020,Puebla,21,Xiutetelco,21199,20593,22075,42668
2020,Puebla,21,Xochiapulco,21200,1727,1897,3624
2020,Puebla,21,Xochiltepec,21201,1586,1910,3496
2020,Puebla,21,Xochitlán Todos Santos,21203,3233,3586,6819
2020,Puebla,21,Xochitlán de Vicente Suárez,21202,6486,6917,13403
2020,Puebla,21,Yaonáhuac,21204,4052,4426,8478
2020,Puebla,21,Yehualtepec,21205,12874,13576,26450
2020,Puebla,21,Zacapala,21206,2199,2467,4666
2020,Puebla,21,Zacapoaxtla,21207,28045,30755,58800
2020,Puebla,21,Zacatlán,21208,41732,45960,87692
2020,Puebla,21,Zapotitlán,21209,4093,4886,8979
2020,Puebla,21,Zapotitlán de Méndez,21210,2942,2994,5936
2020,Puebla,21,Zaragoza,21211,7981,9303,17284
2020,Puebla,21,Zautla,21212,9505,10721,20226
2020,Puebla,21,Zihuateutla,21213,6844,7231,14075
2020,Puebla,21,Zinacatepec,21214,8629,9460,18089
2020,Puebla,21,Zongozotla,21215,2592,2648,5240
2020,Puebla,21,Zoquiapan,21216,1209,1374,2583
2020,Puebla,21,Zoquitlán,21217,9569,10130,19699
2020,Querétaro,22,Amealco de Bonfil,22001,33255,35186,68441
2020,Querétaro,22,Arroyo Seco,22003,7104,7685,14789
2020,Querétaro,22,Cadereyta de Montes,22004,36815,40014,76829
2020,Querétaro,22,Colón,22005,34910,34202,69112
2020,Querétaro,22,Corregidora,22006,101023,107053,208076
2020,Querétaro,22,El Marqués,22011,90008,88664,178672
2020,Querétaro,22,Ezequiel Montes,22007,22213,23664,45877
2020,Querétaro,22,Huimilpan,22008,20335,21970,42305
2020,Querétaro,22,Jalpan de Serra,22009,14148,15477,29625
2020,Querétaro,22,Landa de Matamoros,22010,9718,10595,20313
2020,Querétaro,22,Pedro Escobedo,22012,37952,38459,76411
2020,Querétaro,22,Peñamiller,22013,10843,11145,21988
2020,Querétaro,22,Pinal de Amoles,22002,13647,14542,28189
2020,Querétaro,22,Querétaro,22014,485198,491741,976939
2020,Querétaro,22,San Joaquín,22015,4825,5498,10323
2020,Querétaro,22,San Juan del Río,22016,148119,153422,301541
2020,Querétaro,22,Tequisquiapan,22017,38662,40080,78742
2020,Querétaro,22,Tolimán,22018,15437,16028,31465
2020,Quintana Roo,23,Bacalar,23010,22589,22494,45083
2020,Quintana Roo,23,Benito Juárez,23005,424818,419880,844698
2020,Quintana Roo,23,Cozumel,23001,50593,50513,101106
2020,Quintana Roo,23,Felipe Carrillo Puerto,23002,46770,46334,93104
2020,Quintana Roo,23,Isla Mujeres,23003,11988,11082,23070
2020,Quintana Roo,23,José María Morelos,23006,21957,20842,42799
2020,Quintana Roo,23,Lázaro Cárdenas,23007,16038,15347,31385
2020,Quintana Roo,23,Othón P. Blanco,23004,130108,135190,265298
2020,Quintana Roo,23,Solidaridad,23008,125345,114505,239850
2020,Quintana Roo,23,Tulum,23009,19365,17501,36866
2020,San Luis Potosí,24,Ahualulco,24001,8959,10061,19020
2020,San Luis Potosí,24,Alaquines,24002,4273,4409,8682
2020,San Luis Potosí,24,Aquismón,24003,25715,25169,50884
2020,San Luis Potosí,24,Armadillo de los Infante,24004,2116,2197,4313
2020,San Luis Potosí,24,Axtla de Terrazas,24053,19223,19648,38871
2020,San Luis Potosí,24,Catorce,24006,5193,5016,10209
2020,San Luis Potosí,24,Cedral,24007,9827,10271,20098
2020,San Luis Potosí,24,Cerritos,24008,11018,11704,22722
2020,San Luis Potosí,24,Cerro de San Pedro,24009,2405,2357,4762
2020,San Luis Potosí,24,Charcas,24015,10757,11161,21918
2020,San Luis Potosí,24,Ciudad Fernández,24011,23126,24401,47527
2020,San Luis Potosí,24,Ciudad Valles,24013,90796,96976,187772
2020,San Luis Potosí,24,Ciudad del Maíz,24010,17760,17965,35725
2020,San Luis Potosí,24,Coxcatlán,24014,8168,8056,16224
2020,San Luis Potosí,24,Cárdenas,24005,9447,10272,19719
2020,San Luis Potosí,24,Ebano,24016,22424,23297,45721
2020,San Luis Potosí,24,El Naranjo,24058,11626,11482,23108
2020,San Luis Potosí,24,Guadalcázar,24017,13984,13721,27705
2020,San Luis Potosí,24,Huehuetlán,24018,8241,8478,16719
2020,San Luis Potosí,24,Lagunillas,24019,2823,2952,5775
2020,San Luis Potosí,24,Matehuala,24020,50645,53573,104218
2020,San Luis Potosí,24,Matlapa,24057,16027,16127,32154
2020,San Luis Potosí,24,Mexquitic de Carmona,24021,28396,30985,59381
2020,San Luis Potosí,24,Moctezuma,24022,9748,10590,20338
2020,San Luis Potosí,24,Rayón,24023,7929,8366,16295
2020,San Luis Potosí,24,Rioverde,24024,47951,51031,98982
2020,San Luis Potosí,24,Salinas,24025,15979,17243,33222
2020,San Luis Potosí,24,San Antonio,24026,4985,4780,9765
2020,San Luis Potosí,24,San Ciro de Acosta,24027,5203,5590,10793
2020,San Luis Potosí,24,San Luis Potosí,24028,421020,449558,870578
2020,San Luis Potosí,24,San Martín Chalchicuautla,24029,10977,11112,22089
2020,San Luis Potosí,24,San Nicolás Tolentino,24030,2553,2843,5396
2020,San Luis Potosí,24,San Vicente Tancuayalab,24034,7740,7764,15504
2020,San Luis Potosí,24,Santa Catarina,24031,5973,6314,12287
2020,San Luis Potosí,24,Santa María del Río,24032,19915,21874,41789
2020,San Luis Potosí,24,Santo Domingo,24033,6256,6336,12592
2020,San Luis Potosí,24,Soledad de Graciano Sánchez,24035,160448,168501,328949
2020,San Luis Potosí,24,Tamasopo,24036,15935,15656,31591
2020,San Luis Potosí,24,Tamazunchale,24037,49668,50519,100187
2020,San Luis Potosí,24,Tampacán,24038,8154,8018,16172
2020,San Luis Potosí,24,Tampamolón Corona,24039,7959,8110,16069
2020,San Luis Potosí,24,Tamuín,24040,20118,20614,40732
2020,San Luis Potosí,24,Tancanhuitz,24012,10692,10982,21674
2020,San Luis Potosí,24,Tanlajás,24041,10409,10187,20596
2020,San Luis Potosí,24,Tanquián de Escobedo,24042,7764,8102,15866
2020,San Luis Potosí,24,Tierra Nueva,24043,4491,5105,9596
2020,San Luis Potosí,24,Vanegas,24044,4049,3983,8032
2020,San Luis Potosí,24,Venado,24045,7474,7752,15226
2020,San Luis Potosí,24,Villa Hidalgo,24051,7702,7850,15552
2020,San Luis Potosí,24,Villa Juárez,24052,5225,5380,10605
2020,San Luis Potosí,24,Villa de Arista,24056,7984,8072,16056
2020,San Luis Potosí,24,Villa de Arriaga,24046,9225,9377,18602
2020,San Luis Potosí,24,Villa de Guadalupe,24047,5104,5094,10198
2020,San Luis Potosí,24,Villa de Ramos,24049,18971,20066,39037
2020,San Luis Potosí,24,Villa de Reyes,24050,25634,25897,51531
2020,San Luis Potosí,24,Villa de la Paz,24048,2816,2784,5600
2020,San Luis Potosí,24,Xilitla,24054,26682,27569,54251
2020,San Luis Potosí,24,Zaragoza,24055,13389,13774,27163
2020,Sinaloa,25,Ahome,25001,236375,244279,480654
2020,Sinaloa,25,Angostura,25002,25369,25210,50579
2020,Sinaloa,25,Badiraguato,25003,16612,15410,32022
2020,Sinaloa,25,Choix,25007,17743,16804,34547
2020,Sinaloa,25,Concordia,25004,14912,14467,29379
2020,Sinaloa,25,Cosalá,25005,8818,8393,17211
2020,Sinaloa,25,Culiacán,25006,473128,489743,962871
2020,Sinaloa,25,El Fuerte,25010,54761,53490,108251
2020,Sinaloa,25,Elota,25008,30605,28452,59057
2020,Sinaloa,25,Escuinapa,25009,31807,30890,62697
2020,Sinaloa,25,Guasave,25011,156986,159231,316217
2020,Sinaloa,25,Mazatlán,25012,263769,269964,533733
2020,Sinaloa,25,Mocorito,25013,24867,23446,48313
2020,Sinaloa,25,Navolato,25018,81564,78481,160045
2020,Sinaloa,25,Rosario,25014,28999,27993,56992
2020,Sinaloa,25,Salvador Alvarado,25015,42471,44461,86932
2020,Sinaloa,25,San Ignacio,25016,11540,10733,22273
2020,Sinaloa,25,Sinaloa,25017,48097,46804,94901
2020,Sonora,26,Aconchi,26001,1589,1436,3025
2020,Sonora,26,Agua Prieta,26002,44578,43952,88530
2020,Sonora,26,Alamos,26003,14438,13484,27922
2020,Sonora,26,Altar,26004,5147,5162,10309
2020,Sonora,26,Arivechi,26005,656,628,1284
2020,Sonora,26,Arizpe,26006,1515,1443,2958
2020,Sonora,26,Atil,26007,327,311,638
2020,Sonora,26,Bacadéhuachi,26008,643,577,1220
2020,Sonora,26,Bacanora,26009,452,410,862
2020,Sonora,26,Bacerac,26010,791,746,1537
2020,Sonora,26,Bacoachi,26011,869,867,1736
2020,Sonora,26,Banámichi,26013,907,890,1797
2020,Sonora,26,Bavispe,26015,858,771,1629
2020,Sonora,26,Baviácora,26014,1887,1789,3676
2020,Sonora,26,Benito Juárez,26071,11930,11913,23843
2020,Sonora,26,Benjamín Hill,26016,2731,2849,5580
2020,Sonora,26,Bácum,26012,12528,12372,24900
2020,Sonora,26,Caborca,26017,46417,45760,92177
2020,Sonora,26,Cajeme,26018,229257,239737,468994
2020,Sonora,26,Cananea,26019,18843,19260,38103
2020,Sonora,26,Carbó,26020,2763,2542,5305
2020,Sonora,26,Cucurpe,26022,589,477,1066
2020,Sonora,26,Cumpas,26023,3393,3362,6755
2020,Sonora,26,Divisaderos,26024,415,402,817
2020,Sonora,26,Empalme,26025,30141,30490,60631
2020,Sonora,26,Etchojoa,26026,33875,32758,66633
2020,Sonora,26,Fronteras,26027,4761,4595,9356
2020,Sonora,26,General Plutarco Elías Calles,26070,9341,9140,18481
2020,Sonora,26,Granados,26028,593,577,1170
2020,Sonora,26,Guaymas,26029,84870,86165,171035
2020,Sonora,26,Hermosillo,26030,467181,478873,946054
2020,Sonora,26,Huachinera,26031,726,685,1411
2020,Sonora,26,Huatabampo,26033,43535,43383,86918
2020,Sonora,26,Huásabas,26032,524,466,990
2020,Sonora,26,Huépac,26034,559,532,1091
2020,Sonora,26,Imuris,26035,6953,6890,13843
2020,Sonora,26,La Colorada,26021,1174,948,2122
2020,Sonora,26,Magdalena,26036,16820,17076,33896
2020,Sonora,26,Mazatán,26037,705,619,1324
2020,Sonora,26,Moctezuma,26038,2669,2731,5400
2020,Sonora,26,Naco,26039,3395,3361,6756
2020,Sonora,26,Nacozari de García,26041,7126,7105,14231
2020,Sonora,26,Navojoa,26042,86714,90365,177079
2020,Sonora,26,Nogales,26043,126530,126956,253486
2020,Sonora,26,Nácori Chico,26040,1133,1039,2172
2020,Sonora,26,Onavas,26044,268,225,493
2020,Sonora,26,Opodepe,26045,1564,1385,2949
2020,Sonora,26,Oquitoa,26046,201,231,432
2020,Sonora,26,Pitiquito,26047,5238,4921,10159
2020,Sonora,26,Puerto Peñasco,26048,36775,35504,72279
2020,Sonora,26,Quiriego,26049,1667,1453,3120
2020,Sonora,26,Rayón,26050,864,789,1653
2020,Sonora,26,Rosario,26051,2861,2627,5488
2020,Sonora,26,Sahuaripa,26052,3149,2973,6122
2020,Sonora,26,San Felipe de Jesús,26053,228,221,449
2020,Sonora,26,San Ignacio Río Muerto,26072,8051,7626,15677
2020,Sonora,26,San Javier,26054,385,294,679
2020,Sonora,26,San Luis Río Colorado,26055,104035,102947,206982
2020,Sonora,26,San Miguel de Horcasitas,26056,5425,4645,10070
2020,Sonora,26,San Pedro de la Cueva,26057,881,767,1648
2020,Sonora,26,Santa Ana,26058,8783,9030,17813
2020,Sonora,26,Santa Cruz,26059,1000,1031,2031
2020,Sonora,26,Soyopa,26061,804,670,1474
2020,Sonora,26,Suaqui Grande,26062,662,560,1222
2020,Sonora,26,Sáric,26060,890,846,1736
2020,Sonora,26,Tepache,26063,790,725,1515
2020,Sonora,26,Trincheras,26064,964,799,1763
2020,Sonora,26,Tubutama,26065,681,648,1329
2020,Sonora,26,Ures,26066,4894,4683,9577
2020,Sonora,26,Villa Hidalgo,26067,879,814,1693
2020,Sonora,26,Villa Pesqueira,26068,687,576,1263
2020,Sonora,26,Yécora,26069,3214,3173,6387
2020,Tabasco,27,Balancán,27001,32113,32233,64346
2020,Tabasco,27,Centla,27003,58956,58946,117902
2020,Tabasco,27,Centro,27004,361924,377687,739611
2020,Tabasco,27,Comalcalco,27005,107259,110300,217559
2020,Tabasco,27,Cunduacán,27006,72965,75200,148165
2020,Tabasco,27,Cárdenas,27002,135558,140538,276096
2020,Tabasco,27,Emiliano Zapata,27007,15797,17195,32992
2020,Tabasco,27,Huimanguillo,27008,99080,101580,200660
2020,Tabasco,27,Jalapa,27009,20683,20584,41267
2020,Tabasco,27,Jalpa de Méndez,27010,46990,47262,94252
2020,Tabasco,27,Jonuta,27011,16493,16336,32829
2020,Tabasco,27,Macuspana,27012,86926,90121,177047
2020,Tabasco,27,Nacajuca,27013,73204,76052,149256
2020,Tabasco,27,Paraíso,27014,50770,51131,101901
2020,Tabasco,27,Tacotalpa,27015,26119,25986,52105
2020,Tabasco,27,Teapa,27016,30670,31778,62448
2020,Tabasco,27,Tenosique,27017,31073,32778,63851
2020,Tamaulipas,28,Abasolo,28001,6374,6394,12768
2020,Tamaulipas,28,Aldama,28002,15559,15327,30886
2020,Tamaulipas,28,Altamira,28003,127106,128496,255602
2020,Tamaulipas,28,Antiguo Morelos,28004,5184,5200,10384
2020,Tamaulipas,28,Burgos,28005,2459,2276,4735
2020,Tamaulipas,28,Bustamante,28006,4398,4048,8446
2020,Tamaulipas,28,Camargo,28007,8277,8055,16332
2020,Tamaulipas,28,Casas,28008,2316,2094,4410
2020,Tamaulipas,28,Ciudad Madero,28009,106671,116742,223413
2020,Tamaulipas,28,Cruillas,28010,1013,985,1998
2020,Tamaulipas,28,El Mante,28021,61046,64593,125639
2020,Tamaulipas,28,González,28012,23042,23332,46374
2020,Tamaulipas,28,Guerrero,28014,2475,2311,4786
2020,Tamaulipas,28,Gustavo Díaz Ordaz,28015,8422,8218,16640
2020,Tamaulipas,28,Gómez Farías,28011,4961,4728,9689
2020,Tamaulipas,28,Güémez,28013,8577,7947,16524
2020,Tamaulipas,28,Hidalgo,28016,12558,11946,24504
2020,Tamaulipas,28,Jaumave,28017,8311,8039,16350
2020,Tamaulipas,28,Jiménez,28018,4276,4262,8538
2020,Tamaulipas,28,Llera,28019,9087,8805,17892
2020,Tamaulipas,28,Mainero,28020,1361,1323,2684
2020,Tamaulipas,28,Matamoros,28022,269172,276943,546115
2020,Tamaulipas,28,Mier,28024,2174,2260,4434
2020,Tamaulipas,28,Miguel Alemán,28025,14460,14573,29033
2020,Tamaulipas,28,Miquihuana,28026,1997,1820,3817
2020,Tamaulipas,28,Méndez,28023,2165,1975,4140
2020,Tamaulipas,28,Nuevo Laredo,28027,210763,210532,421295
2020,Tamaulipas,28,Nuevo Morelos,28028,1954,1784,3738
2020,Tamaulipas,28,Ocampo,28029,7406,7118,14524
2020,Tamaulipas,28,Padilla,28030,7459,7349,14808
2020,Tamaulipas,28,Palmillas,28031,935,905,1840
2020,Tamaulipas,28,Reynosa,28032,343257,343413,686670
2020,Tamaulipas,28,Río Bravo,28033,66778,66428,133206
2020,Tamaulipas,28,San Carlos,28034,4955,4478,9433
2020,Tamaulipas,28,San Fernando,28035,29747,29468,59215
2020,Tamaulipas,28,San Nicolás,28036,583,517,1100
2020,Tamaulipas,28,Soto la Marina,28037,13546,12921,26467
2020,Tamaulipas,28,Tampico,28038,160435,174100,334535
2020,Tamaulipas,28,Tula,28039,15385,15500,30885
2020,Tamaulipas,28,Valle Hermoso,28040,33461,34504,67965
2020,Tamaulipas,28,Victoria,28041,179551,187500,367051
2020,Tamaulipas,28,Villagrán,28042,3389,3174,6563
2020,Tamaulipas,28,Xicoténcatl,28043,12585,12589,25174
2020,Tlaxcala,29,Acuamanala de Miguel Hidalgo,29022,3474,3460,6934
2020,Tlaxcala,29,Altzayanca,29004,9310,9268,18578
2020,Tlaxcala,29,Amaxac de Guerrero,29001,5926,6092,12018
2020,Tlaxcala,29,Apetatitlán de Antonio Carvajal,29002,7876,8390,16266
2020,Tlaxcala,29,Apizaco,29005,40651,44525,85176
2020,Tlaxcala,29,Atlangatepec,29003,3443,3587,7030
2020,Tlaxcala,29,Benito Juárez,29045,3180,3266,6446
2020,Tlaxcala,29,Calpulalpan,29006,25343,26623,51966
2020,Tlaxcala,29,Chiautempan,29010,37425,40010,77435
2020,Tlaxcala,29,Contla de Juan Cuamatzi,29018,20374,20893,41267
2020,Tlaxcala,29,Cuapiaxtla,29008,8197,8166,16363
2020,Tlaxcala,29,Cuaxomulco,29009,2846,2874,5720
2020,Tlaxcala,29,El Carmen Tequexquitla,29007,9030,9251,18281
2020,Tlaxcala,29,Emiliano Zapata,29046,2363,2473,4836
2020,Tlaxcala,29,Españita,29012,4662,4747,9409
2020,Tlaxcala,29,Huamantla,29013,49216,51031,100247
2020,Tlaxcala,29,Hueyotlipan,29014,7708,7870,15578
2020,Tlaxcala,29,Ixtacuixtla de Mariano Matamoros,29015,20349,21482,41831
2020,Tlaxcala,29,Ixtenco,29016,3738,4021,7759
2020,Tlaxcala,29,La Magdalena Tlaltelulco,29048,9628,10339,19967
2020,Tlaxcala,29,Lázaro Cárdenas,29047,1628,1654,3282
2020,Tlaxcala,29,Mazatecochco de José María Morelos,29017,5755,5846,11601
2020,Tlaxcala,29,Muñoz de Domingo Arenas,29011,2468,2437,4905
2020,Tlaxcala,29,Nanacamilpa de Mariano Arista,29021,9486,9916,19402
2020,Tlaxcala,29,Natívitas,29023,13196,14098,27294
2020,Tlaxcala,29,Panotla,29024,14020,14997,29017
2020,Tlaxcala,29,Papalotla de Xicohténcatl,29041,15773,16818,32591
2020,Tlaxcala,29,San Damián Texóloc,29049,3005,3017,6022
2020,Tlaxcala,29,San Francisco Tetlanohcan,29050,5635,5867,11502
2020,Tlaxcala,29,San Jerónimo Zacualpan,29051,1951,2156,4107
2020,Tlaxcala,29,San José Teacalco,29052,3136,3285,6421
2020,Tlaxcala,29,San Juan Huactzinco,29053,3853,4200,8053
2020,Tlaxcala,29,San Lorenzo Axocomanitla,29054,2911,3120,6031
2020,Tlaxcala,29,San Lucas Tecopilco,29055,1617,1711,3328
2020,Tlaxcala,29,San Pablo del Monte,29025,41206,41336,82542
2020,Tlaxcala,29,Sanctórum de Lázaro Cárdenas,29020,5244,5344,10588
2020,Tlaxcala,29,Santa Ana Nopalucan,29056,4105,4232,8337
2020,Tlaxcala,29,Santa Apolonia Teacalco,29057,2343,2601,4944
2020,Tlaxcala,29,Santa Catarina Ayometla,29058,4577,4923,9500
2020,Tlaxcala,29,Santa Cruz Quilehtla,29059,3832,3832,7664
2020,Tlaxcala,29,Santa Cruz Tlaxcala,29026,10861,11201,22062
2020,Tlaxcala,29,Santa Isabel Xiloxoxtla,29060,2620,2747,5367
2020,Tlaxcala,29,Tenancingo,29027,6856,7082,13938
2020,Tlaxcala,29,Teolocholco,29028,12660,13405,26065
2020,Tlaxcala,29,Tepetitla de Lardizábal,29019,10962,11771,22733
2020,Tlaxcala,29,Tepeyanco,29029,6890,7506,14396
2020,Tlaxcala,29,Terrenate,29030,8209,8121,16330
2020,Tlaxcala,29,Tetla de la Solidaridad,29031,17211,17655,34866
2020,Tlaxcala,29,Tetlatlahuca,29032,7403,7834,15237
2020,Tlaxcala,29,Tlaxcala,29033,49346,54089,103435
2020,Tlaxcala,29,Tlaxco,29034,22465,23261,45726
2020,Tlaxcala,29,Tocatlán,29035,3122,3184,6306
2020,Tlaxcala,29,Totolac,29036,11591,12570,24161
2020,Tlaxcala,29,Tzompantepec,29038,8972,9591,18563
2020,Tlaxcala,29,Xaloztoc,29039,12937,12847,25784
2020,Tlaxcala,29,Xaltocan,29040,5618,6009,11627
2020,Tlaxcala,29,Xicohtzinco,29042,7040,7730,14770
2020,Tlaxcala,29,Yauhquemehcan,29043,20248,21525,41773
2020,Tlaxcala,29,Zacatelco,29044,22606,24542,47148
2020,Tlaxcala,29,Ziltlaltépec de Trinidad Sánchez Santos,29037,4549,4937,9486
2020,Veracruz,30,Acajete,30001,4673,4458,9131
2020,Veracruz,30,Acatlán,30002,1646,1698,3344
2020,Veracruz,30,Acayucan,30003,43913,47282,91195
2020,Veracruz,30,Actopan,30004,22504,23314,45818
2020,Veracruz,30,Acula,30005,2849,2841,5690
2020,Veracruz,30,Acultzingo,30006,11759,12162,23921
2020,Veracruz,30,Agua Dulce,30204,24628,26052,50680
2020,Veracruz,30,Alpatláhuac,30008,5271,5292,10563
2020,Veracruz,30,Alto Lucero de Gutiérrez Barrios,30009,15404,15336,30740
2020,Veracruz,30,Altotonga,30010,33008,35332,68340
2020,Veracruz,30,Alvarado,30011,28032,28603,56635
2020,Veracruz,30,Amatitlán,30012,4144,4325,8469
2020,Veracruz,30,Amatlán de los Reyes,30014,23182,24825,48007
2020,Veracruz,30,Angel R. Cabada,30015,17456,18453,35909
2020,Veracruz,30,Apazapan,30017,2130,2158,4288
2020,Veracruz,30,Aquila,30018,952,1017,1969
2020,Veracruz,30,Astacinga,30019,3125,3560,6685
2020,Veracruz,30,Atlahuilco,30020,5528,5790,11318
2020,Veracruz,30,Atoyac,30021,12160,12880,25040
2020,Veracruz,30,Atzacan,30022,11044,11370,22414
2020,Veracruz,30,Atzalan,30023,26325,26506,52831
2020,Veracruz,30,Ayahualulco,30025,13937,14068,28005
2020,Veracruz,30,Banderilla,30026,11696,12996,24692
2020,Veracruz,30,Benito Juárez,30027,8994,9429,18423
2020,Veracruz,30,Boca del Río,30028,71930,80880,152810
2020,Veracruz,30,Calcahualco,30029,6771,6729,13500
2020,Veracruz,30,Camarón de Tejeda,30007,3415,3405,6820
2020,Veracruz,30,Camerino Z. Mendoza,30030,21164,23716,44880
2020,Veracruz,30,Carlos A. Carrillo,30208,12462,13529,25991
2020,Veracruz,30,Carrillo Puerto,30031,8734,9069,17803
2020,Veracruz,30,Castillo de Teayo,30157,10467,10285,20752
2020,Veracruz,30,Catemaco,30032,25215,26919,52134
2020,Veracruz,30,Cazones de Herrera,30033,12115,12843,24958
2020,Veracruz,30,Cerro Azul,30034,13523,15018,28541
2020,Veracruz,30,Chacaltianguis,30054,6364,6746,13110
2020,Veracruz,30,Chalma,30055,6953,7184,14137
2020,Veracruz,30,Chiconamel,30056,3399,3632,7031
2020,Veracruz,30,Chiconquiaco,30057,7352,7439,14791
2020,Veracruz,30,Chicontepec,30058,28596,30015,58611
2020,Veracruz,30,Chinameca,30059,8336,8739,17075
2020,Veracruz,30,Chinampa de Gorostiza,30060,8628,8864,17492
2020,Veracruz,30,Chocamán,30062,11000,11053,22053
2020,Veracruz,30,Chontla,30063,7580,7654,15234
2020,Veracruz,30,Chumatlán,30064,1992,2103,4095
2020,Veracruz,30,Citlaltépetl,30035,6092,6382,12474
2020,Veracruz,30,Coacoatzintla,30036,5357,5608,10965
2020,Veracruz,30,Coahuitlán,30037,4354,4498,8852
2020,Veracruz,30,Coatepec,30038,47266,50683,97949
2020,Veracruz,30,Coatzacoalcos,30039,164483,174625,339108
2020,Veracruz,30,Coatzintla,30040,29183,30680,59863
2020,Veracruz,30,Coetzala,30041,1172,1201,2373
2020,Veracruz,30,Colipa,30042,2891,3011,5902
2020,Veracruz,30,Comapa,30043,10798,10361,21159
2020,Veracruz,30,Cosamaloapan de Carpio,30045,28678,31192,59870
2020,Veracruz,30,Cosautlán de Carvajal,30046,8501,8606,17107
2020,Veracruz,30,Coscomatepec,30047,29970,30902,60872
2020,Veracruz,30,Cosoleacaque,30048,70455,75375,145830
2020,Veracruz,30,Cotaxtla,30049,10968,11004,21972
2020,Veracruz,30,Coxquihui,30050,8565,8941,17506
2020,Veracruz,30,Coyutla,30051,11327,12175,23502
2020,Veracruz,30,Cuichapa,30052,6106,6729,12835
2020,Veracruz,30,Cuitláhuac,30053,14147,15408,29555
2020,Veracruz,30,Córdoba,30044,107646,121057,228703
2020,Veracruz,30,El Higo,30205,10261,10339,20600
2020,Veracruz,30,Emiliano Zapata,30065,40682,43515,84197
2020,Veracruz,30,Espinal,30066,13933,14604,28537
2020,Veracruz,30,Filomeno Mata,30067,9757,9686,19443
2020,Veracruz,30,Fortín,30068,33418,37010,70428
2020,Veracruz,30,Gutiérrez Zamora,30069,12170,13704,25874
2020,Veracruz,30,Hidalgotitlán,30070,10019,9720,19739
2020,Veracruz,30,Huatusco,30071,30788,32861,63649
2020,Veracruz,30,Huayacocotla,30072,10942,11645,22587
2020,Veracruz,30,Hueyapan de Ocampo,30073,22067,23265,45332
2020,Veracruz,30,Huiloapan de Cuauhtémoc,30074,3691,3945,7636
2020,Veracruz,30,Ignacio de la Llave,30075,8752,9515,18267
2020,Veracruz,30,Ilamatlán,30076,6808,7432,14240
2020,Veracruz,30,Isla,30077,22220,23220,45440
2020,Veracruz,30,Ixcatepec,30078,7085,7063,14148
2020,Veracruz,30,Ixhuacán de los Reyes,30079,6059,5939,11998
2020,Veracruz,30,Ixhuatlancillo,30081,13124,14227,27351
2020,Veracruz,30,Ixhuatlán de Madero,30083,27606,28897,56503
2020,Veracruz,30,Ixhuatlán del Café,30080,11963,12017,23980
2020,Veracruz,30,Ixhuatlán del Sureste,30082,8286,8238,16524
2020,Veracruz,30,Ixmatlahuacan,30084,3004,3063,6067
2020,Veracruz,30,Ixtaczoquitlán,30085,35230,37326,72556
2020,Veracruz,30,Jalacingo,30086,22751,23702,46453
2020,Veracruz,30,Jalcomulco,30088,2712,2666,5378
2020,Veracruz,30,Jamapa,30090,5865,6106,11971
2020,Veracruz,30,Jesús Carranza,30091,15145,15244,30389
2020,Veracruz,30,Jilotepec,30093,8573,8999,17572
2020,Veracruz,30,José Azueta,30169,11826,12270,24096
2020,Veracruz,30,Juan Rodríguez Clara,30094,20309,20799,41108
2020,Veracruz,30,Juchique de Ferrer,30095,8245,8417,16662
2020,Veracruz,30,Jáltipan,30089,20967,22861,43828
2020,Veracruz,30,La Antigua,30016,13752,14729,28481
2020,Veracruz,30,La Perla,30127,14221,14738,28959
2020,Veracruz,30,Landero y Coss,30096,812,859,1671
2020,Veracruz,30,Las Choapas,30061,41817,43327,85144
2020,Veracruz,30,Las Minas,30107,1597,1533,3130
2020,Veracruz,30,Las Vigas de Ramírez,30132,10311,10356,20667
2020,Veracruz,30,Lerdo de Tejada,30097,9805,11182,20987
2020,Veracruz,30,Los Reyes,30137,3081,3119,6200
2020,Veracruz,30,Magdalena,30098,1615,1625,3240
2020,Veracruz,30,Maltrata,30099,9116,9729,18845
2020,Veracruz,30,Manlio Fabio Altamirano,30100,12237,12612,24849
2020,Veracruz,30,Mariano Escobedo,30101,18560,19943,38503
2020,Veracruz,30,Martínez de la Torre,30102,53338,57826,111164
2020,Veracruz,30,Mecatlán,30103,6387,6563,12950
2020,Veracruz,30,Mecayapan,30104,8567,8959,17526
2020,Veracruz,30,Medellín,30105,40020,43260,83280
2020,Veracruz,30,Miahuatlán,30106,2428,2500,4928
2020,Veracruz,30,Minatitlán,30108,79616,84741,164357
2020,Veracruz,30,Misantla,30109,33063,34689,67752
2020,Veracruz,30,Mixtla de Altamirano,30110,6163,6042,12205
2020,Veracruz,30,Moloacán,30111,8816,9301,18117
2020,Veracruz,30,Nanchital de Lázaro Cárdenas del Rio,30206,15176,16039,31215
2020,Veracruz,30,Naolinco,30112,11228,11728,22956
2020,Veracruz,30,Naranjal,30113,2336,2481,4817
2020,Veracruz,30,Naranjos Amatlán,30013,14288,15815,30103
2020,Veracruz,30,Nautla,30114,5655,5864,11519
2020,Veracruz,30,Nogales,30115,19015,20753,39768
2020,Veracruz,30,Oluta,30116,8327,8964,17291
2020,Veracruz,30,Omealca,30117,12159,13000,25159
2020,Veracruz,30,Orizaba,30118,61961,72459,134420
2020,Veracruz,30,Otatitlán,30119,2859,3112,5971
2020,Veracruz,30,Oteapan,30120,8399,8685,17084
2020,Veracruz,30,Ozuluama de Mascareñas,30121,12514,11956,24470
2020,Veracruz,30,Pajapan,30122,9125,9047,18172
2020,Veracruz,30,Papantla,30124,82430,84066,166496
2020,Veracruz,30,Paso de Ovejas,30126,17664,17781,35445
2020,Veracruz,30,Paso del Macho,30125,16491,16854,33345
2020,Veracruz,30,Perote,30128,38366,38611,76977
2020,Veracruz,30,Platón Sánchez,30129,9378,9754,19132
2020,Veracruz,30,Playa Vicente,30130,19023,20689,39712
2020,Veracruz,30,Poza Rica de Hidalgo,30131,103403,114370,217773
2020,Veracruz,30,Pueblo Viejo,30133,30558,30420,60978
2020,Veracruz,30,Puente Nacional,30134,11768,12122,23890
2020,Veracruz,30,Pánuco,30123,52791,53135,105926
2020,Veracruz,30,Rafael Delgado,30135,12038,12401,24439
2020,Veracruz,30,Rafael Lucio,30136,4141,4369,8510
2020,Veracruz,30,Río Blanco,30138,20965,23603,44568
2020,Veracruz,30,Saltabarranca,30139,3159,3367,6526
2020,Veracruz,30,San Andrés Tenejapan,30140,1520,1577,3097
2020,Veracruz,30,San Andrés Tuxtla,30141,83314,89835,173149
2020,Veracruz,30,San Juan Evangelista,30142,17498,18109,35607
2020,Veracruz,30,San Rafael,30211,15447,16017,31464
2020,Veracruz,30,Santiago Sochiapan,30212,7282,7755,15037
2020,Veracruz,30,Santiago Tuxtla,30143,29178,31364,60542
2020,Veracruz,30,Sayula de Alemán,30144,16884,17447,34331
2020,Veracruz,30,Sochiapa,30146,1925,1914,3839
2020,Veracruz,30,Soconusco,30145,8327,8756,17083
2020,Veracruz,30,Soledad Atzompa,30147,12090,12179,24269
2020,Veracruz,30,Soledad de Doblado,30148,14433,14717,29150
2020,Veracruz,30,Soteapan,30149,17737,18306,36043
2020,Veracruz,30,Tamalín,30150,6137,6096,12233
2020,Veracruz,30,Tamiahua,30151,12275,12184,24459
2020,Veracruz,30,Tampico Alto,30152,6774,6325,13099
2020,Veracruz,30,Tancoco,30153,2953,3119,6072
2020,Veracruz,30,Tantima,30154,6947,6715,13662
2020,Veracruz,30,Tantoyuca,30155,53965,55052,109017
2020,Veracruz,30,Tatahuicapan de Juárez,30209,7952,8296,16248
2020,Veracruz,30,Tatatila,30156,3228,2951,6179
2020,Veracruz,30,Tecolutla,30158,12488,12864,25352
2020,Veracruz,30,Tehuipango,30159,13243,14024,27267
2020,Veracruz,30,Tempoal,30161,18426,18984,37410
2020,Veracruz,30,Tenampa,30162,3466,3615,7081
2020,Veracruz,30,Tenochtitlán,30163,2614,2811,5425
2020,Veracruz,30,Teocelo,30164,8532,9019,17551
2020,Veracruz,30,Tepatlaxco,30165,4559,4329,8888
2020,Veracruz,30,Tepetlán,30166,5155,4992,10147
2020,Veracruz,30,Tepetzintla,30167,7614,7801,15415
2020,Veracruz,30,Tequila,30168,7862,8106,15968
2020,Veracruz,30,Texcatepec,30170,5629,5898,11527
2020,Veracruz,30,Texhuacán,30171,2660,2970,5630
2020,Veracruz,30,Texistepec,30172,10916,10882,21798
2020,Veracruz,30,Tezonapa,30173,29367,30021,59388
2020,Veracruz,30,Tierra Blanca,30174,53383,57428,110811
2020,Veracruz,30,Tihuatlán,30175,49528,51439,100967
2020,Veracruz,30,Tlachichilco,30180,5975,6183,12158
2020,Veracruz,30,Tlacojalpan,30176,2547,2635,5182
2020,Veracruz,30,Tlacolulan,30177,6016,5809,11825
2020,Veracruz,30,Tlacotalpan,30178,6784,7337,14121
2020,Veracruz,30,Tlacotepec de Mejía,30179,2059,2097,4156
2020,Veracruz,30,Tlalixcoyan,30181,19727,20356,40083
2020,Veracruz,30,Tlalnelhuayocan,30182,9726,10041,19767
2020,Veracruz,30,Tlaltetela,30024,8337,8106,16443
2020,Veracruz,30,Tlapacoyan,30183,31651,33436,65087
2020,Veracruz,30,Tlaquilpa,30184,3752,4283,8035
2020,Veracruz,30,Tlilapan,30185,2730,2854,5584
2020,Veracruz,30,Tomatlán,30186,3610,3716,7326
2020,Veracruz,30,Tonayán,30187,2916,3085,6001
2020,Veracruz,30,Totutla,30188,9119,9187,18306
2020,Veracruz,30,Tres Valles,30207,23718,24994,48712
2020,Veracruz,30,Tuxpan,30189,82862,86901,169763
2020,Veracruz,30,Tuxtilla,30190,1165,1193,2358
2020,Veracruz,30,Ursulo Galván,30191,15790,16688,32478
2020,Veracruz,30,Uxpanapa,30210,15414,15035,30449
2020,Veracruz,30,Vega de Alatorre,30192,10307,11012,21319
2020,Veracruz,30,Veracruz,30193,301292,325626,626918
2020,Veracruz,30,Villa Aldama,30194,6146,6260,12406
2020,Veracruz,30,Xalapa,30087,242062,271381,513443
2020,Veracruz,30,Xico,30092,19971,20435,40406
2020,Veracruz,30,Xoxocotla,30195,2912,2773,5685
2020,Veracruz,30,Yanga,30196,8918,10063,18981
2020,Veracruz,30,Yecuatla,30197,6164,6385,12549
2020,Veracruz,30,Zacualpan,30198,3634,3896,7530
2020,Veracruz,30,Zaragoza,30199,5817,6067,11884
2020,Veracruz,30,Zentla,30200,7095,6961,14056
2020,Veracruz,30,Zongolica,30201,22700,23123,45823
2020,Veracruz,30,Zontecomatlán de López y Fuentes,30202,7549,7709,15258
2020,Veracruz,30,Zozocolco de Hidalgo,30203,7697,8011,15708
2020,Veracruz,30,Álamo Temapache,30160,54852,55513,110365
2020,Yucatán,31,Abalá,31001,3599,3436,7035
2020,Yucatán,31,Acanceh,31002,8702,8688,17390
2020,Yucatán,31,Akil,31003,5826,6051,11877
2020,Yucatán,31,Baca,31004,3170,3236,6406
2020,Yucatán,31,Bokobá,31005,1200,1149,2349
2020,Yucatán,31,Buctzotz,31006,4795,4765,9560
2020,Yucatán,31,Cacalchén,31007,3984,3784,7768
2020,Yucatán,31,Calotmul,31008,2172,2156,4328
2020,Yucatán,31,Cansahcab,31009,2481,2513,4994
2020,Yucatán,31,Cantamayec,31010,1400,1284,2684
2020,Yucatán,31,Celestún,31011,4235,4025,8260
2020,Yucatán,31,Cenotillo,31012,2024,2170,4194
2020,Yucatán,31,Chacsinkín,31016,1616,1581,3197
2020,Yucatán,31,Chankom,31017,2489,2407,4896
2020,Yucatán,31,Chapab,31018,1699,1689,3388
2020,Yucatán,31,Chemax,31019,19662,19338,39000
2020,Yucatán,31,Chichimilá,31021,4515,4445,8960
2020,Yucatán,31,Chicxulub Pueblo,31020,2469,2336,4805
2020,Yucatán,31,Chikindzonot,31022,2258,2190,4448
2020,Yucatán,31,Chocholá,31023,2583,2487,5070
2020,Yucatán,31,Chumayel,31024,1716,1784,3500
2020,Yucatán,31,Conkal,31013,5957,5934,11891
2020,Yucatán,31,Cuncunul,31014,878,846,1724
2020,Yucatán,31,Cuzamá,31015,2819,2736,5555
2020,Yucatán,31,Dzemul,31026,2003,1978,3981
2020,Yucatán,31,Dzidzantún,31027,4489,4385,8874
2020,Yucatán,31,Dzilam González,31029,3361,3182,6543
2020,Yucatán,31,Dzilam de Bravo,31028,1488,1404,2892
2020,Yucatán,31,Dzitás,31030,2067,1967,4034
2020,Yucatán,31,Dzoncauich,31031,1408,1432,2840
2020,Yucatán,31,Dzán,31025,2779,2911,5690
2020,Yucatán,31,Espita,31032,8788,8512,17300
2020,Yucatán,31,Halachó,31033,10935,10685,21620
2020,Yucatán,31,Hocabá,31034,3311,3296,6607
2020,Yucatán,31,Hoctún,31035,3146,3212,6358
2020,Yucatán,31,Homún,31036,4198,4045,8243
2020,Yucatán,31,Huhí,31037,2843,2735,5578
2020,Yucatán,31,Hunucmá,31038,17403,17453,34856
2020,Yucatán,31,Ixil,31039,2242,2148,4390
2020,Yucatán,31,Izamal,31040,14316,14556,28872
2020,Yucatán,31,Kanasín,31041,54097,54821,108918
2020,Yucatán,31,Kantunil,31042,2847,2966,5813
2020,Yucatán,31,Kaua,31043,1691,1616,3307
2020,Yucatán,31,Kinchil,31044,3872,3785,7657
2020,Yucatán,31,Kopomá,31045,1406,1320,2726
2020,Yucatán,31,Mama,31046,1599,1772,3371
2020,Yucatán,31,Maní,31047,2936,3065,6001
2020,Yucatán,31,Maxcanú,31048,12261,12070,24331
2020,Yucatán,31,Mayapán,31049,2019,1882,3901
2020,Yucatán,31,Mocochá,31051,1776,1737,3513
2020,Yucatán,31,Motul,31052,19383,19669,39052
2020,Yucatán,31,Muna,31053,6656,6915,13571
2020,Yucatán,31,Muxupip,31054,1508,1566,3074
2020,Yucatán,31,Mérida,31050,464943,498918,963861
2020,Yucatán,31,Opichén,31055,3690,3559,7249
2020,Yucatán,31,Oxkutzcab,31056,15863,17328,33191
2020,Yucatán,31,Panabá,31057,4123,4131,8254
2020,Yucatán,31,Peto,31058,13354,13540,26894
2020,Yucatán,31,Progreso,31059,31402,31635,63037
2020,Yucatán,31,Quintana Roo,31060,516,512,1028
2020,Yucatán,31,Río Lagartos,31061,1954,1857,3811
2020,Yucatán,31,Sacalum,31062,2653,2504,5157
2020,Yucatán,31,Samahil,31063,2781,2759,5540
2020,Yucatán,31,San Felipe,31065,1067,1005,2072
2020,Yucatán,31,Sanahcat,31064,915,914,1829
2020,Yucatán,31,Santa Elena,31066,2086,2192,4278
2020,Yucatán,31,Seyé,31067,5300,5060,10360
2020,Yucatán,31,Sinanché,31068,1759,1618,3377
2020,Yucatán,31,Sotuta,31069,4832,4653,9485
2020,Yucatán,31,Sucilá,31070,2138,2066,4204
2020,Yucatán,31,Sudzal,31071,961,864,1825
2020,Yucatán,31,Suma,31072,999,964,1963
2020,Yucatán,31,Tahdziú,31073,2771,2604,5375
2020,Yucatán,31,Tahmek,31074,2026,1956,3982
2020,Yucatán,31,Teabo,31075,3491,3540,7031
2020,Yucatán,31,Tecoh,31076,9444,9347,18791
2020,Yucatán,31,Tekal de Venegas,31077,1442,1403,2845
2020,Yucatán,31,Tekantó,31078,2023,2026,4049
2020,Yucatán,31,Tekax,31079,22380,23061,45441
2020,Yucatán,31,Tekit,31080,5573,5401,10974
2020,Yucatán,31,Tekom,31081,1718,1725,3443
2020,Yucatán,31,Telchac Pueblo,31082,2039,2012,4051
2020,Yucatán,31,Telchac Puerto,31083,1002,910,1912
2020,Yucatán,31,Temax,31084,3887,3859,7746
2020,Yucatán,31,Temozón,31085,8425,8168,16593
2020,Yucatán,31,Tepakán,31086,1214,1158,2372
2020,Yucatán,31,Tetiz,31087,2695,2724,5419
2020,Yucatán,31,Teya,31088,1034,1057,2091
2020,Yucatán,31,Ticul,31089,21212,21748,42960
2020,Yucatán,31,Timucuy,31090,4030,3847,7877
2020,Yucatán,31,Tinum,31091,6508,6263,12771
2020,Yucatán,31,Tixcacalcupul,31092,3839,3775,7614
2020,Yucatán,31,Tixkokob,31093,9592,9748,19340
2020,Yucatán,31,Tixmehuac,31094,2615,2585,5200
2020,Yucatán,31,Tixpéhual,31095,2917,3005,5922
2020,Yucatán,31,Tizimín,31096,40921,41821,82742
2020,Yucatán,31,Tunkás,31097,1912,1839,3751
2020,Yucatán,31,Tzucacab,31098,7930,7756,15686
2020,Yucatán,31,Uayma,31099,2235,2133,4368
2020,Yucatán,31,Ucú,31100,1996,1967,3963
2020,Yucatán,31,Umán,31101,29109,29030,58139
2020,Yucatán,31,Valladolid,31102,42773,43432,86205
2020,Yucatán,31,Xocchel,31103,1900,1822,3722
2020,Yucatán,31,Yaxcabá,31104,8404,7909,16313
2020,Yucatán,31,Yaxkukul,31105,1680,1697,3377
2020,Yucatán,31,Yobaín,31106,1238,1188,2426
2020,Zacatecas,32,Apozol,32001,3071,3271,6342
2020,Zacatecas,32,Apulco,32002,2418,2679,5097
2020,Zacatecas,32,Atolinga,32003,1273,1348,2621
2020,Zacatecas,32,Benito Juárez,32004,2192,2115,4307
2020,Zacatecas,32,Calera,32005,23728,23649,47377
2020,Zacatecas,32,Cañitas de Felipe Pescador,32006,4302,4410,8712
2020,Zacatecas,32,Chalchihuites,32009,5762,6080,11842
2020,Zacatecas,32,Concepción del Oro,32007,7047,6886,13933
2020,Zacatecas,32,Cuauhtémoc,32008,6457,6773,13230
2020,Zacatecas,32,El Plateado de Joaquín Amaro,32015,666,674,1340
2020,Zacatecas,32,El Salvador,32041,1287,1241,2528
2020,Zacatecas,32,Fresnillo,32010,120057,122769,242826
2020,Zacatecas,32,Genaro Codina,32012,4174,4385,8559
2020,Zacatecas,32,General Enrique Estrada,32013,3277,3343,6620
2020,Zacatecas,32,General Francisco R. Murguía,32014,11029,11763,22792
2020,Zacatecas,32,General Pánfilo Natera,32016,11919,12367,24286
2020,Zacatecas,32,Guadalupe,32017,97583,101998,199581
2020,Zacatecas,32,Huanusco,32018,2086,2177,4263
2020,Zacatecas,32,Jalpa,32019,12439,12983,25422
2020,Zacatecas,32,Jerez,32020,30642,32393,63035
2020,Zacatecas,32,Jiménez del Teul,32021,2217,2247,4464
2020,Zacatecas,32,Juan Aldama,32022,11073,11707,22780
2020,Zacatecas,32,Juchipila,32023,6347,7010,13357
2020,Zacatecas,32,Loreto,32024,28072,28443,56515
2020,Zacatecas,32,Luis Moya,32025,6943,7005,13948
2020,Zacatecas,32,Mazapil,32026,9692,8772,18464
2020,Zacatecas,32,Melchor Ocampo,32027,1656,1456,3112
2020,Zacatecas,32,Mezquital del Oro,32028,1247,1358,2605
2020,Zacatecas,32,Miguel Auza,32029,12197,12650,24847
2020,Zacatecas,32,Momax,32030,1229,1313,2542
2020,Zacatecas,32,Monte Escobedo,32031,4812,4896,9708
2020,Zacatecas,32,Morelos,32032,6552,6568,13120
2020,Zacatecas,32,Moyahua de Estrada,32033,1984,2233,4217
2020,Zacatecas,32,Nochistlán de Mejía,32034,13983,15370,29353
2020,Zacatecas,32,Noria de Ángeles,32035,8689,8947,17636
2020,Zacatecas,32,Ojocaliente,32036,22169,23133,45302
2020,Zacatecas,32,Pinos,32038,37654,39217,76871
2020,Zacatecas,32,Pánuco,32037,9418,9371,18789
2020,Zacatecas,32,Río Grande,32039,32747,34760,67507
2020,Zacatecas,32,Sain Alto,32040,11341,11942,23283
2020,Zacatecas,32,Santa María de la Paz,32058,1419,1436,2855
2020,Zacatecas,32,Sombrerete,32042,32232,33098,65330
2020,Zacatecas,32,Susticacán,32043,685,744,1429
2020,Zacatecas,32,Tabasco,32044,7993,8379,16372
2020,Zacatecas,32,Tepechitlán,32045,4399,4781,9180
2020,Zacatecas,32,Tepetongo,32046,3634,3849,7483
2020,Zacatecas,32,Teúl de González Ortega,32047,2525,2647,5172
2020,Zacatecas,32,Tlaltenango de Sánchez Román,32048,13809,14303,28112
2020,Zacatecas,32,Trancoso,32057,10046,10239,20285
2020,Zacatecas,32,Trinidad García de la Cadena,32011,1486,1536,3022
2020,Zacatecas,32,Valparaíso,32049,17169,17623,34792
2020,Zacatecas,32,Vetagrande,32050,5205,5331,10536
2020,Zacatecas,32,Villa García,32052,10000,10167,20167
2020,Zacatecas,32,Villa González Ortega,32053,6767,7178,13945
2020,Zacatecas,32,Villa Hidalgo,32054,10030,10147,20177
2020,Zacatecas,32,Villa de Cos,32051,18683,18416,37099
2020,Zacatecas,32,Villanueva,32055,15583,16221,31804
2020,Zacatecas,32,Zacatecas,32056,75693,79840,155533
2021,Aguascalientes,01,Aguascalientes,01001,478033,496496,974529
2021,Aguascalientes,01,Asientos,01002,25573,25810,51383
2021,Aguascalientes,01,Calvillo,01003,30055,31334,61389
2021,Aguascalientes,01,Cosío,01004,8386,8690,17076
2021,Aguascalientes,01,El Llano,01010,11249,10940,22189
2021,Aguascalientes,01,Jesús María,01005,66491,65849,132340
2021,Aguascalientes,01,Pabellón de Arteaga,01006,24727,25847,50574
2021,Aguascalientes,01,Rincón de Romos,01007,29114,29486,58600
2021,Aguascalientes,01,San Francisco de los Romo,01011,26217,26367,52584
2021,Aguascalientes,01,San José de Gracia,01008,4739,5032,9771
2021,Aguascalientes,01,Tepezalá,01009,11332,11685,23017
2021,Baja California,02,Ensenada,02001,272016,272552,544568
2021,Baja California,02,Mexicali,02002,551427,553852,1105279
2021,Baja California,02,Playas de Rosarito,02005,54920,54759,109679
2021,Baja California,02,Tecate,02003,59526,56008,115534
2021,Baja California,02,Tijuana,02004,904688,910412,1815100
2021,Baja California Sur,03,Comondú,03001,42887,41706,84593
2021,Baja California Sur,03,La Paz,03003,153089,154241,307330
2021,Baja California Sur,03,Loreto,03009,11570,10600,22170
2021,Baja California Sur,03,Los Cabos,03008,174044,164259,338303
2021,Baja California Sur,03,Mulegé,03002,35582,33081,68663
2021,Campeche,04,Calakmul,04010,16361,15813,32174
2021,Campeche,04,Calkiní,04001,31625,32644,64269
2021,Campeche,04,Campeche,04002,155672,167084,322756
2021,Campeche,04,Candelaria,04011,25055,24419,49474
2021,Campeche,04,Carmen,04003,139522,140645,280167
2021,Campeche,04,Champotón,04004,51007,50668,101675
2021,Campeche,04,Escárcega,04009,31802,32571,64373
2021,Campeche,04,Hecelchakán,04005,17575,17647,35222
2021,Campeche,04,Hopelchén,04006,22878,21902,44780
2021,Campeche,04,Palizada,04007,5057,4943,10000
2021,Campeche,04,Tenabo,04008,6220,5901,12121
2021,Chiapas,07,Acacoyagua,07001,10098,10044,20142
2021,Chiapas,07,Acala,07002,17357,17638,34995
2021,Chiapas,07,Acapetahua,07003,15753,15726,31479
2021,Chiapas,07,Aldama,07113,3489,3773,7262
2021,Chiapas,07,Altamirano,07004,18389,18153,36542
2021,Chiapas,07,Amatenango de la Frontera,07006,16672,17657,34329
2021,Chiapas,07,Amatenango del Valle,07007,5253,5673,10926
2021,Chiapas,07,Amatán,07005,11144,10847,21991
2021,Chiapas,07,Angel Albino Corzo,07008,15565,15680,31245
2021,Chiapas,07,Arriaga,07009,21633,23106,44739
2021,Chiapas,07,Bejucal de Ocampo,07010,4233,4194,8427
2021,Chiapas,07,Bella Vista,07011,11071,11239,22310
2021,Chiapas,07,Benemérito de las Américas,07114,11085,10866,21951
2021,Chiapas,07,Berriozábal,07012,28988,29135,58123
2021,Chiapas,07,Bochil,07013,19160,19522,38682
2021,Chiapas,07,Cacahoatán,07015,24906,26182,51088
2021,Chiapas,07,Catazajá,07016,9698,9532,19230
2021,Chiapas,07,Chalchihuitán,07022,9042,9208,18250
2021,Chiapas,07,Chamula,07023,44751,52148,96899
2021,Chiapas,07,Chanal,07024,6762,6801,13563
2021,Chiapas,07,Chapultenango,07025,4168,4157,8325
2021,Chiapas,07,Chenalhó,07026,21849,22316,44165
2021,Chiapas,07,Chiapa de Corzo,07027,55622,57599,113221
2021,Chiapas,07,Chiapilla,07028,3308,3181,6489
2021,Chiapas,07,Chicoasén,07029,2823,2830,5653
2021,Chiapas,07,Chicomuselo,07030,19241,19499,38740
2021,Chiapas,07,Chilón,07031,70404,72009,142413
2021,Chiapas,07,Cintalapa,07017,47318,47570,94888
2021,Chiapas,07,Coapilla,07018,5017,5150,10167
2021,Chiapas,07,Comitán de Domínguez,07019,82643,90514,173157
2021,Chiapas,07,Copainalá,07021,11874,12424,24298
2021,Chiapas,07,El Bosque,07014,11989,12830,24819
2021,Chiapas,07,El Porvenir,07070,7828,7870,15698
2021,Chiapas,07,Escuintla,07032,17259,17807,35066
2021,Chiapas,07,Francisco León,07033,4255,4131,8386
2021,Chiapas,07,Frontera Comalapa,07034,39837,42259,82096
2021,Chiapas,07,Frontera Hidalgo,07035,7810,8197,16007
2021,Chiapas,07,Huehuetán,07037,18798,19860,38658
2021,Chiapas,07,Huitiupán,07039,12795,12625,25420
2021,Chiapas,07,Huixtla,07040,28909,31032,59941
2021,Chiapas,07,Huixtán,07038,12791,13210,26001
2021,Chiapas,07,Ixhuatán,07042,6167,6335,12502
2021,Chiapas,07,Ixtacomitán,07043,5907,6001,11908
2021,Chiapas,07,Ixtapa,07044,15019,15188,30207
2021,Chiapas,07,Ixtapangajoya,07045,3070,2985,6055
2021,Chiapas,07,Jiquipilas,07046,21570,22304,43874
2021,Chiapas,07,Jitotol,07047,11651,11329,22980
2021,Chiapas,07,Juárez,07048,11758,12053,23811
2021,Chiapas,07,La Concordia,07020,25714,25421,51135
2021,Chiapas,07,La Grandeza,07036,3937,4027,7964
2021,Chiapas,07,La Independencia,07041,24704,25636,50340
2021,Chiapas,07,La Libertad,07050,2688,2779,5467
2021,Chiapas,07,La Trinitaria,07099,42336,44430,86766
2021,Chiapas,07,Larráinzar,07049,12856,13300,26156
2021,Chiapas,07,Las Margaritas,07052,67847,69085,136932
2021,Chiapas,07,Las Rosas,07075,15471,15792,31263
2021,Chiapas,07,Mapastepec,07051,25867,26770,52637
2021,Chiapas,07,Maravilla Tenejapa,07115,7090,6844,13934
2021,Chiapas,07,Marqués de Comillas,07116,6304,6125,12429
2021,Chiapas,07,Mazapa de Madero,07053,4258,4406,8664
2021,Chiapas,07,Mazatán,07054,15919,16404,32323
2021,Chiapas,07,Metapa,07055,3021,3255,6276
2021,Chiapas,07,Mitontic,07056,6706,6773,13479
2021,Chiapas,07,Montecristo de Guerrero,07117,4290,4173,8463
2021,Chiapas,07,Motozintla,07057,39653,41167,80820
2021,Chiapas,07,Nicolás Ruíz,07058,2454,2319,4773
2021,Chiapas,07,Ocosingo,07059,121023,121908,242931
2021,Chiapas,07,Ocotepec,07060,6834,7106,13940
2021,Chiapas,07,Ocozocoautla de Espinosa,07061,50260,51511,101771
2021,Chiapas,07,Ostuacán,07062,10178,10049,20227
2021,Chiapas,07,Osumacinta,07063,2074,2077,4151
2021,Chiapas,07,Oxchuc,07064,26322,26048,52370
2021,Chiapas,07,Palenque,07065,65609,67672,133281
2021,Chiapas,07,Pantelhó,07066,12105,12287,24392
2021,Chiapas,07,Pantepec,07067,6741,6833,13574
2021,Chiapas,07,Pichucalco,07068,17181,17556,34737
2021,Chiapas,07,Pijijiapan,07069,29054,29873,58927
2021,Chiapas,07,Pueblo Nuevo Solistahuacán,07072,17050,18471,35521
2021,Chiapas,07,Rayón,07073,5314,5397,10711
2021,Chiapas,07,Reforma,07074,24910,25358,50268
2021,Chiapas,07,Sabanilla,07076,14936,14758,29694
2021,Chiapas,07,Salto de Agua,07077,34668,35028,69696
2021,Chiapas,07,San Andrés Duraznal,07118,2899,3053,5952
2021,Chiapas,07,San Cristóbal de las Casas,07078,111657,123221,234878
2021,Chiapas,07,San Fernando,07079,22053,21649,43702
2021,Chiapas,07,San Juan Cancuc,07112,18843,19674,38517
2021,Chiapas,07,San Lucas,07110,3997,4006,8003
2021,Chiapas,07,Santiago el Pinar,07119,2031,1991,4022
2021,Chiapas,07,Siltepec,07080,20236,19620,39856
2021,Chiapas,07,Simojovel,07081,24207,24590,48797
2021,Chiapas,07,Sitalá,07082,7866,7940,15806
2021,Chiapas,07,Socoltenango,07083,10154,10244,20398
2021,Chiapas,07,Solosuchiapa,07084,4458,4425,8883
2021,Chiapas,07,Soyaló,07085,5990,5928,11918
2021,Chiapas,07,Suchiapa,07086,13491,13461,26952
2021,Chiapas,07,Suchiate,07087,20934,21828,42762
2021,Chiapas,07,Sunuapa,07088,1340,1299,2639
2021,Chiapas,07,Tapachula,07089,186750,203326,390076
2021,Chiapas,07,Tapalapa,07090,2138,2249,4387
2021,Chiapas,07,Tapilula,07091,7031,7380,14411
2021,Chiapas,07,Tecpatán,07092,22796,23161,45957
2021,Chiapas,07,Tenejapa,07093,23532,24776,48308
2021,Chiapas,07,Teopisca,07094,23322,24647,47969
2021,Chiapas,07,Tila,07096,43475,43298,86773
2021,Chiapas,07,Tonalá,07097,48884,50180,99064
2021,Chiapas,07,Totolapa,07098,4022,3984,8006
2021,Chiapas,07,Tumbalá,07100,18512,19358,37870
2021,Chiapas,07,Tuxtla Chico,07102,22650,23997,46647
2021,Chiapas,07,Tuxtla Gutiérrez,07101,319838,351781,671619
2021,Chiapas,07,Tuzantán,07103,17478,18014,35492
2021,Chiapas,07,Tzimol,07104,8361,8759,17120
2021,Chiapas,07,Unión Juárez,07105,8274,8747,17021
2021,Chiapas,07,Venustiano Carranza,07106,35771,36065,71836
2021,Chiapas,07,Villa Comaltitlán,07071,15739,16134,31873
2021,Chiapas,07,Villa Corzo,07107,42613,44163,86776
2021,Chiapas,07,Villaflores,07108,57361,59832,117193
2021,Chiapas,07,Yajalón,07109,20680,21596,42276
2021,Chiapas,07,Zinacantán,07111,21299,24187,45486
2021,Chihuahua,08,Ahumada,08001,6600,6459,13059
2021,Chihuahua,08,Aldama,08002,13198,13343,26541
2021,Chihuahua,08,Allende,08003,4843,4734,9577
2021,Chihuahua,08,Aquiles Serdán,08004,10044,9448,19492
2021,Chihuahua,08,Ascensión,08005,13474,13144,26618
2021,Chihuahua,08,Bachíniva,08006,3486,3348,6834
2021,Chihuahua,08,Balleza,08007,9093,8825,17918
2021,Chihuahua,08,Batopilas,08008,6449,6474,12923
2021,Chihuahua,08,Bocoyna,08009,14655,15286,29941
2021,Chihuahua,08,Buenaventura,08010,12749,12516,25265
2021,Chihuahua,08,Camargo,08011,27432,28472,55904
2021,Chihuahua,08,Carichí,08012,5153,5088,10241
2021,Chihuahua,08,Casas Grandes,08013,6303,6032,12335
2021,Chihuahua,08,Chihuahua,08019,468098,492800,960898
2021,Chihuahua,08,Chínipas,08020,4520,4090,8610
2021,Chihuahua,08,Coronado,08014,1247,1150,2397
2021,Chihuahua,08,Coyame del Sotol,08015,1016,837,1853
2021,Chihuahua,08,Cuauhtémoc,08017,89304,94878,184182
2021,Chihuahua,08,Cusihuiriachi,08018,2663,2478,5141
2021,Chihuahua,08,Delicias,08021,79312,83053,162365
2021,Chihuahua,08,Dr. Belisario Domínguez,08022,1426,1388,2814
2021,Chihuahua,08,El Tule,08064,940,907,1847
2021,Chihuahua,08,Galeana,08023,3586,3580,7166
2021,Chihuahua,08,Gran Morelos,08026,1435,1376,2811
2021,Chihuahua,08,Guachochi,08027,24526,25678,50204
2021,Chihuahua,08,Guadalupe,08028,2440,2507,4947
2021,Chihuahua,08,Guadalupe y Calvo,08029,29807,29208,59015
2021,Chihuahua,08,Guazapares,08030,4437,4231,8668
2021,Chihuahua,08,Guerrero,08031,21583,21295,42878
2021,Chihuahua,08,Gómez Farías,08025,4878,4868,9746
2021,Chihuahua,08,Hidalgo del Parral,08032,57541,61172,118713
2021,Chihuahua,08,Huejotitán,08033,541,543,1084
2021,Chihuahua,08,Ignacio Zaragoza,08034,3823,3759,7582
2021,Chihuahua,08,Janos,08035,6238,5704,11942
2021,Chihuahua,08,Jiménez,08036,22907,23241,46148
2021,Chihuahua,08,Julimes,08038,2527,2432,4959
2021,Chihuahua,08,Juárez,08037,736424,737015,1473439
2021,Chihuahua,08,La Cruz,08016,2195,2085,4280
2021,Chihuahua,08,López,08039,2278,2119,4397
2021,Chihuahua,08,Madera,08040,15646,15457,31103
2021,Chihuahua,08,Maguarichi,08041,888,837,1725
2021,Chihuahua,08,Manuel Benavides,08042,858,725,1583
2021,Chihuahua,08,Matachí,08043,1686,1663,3349
2021,Chihuahua,08,Matamoros,08044,2505,2407,4912
2021,Chihuahua,08,Meoqui,08045,24132,24600,48732
2021,Chihuahua,08,Morelos,08046,4195,4111,8306
2021,Chihuahua,08,Moris,08047,2875,2691,5566
2021,Chihuahua,08,Namiquipa,08048,13336,12706,26042
2021,Chihuahua,08,Nonoava,08049,1466,1389,2855
2021,Chihuahua,08,Nuevo Casas Grandes,08050,33311,34773,68084
2021,Chihuahua,08,Ocampo,08051,4202,3871,8073
2021,Chihuahua,08,Ojinaga,08052,15320,15133,30453
2021,Chihuahua,08,Praxedis G. Guerrero,08053,2549,2511,5060
2021,Chihuahua,08,Riva Palacio,08054,4245,4092,8337
2021,Chihuahua,08,Rosales,08055,9384,9211,18595
2021,Chihuahua,08,Rosario,08056,1128,1079,2207
2021,Chihuahua,08,San Francisco de Borja,08057,1282,1210,2492
2021,Chihuahua,08,San Francisco de Conchos,08058,1482,1376,2858
2021,Chihuahua,08,San Francisco del Oro,08059,2814,2793,5607
2021,Chihuahua,08,Santa Bárbara,08060,5834,5908,11742
2021,Chihuahua,08,Santa Isabel,08024,2144,2194,4338
2021,Chihuahua,08,Satevó,08061,1754,1645,3399
2021,Chihuahua,08,Saucillo,08062,17329,17125,34454
2021,Chihuahua,08,Temósachic,08063,3639,3468,7107
2021,Chihuahua,08,Urique,08065,11399,11056,22455
2021,Chihuahua,08,Uruachi,08066,3370,3217,6587
2021,Chihuahua,08,Valle de Zaragoza,08067,2938,2813,5751
2021,Ciudad de México,09,Azcapotzalco,09002,191438,215842,407280
2021,Ciudad de México,09,Benito Juárez,09014,201203,235534,436737
2021,Ciudad de México,09,Coyoacán,09003,291287,329199,620486
2021,Ciudad de México,09,Cuajimalpa de Morelos,09004,95983,103943,199926
2021,Ciudad de México,09,Cuauhtémoc,09015,260840,288556,549396
2021,Ciudad de México,09,Gustavo A. Madero,09005,563297,610258,1173555
2021,Ciudad de México,09,Iztacalco,09006,186270,207005,393275
2021,Ciudad de México,09,Iztapalapa,09007,876717,930416,1807133
2021,Ciudad de México,09,La Magdalena Contreras,09008,117705,127064,244769
2021,Ciudad de México,09,Miguel Hidalgo,09016,176001,204464,380465
2021,Ciudad de México,09,Milpa Alta,09009,68160,71281,139441
2021,Ciudad de México,09,Tlalpan,09012,326516,355605,682121
2021,Ciudad de México,09,Tláhuac,09011,175992,189394,365386
2021,Ciudad de México,09,Venustiano Carranza,09017,203571,228821,432392
2021,Ciudad de México,09,Xochimilco,09013,204078,212341,416419
2021,Ciudad de México,09,Álvaro Obregón,09010,360028,395018,755046
2021,Coahuila,05,Abasolo,05001,575,570,1145
2021,Coahuila,05,Acuña,05002,82756,81911,164667
2021,Coahuila,05,Allende,05003,12335,12625,24960
2021,Coahuila,05,Arteaga,05004,13214,12601,25815
2021,Coahuila,05,Candela,05005,1035,936,1971
2021,Coahuila,05,Castaños,05006,15524,15468,30992
2021,Coahuila,05,Cuatro Ciénegas,05007,7481,7312,14793
2021,Coahuila,05,Escobedo,05008,1735,1663,3398
2021,Coahuila,05,Francisco I. Madero,05009,32701,32734,65435
2021,Coahuila,05,Frontera,05010,44795,44270,89065
2021,Coahuila,05,General Cepeda,05011,7131,6549,13680
2021,Coahuila,05,Guerrero,05012,1047,931,1978
2021,Coahuila,05,Hidalgo,05013,976,930,1906
2021,Coahuila,05,Jiménez,05014,5630,5452,11082
2021,Coahuila,05,Juárez,05015,908,835,1743
2021,Coahuila,05,Lamadrid,05016,1039,975,2014
2021,Coahuila,05,Matamoros,05017,60529,60322,120851
2021,Coahuila,05,Monclova,05018,126639,127919,254558
2021,Coahuila,05,Morelos,05019,4854,4710,9564
2021,Coahuila,05,Múzquiz,05020,38762,37847,76609
2021,Coahuila,05,Nadadores,05021,3643,3587,7230
2021,Coahuila,05,Nava,05022,17191,16300,33491
2021,Coahuila,05,Ocampo,05023,6040,5600,11640
2021,Coahuila,05,Parras,05024,25093,23974,49067
2021,Coahuila,05,Piedras Negras,05025,90067,89123,179190
2021,Coahuila,05,Progreso,05026,1912,1783,3695
2021,Coahuila,05,Ramos Arizpe,05027,53805,51650,105455
2021,Coahuila,05,Sabinas,05028,35328,35099,70427
2021,Coahuila,05,Sacramento,05029,1344,1304,2648
2021,Coahuila,05,Saltillo,05030,439715,441649,881364
2021,Coahuila,05,San Buenaventura,05031,13119,13085,26204
2021,Coahuila,05,San Juan de Sabinas,05032,23540,24354,47894
2021,Coahuila,05,San Pedro,05033,59533,59572,119105
2021,Coahuila,05,Sierra Mojada,05034,4116,3806,7922
2021,Coahuila,05,Torreón,05035,369095,385242,754337
2021,Coahuila,05,Viesca,05036,12285,11829,24114
2021,Coahuila,05,Villa Unión,05037,3551,3367,6918
2021,Coahuila,05,Zaragoza,05038,7201,7131,14332
2021,Colima,06,Armería,06001,16531,16279,32810
2021,Colima,06,Colima,06002,83627,88047,171674
2021,Colima,06,Comala,06003,12197,12010,24207
2021,Colima,06,Coquimatlán,06004,11348,11105,22453
2021,Colima,06,Cuauhtémoc,06005,16748,16574,33322
2021,Colima,06,Ixtlahuacán,06006,3114,3056,6170
2021,Colima,06,Manzanillo,06007,104510,102247,206757
2021,Colima,06,Minatitlán,06008,5108,4698,9806
2021,Colima,06,Tecomán,06009,68973,67624,136597
2021,Colima,06,Villa de Álvarez,06010,74905,78544,153449
2021,Durango,10,Canatlán,10001,17318,17715,35033
2021,Durango,10,Canelas,10002,2540,2308,4848
2021,Durango,10,Coneto de Comonfort,10003,2313,2357,4670
2021,Durango,10,Cuencamé,10004,19040,18725,37765
2021,Durango,10,Durango,10005,340100,362386,702486
2021,Durango,10,El Oro,10018,6173,6226,12399
2021,Durango,10,General Simón Bolívar,10006,5379,5499,10878
2021,Durango,10,Guadalupe Victoria,10008,18871,19203,38074
2021,Durango,10,Guanaceví,10009,5447,5100,10547
2021,Durango,10,Gómez Palacio,10007,184552,188007,372559
2021,Durango,10,Hidalgo,10010,2118,2059,4177
2021,Durango,10,Indé,10011,2730,2719,5449
2021,Durango,10,Lerdo,10012,82775,83521,166296
2021,Durango,10,Mapimí,10013,14290,14271,28561
2021,Durango,10,Mezquital,10014,20162,20776,40938
2021,Durango,10,Nazas,10015,6981,7020,14001
2021,Durango,10,Nombre de Dios,10016,10497,10577,21074
2021,Durango,10,Nuevo Ideal,10039,14484,14615,29099
2021,Durango,10,Ocampo,10017,5330,5104,10434
2021,Durango,10,Otáez,10019,2872,2656,5528
2021,Durango,10,Peñón Blanco,10021,5840,5781,11621
2021,Durango,10,Poanas,10022,13384,13745,27129
2021,Durango,10,Pueblo Nuevo,10023,26486,26683,53169
2021,Durango,10,Pánuco de Coronado,10020,6400,6588,12988
2021,Durango,10,Rodeo,10024,7302,7263,14565
2021,Durango,10,San Bernardo,10025,1840,1639,3479
2021,Durango,10,San Dimas,10026,10391,9748,20139
2021,Durango,10,San Juan de Guadalupe,10027,2926,3014,5940
2021,Durango,10,San Juan del Río,10028,6635,6807,13442
2021,Durango,10,San Luis del Cordero,10029,1155,1120,2275
2021,Durango,10,San Pedro del Gallo,10030,857,791,1648
2021,Durango,10,Santa Clara,10031,3775,3788,7563
2021,Durango,10,Santiago Papasquiaro,10032,25782,25749,51531
2021,Durango,10,Súchil,10033,3243,3532,6775
2021,Durango,10,Tamazula,10034,14260,13071,27331
2021,Durango,10,Tepehuanes,10035,5783,5802,11585
2021,Durango,10,Tlahualilo,10036,12769,12495,25264
2021,Durango,10,Topia,10037,5136,4810,9946
2021,Durango,10,Vicente Guerrero,10038,11363,12053,23416
2021,Estado de México,15,Acambay de Ruíz Castañeda,15001,34032,36140,70172
2021,Estado de México,15,Acolman,15002,95268,94805,190073
2021,Estado de México,15,Aculco,15003,26043,26699,52742
2021,Estado de México,15,Almoloya de Alquisiras,15004,7520,8188,15708
2021,Estado de México,15,Almoloya de Juárez,15005,94498,96379,190877
2021,Estado de México,15,Almoloya del Río,15006,5949,6365,12314
2021,Estado de México,15,Amanalco,15007,12784,13298,26082
2021,Estado de México,15,Amatepec,15008,13876,14725,28601
2021,Estado de México,15,Amecameca,15009,26571,28399,54970
2021,Estado de México,15,Apaxco,15010,15749,16142,31891
2021,Estado de México,15,Atenco,15011,35217,35905,71122
2021,Estado de México,15,Atizapán,15012,6157,6508,12665
2021,Estado de México,15,Atizapán de Zaragoza,15013,272521,288473,560994
2021,Estado de México,15,Atlacomulco,15014,52133,56448,108581
2021,Estado de México,15,Atlautla,15015,16151,16889,33040
2021,Estado de México,15,Axapusco,15016,15129,15307,30436
2021,Estado de México,15,Ayapango,15017,5527,5741,11268
2021,Estado de México,15,Calimaya,15018,29900,31341,61241
2021,Estado de México,15,Capulhuac,15019,18732,19814,38546
2021,Estado de México,15,Chalco,15025,198479,207009,405488
2021,Estado de México,15,Chapa de Mota,15026,15040,15623,30663
2021,Estado de México,15,Chapultepec,15027,6510,6724,13234
2021,Estado de México,15,Chiautla,15028,15856,16407,32263
2021,Estado de México,15,Chicoloapan,15029,111989,118664,230653
2021,Estado de México,15,Chiconcuac,15030,13791,14161,27952
2021,Estado de México,15,Chimalhuacán,15031,356994,369436,726430
2021,Estado de México,15,Coacalco de Berriozábal,15020,150513,161876,312389
2021,Estado de México,15,Coatepec Harinas,15021,20303,21830,42133
2021,Estado de México,15,Cocotitlán,15022,7617,7970,15587
2021,Estado de México,15,Coyotepec,15023,22019,22449,44468
2021,Estado de México,15,Cuautitlán,15024,87852,89879,177731
2021,Estado de México,15,Cuautitlán Izcalli,15121,283551,298137,581688
2021,Estado de México,15,Donato Guerra,15032,17935,18509,36444
2021,Estado de México,15,Ecatepec de Morelos,15033,847847,869044,1716891
2021,Estado de México,15,Ecatzingo,15034,5006,5165,10171
2021,Estado de México,15,El Oro,15064,19401,20557,39958
2021,Estado de México,15,Huehuetoca,15035,74308,76346,150654
2021,Estado de México,15,Hueypoxtla,15036,23836,23436,47272
2021,Estado de México,15,Huixquilucan,15037,141712,151955,293667
2021,Estado de México,15,Isidro Fabela,15038,6278,6391,12669
2021,Estado de México,15,Ixtapaluca,15039,273330,283762,557092
2021,Estado de México,15,Ixtapan de la Sal,15040,18657,20043,38700
2021,Estado de México,15,Ixtapan del Oro,15041,3720,3630,7350
2021,Estado de México,15,Ixtlahuaca,15042,79773,85266,165039
2021,Estado de México,15,Jaltenco,15044,14201,15059,29260
2021,Estado de México,15,Jilotepec,15045,47208,48765,95973
2021,Estado de México,15,Jilotzingo,15046,10190,10743,20933
2021,Estado de México,15,Jiquipilco,15047,38860,41296,80156
2021,Estado de México,15,Jocotitlán,15048,34420,36814,71234
2021,Estado de México,15,Joquicingo,15049,7260,7603,14863
2021,Estado de México,15,Juchitepec,15050,13577,13963,27540
2021,Estado de México,15,La Paz,15070,154531,158439,312970
2021,Estado de México,15,Lerma,15051,80046,82158,162204
2021,Estado de México,15,Luvianos,15123,14897,15101,29998
2021,Estado de México,15,Malinalco,15052,14705,15142,29847
2021,Estado de México,15,Melchor Ocampo,15053,30415,31690,62105
2021,Estado de México,15,Metepec,15054,120373,127827,248200
2021,Estado de México,15,Mexicaltzingo,15055,6742,7176,13918
2021,Estado de México,15,Morelos,15056,15405,16717,32122
2021,Estado de México,15,Naucalpan de Juárez,15057,445809,471503,917312
2021,Estado de México,15,Nextlalpan,15059,21989,22443,44432
2021,Estado de México,15,Nezahualcóyotl,15058,550452,591318,1141770
2021,Estado de México,15,Nicolás Romero,15060,219154,227863,447017
2021,Estado de México,15,Nopaltepec,15061,4903,4929,9832
2021,Estado de México,15,Ocoyoacac,15062,35710,36847,72557
2021,Estado de México,15,Ocuilan,15063,18161,18896,37057
2021,Estado de México,15,Otumba,15065,19431,19147,38578
2021,Estado de México,15,Otzoloapan,15066,2127,2085,4212
2021,Estado de México,15,Otzolotepec,15067,45372,46480,91852
2021,Estado de México,15,Ozumba,15068,15145,16336,31481
2021,Estado de México,15,Papalotla,15069,2143,2254,4397
2021,Estado de México,15,Polotitlán,15071,7460,7783,15243
2021,Estado de México,15,Rayón,15072,7284,7507,14791
2021,Estado de México,15,San Antonio la Isla,15073,15984,16403,32387
2021,Estado de México,15,San Felipe del Progreso,15074,65852,73674,139526
2021,Estado de México,15,San José del Rincón,15124,49406,50181,99587
2021,Estado de México,15,San Martín de las Pirámides,15075,14572,14925,29497
2021,Estado de México,15,San Mateo Atenco,15076,40097,41455,81552
2021,Estado de México,15,San Simón de Guerrero,15077,3204,3404,6608
2021,Estado de México,15,Santo Tomás,15078,5101,5244,10345
2021,Estado de México,15,Soyaniquilpan de Juárez,15079,7186,7345,14531
2021,Estado de México,15,Sultepec,15080,13435,14957,28392
2021,Estado de México,15,Tecámac,15081,249418,261350,510768
2021,Estado de México,15,Tejupilco,15082,38467,41662,80129
2021,Estado de México,15,Temamatla,15083,6708,7135,13843
2021,Estado de México,15,Temascalapa,15084,21045,21062,42107
2021,Estado de México,15,Temascalcingo,15085,32512,35258,67770
2021,Estado de México,15,Temascaltepec,15086,16959,17632,34591
2021,Estado de México,15,Temoaya,15087,53922,56872,110794
2021,Estado de México,15,Tenancingo,15088,51817,54711,106528
2021,Estado de México,15,Tenango del Aire,15089,6690,6850,13540
2021,Estado de México,15,Tenango del Valle,15090,45647,47445,93092
2021,Estado de México,15,Teoloyucan,15091,34390,35033,69423
2021,Estado de México,15,Teotihuacán,15092,30327,31282,61609
2021,Estado de México,15,Tepetlaoxtoc,15093,16582,16908,33490
2021,Estado de México,15,Tepetlixpa,15094,10529,10816,21345
2021,Estado de México,15,Tepotzotlán,15095,52004,53762,105766
2021,Estado de México,15,Tequixquiac,15096,19937,20163,40100
2021,Estado de México,15,Texcaltitlán,15097,9845,10498,20343
2021,Estado de México,15,Texcalyacac,15098,2845,2924,5769
2021,Estado de México,15,Texcoco,15099,128528,135893,264421
2021,Estado de México,15,Tezoyuca,15100,23571,23827,47398
2021,Estado de México,15,Tianguistenco,15101,40566,42764,83330
2021,Estado de México,15,Timilpan,15102,8146,8809,16955
2021,Estado de México,15,Tlalmanalco,15103,24982,26822,51804
2021,Estado de México,15,Tlalnepantla de Baz,15104,369541,394187,763728
2021,Estado de México,15,Tlatlaya,15105,18576,19333,37909
2021,Estado de México,15,Toluca,15106,463616,495622,959238
2021,Estado de México,15,Tonanitla,15125,5437,5577,11014
2021,Estado de México,15,Tonatico,15107,6651,7063,13714
2021,Estado de México,15,Tultepec,15108,79955,83001,162956
2021,Estado de México,15,Tultitlán,15109,274982,285138,560120
2021,Estado de México,15,Valle de Bravo,15110,34711,36042,70753
2021,Estado de México,15,Valle de Chalco Solidaridad,15122,208460,215461,423921
2021,Estado de México,15,Villa Guerrero,15113,35762,36843,72605
2021,Estado de México,15,Villa Victoria,15114,55605,56259,111864
2021,Estado de México,15,Villa de Allende,15111,27171,28198,55369
2021,Estado de México,15,Villa del Carbón,15112,25693,25418,51111
2021,Estado de México,15,Xalatlaco,15043,15868,16724,32592
2021,Estado de México,15,Xonacatlán,15115,27594,27405,54999
2021,Estado de México,15,Zacazonapan,15116,2200,2181,4381
2021,Estado de México,15,Zacualpan,15117,7724,8485,16209
2021,Estado de México,15,Zinacantepec,15118,101014,103766,204780
2021,Estado de México,15,Zumpahuacán,15119,8647,9420,18067
2021,Estado de México,15,Zumpango,15120,106866,114130,220996
2021,Guanajuato,11,Abasolo,11001,46713,49611,96324
2021,Guanajuato,11,Acámbaro,11002,57665,62210,119875
2021,Guanajuato,11,Apaseo el Alto,11004,35526,37205,72731
2021,Guanajuato,11,Apaseo el Grande,11005,48607,51465,100072
2021,Guanajuato,11,Atarjea,11006,2737,2848,5585
2021,Guanajuato,11,Celaya,11007,260381,274884,535265
2021,Guanajuato,11,Comonfort,11009,41653,46173,87826
2021,Guanajuato,11,Coroneo,11010,6203,6908,13111
2021,Guanajuato,11,Cortazar,11011,49692,52427,102119
2021,Guanajuato,11,Cuerámaro,11012,14546,15648,30194
2021,Guanajuato,11,Doctor Mora,11013,12424,13343,25767
2021,Guanajuato,11,Dolores Hidalgo Cuna de la Independencia Nacional,11014,76525,85109,161634
2021,Guanajuato,11,Guanajuato,11015,97988,101878,199866
2021,Guanajuato,11,Huanímaro,11016,10814,11974,22788
2021,Guanajuato,11,Irapuato,11017,300830,315482,616312
2021,Guanajuato,11,Jaral del Progreso,11018,20443,21114,41557
2021,Guanajuato,11,Jerécuaro,11019,24028,27466,51494
2021,Guanajuato,11,León,11020,841487,853107,1694594
2021,Guanajuato,11,Manuel Doblado,11008,19537,21349,40886
2021,Guanajuato,11,Moroleón,11021,26254,28581,54835
2021,Guanajuato,11,Ocampo,11022,12070,12862,24932
2021,Guanajuato,11,Pueblo Nuevo,11024,6050,6704,12754
2021,Guanajuato,11,Purísima del Rincón,11025,43658,43499,87157
2021,Guanajuato,11,Pénjamo,11023,76946,83971,160917
2021,Guanajuato,11,Romita,11026,30647,32369,63016
2021,Guanajuato,11,Salamanca,11027,144336,151513,295849
2021,Guanajuato,11,Salvatierra,11028,51489,56349,107838
2021,Guanajuato,11,San Diego de la Unión,11029,19527,22372,41899
2021,Guanajuato,11,San Felipe,11030,57916,61365,119281
2021,Guanajuato,11,San Francisco del Rincón,11031,61889,64789,126678
2021,Guanajuato,11,San José Iturbide,11032,40994,43422,84416
2021,Guanajuato,11,San Luis de la Paz,11033,61284,67276,128560
2021,Guanajuato,11,San Miguel de Allende,11003,88851,95887,184738
2021,Guanajuato,11,Santa Catarina,11034,2684,2942,5626
2021,Guanajuato,11,Santa Cruz de Juventino Rosas,11035,43148,46205,89353
2021,Guanajuato,11,Santiago Maravatío,11036,3532,3883,7415
2021,Guanajuato,11,Silao de la Victoria,11037,100337,102713,203050
2021,Guanajuato,11,Tarandacuao,11038,6256,6859,13115
2021,Guanajuato,11,Tarimoro,11039,17898,18864,36762
2021,Guanajuato,11,Tierra Blanca,11040,9891,10522,20413
2021,Guanajuato,11,Uriangato,11041,32854,34931,67785
2021,Guanajuato,11,Valle de Santiago,11042,73675,80651,154326
2021,Guanajuato,11,Victoria,11043,10279,11393,21672
2021,Guanajuato,11,Villagrán,11044,31083,32351,63434
2021,Guanajuato,11,Xichú,11045,5922,6450,12372
2021,Guanajuato,11,Yuriria,11046,35447,39005,74452
2021,Guerrero,12,Acapulco de Juárez,12001,406361,437129,843490
2021,Guerrero,12,Acatepec,12076,18963,19839,38802
2021,Guerrero,12,Ahuacuotzingo,12002,12858,14617,27475
2021,Guerrero,12,Ajuchitlán del Progreso,12003,18806,20047,38853
2021,Guerrero,12,Alcozauca de Guerrero,12004,9449,10763,20212
2021,Guerrero,12,Alpoyeca,12005,3294,3691,6985
2021,Guerrero,12,Apaxtla,12006,5616,6083,11699
2021,Guerrero,12,Arcelia,12007,15783,16757,32540
2021,Guerrero,12,Atenango del Río,12008,4283,4664,8947
2021,Guerrero,12,Atlamajalcingo del Monte,12009,2482,2762,5244
2021,Guerrero,12,Atlixtac,12010,13647,14580,28227
2021,Guerrero,12,Atoyac de Álvarez,12011,30756,31868,62624
2021,Guerrero,12,Ayutla de los Libres,12012,34492,36002,70494
2021,Guerrero,12,Azoyú,12013,6278,6678,12956
2021,Guerrero,12,Benito Juárez,12014,7789,8193,15982
2021,Guerrero,12,Buenavista de Cuéllar,12015,6719,7057,13776
2021,Guerrero,12,Chilapa de Álvarez,12028,63581,70392,133973
2021,Guerrero,12,Chilpancingo de los Bravo,12029,137015,149294,286309
2021,Guerrero,12,Coahuayutla de José María Izazaga,12016,6439,6151,12590
2021,Guerrero,12,Cochoapa el Grande,12078,9183,10128,19311
2021,Guerrero,12,Cocula,12017,6769,7272,14041
2021,Guerrero,12,Copala,12018,7224,7482,14706
2021,Guerrero,12,Copalillo,12019,7187,7921,15108
2021,Guerrero,12,Copanatoyac,12020,9967,10908,20875
2021,Guerrero,12,Coyuca de Benítez,12021,38855,40303,79158
2021,Guerrero,12,Coyuca de Catalán,12022,20423,19843,40266
2021,Guerrero,12,Cuajinicuilapa,12023,14043,13979,28022
2021,Guerrero,12,Cualác,12024,3776,4060,7836
2021,Guerrero,12,Cuautepec,12025,8264,8334,16598
2021,Guerrero,12,Cuetzala del Progreso,12026,4358,4593,8951
2021,Guerrero,12,Cutzamala de Pinzón,12027,10005,10363,20368
2021,Guerrero,12,Eduardo Neri,12075,26076,27202,53278
2021,Guerrero,12,Florencio Villarreal,12030,10668,10919,21587
2021,Guerrero,12,General Canuto A. Neri,12031,2852,3078,5930
2021,Guerrero,12,General Heliodoro Castillo,12032,18927,18913,37840
2021,Guerrero,12,Huamuxtitlán,12033,7437,8378,15815
2021,Guerrero,12,Huitzuco de los Figueroa,12034,18627,20179,38806
2021,Guerrero,12,Iguala de la Independencia,12035,76714,82252,158966
2021,Guerrero,12,Igualapa,12036,5715,5916,11631
2021,Guerrero,12,Iliatenco,12081,5400,5938,11338
2021,Guerrero,12,Ixcateopan de Cuauhtémoc,12037,3070,3387,6457
2021,Guerrero,12,José Joaquín de Herrera,12079,8903,9068,17971
2021,Guerrero,12,Juan R. Escudero,12039,12546,13256,25802
2021,Guerrero,12,Juchitán,12080,4021,3941,7962
2021,Guerrero,12,La Unión de Isidoro Montes de Oca,12068,13782,13200,26982
2021,Guerrero,12,Leonardo Bravo,12040,13325,13612,26937
2021,Guerrero,12,Malinaltepec,12041,13194,14839,28033
2021,Guerrero,12,Marquelia,12077,7120,7202,14322
2021,Guerrero,12,Metlatónoc,12043,8782,10118,18900
2021,Guerrero,12,Mochitlán,12044,6510,6783,13293
2021,Guerrero,12,Mártir de Cuilapan,12042,9267,10170,19437
2021,Guerrero,12,Olinalá,12045,12711,13744,26455
2021,Guerrero,12,Ometepec,12046,34250,35994,70244
2021,Guerrero,12,Pedro Ascencio Alquisiras,12047,3260,3788,7048
2021,Guerrero,12,Petatlán,12048,22457,22872,45329
2021,Guerrero,12,Pilcaya,12049,6474,6877,13351
2021,Guerrero,12,Pungarabato,12050,18794,19978,38772
2021,Guerrero,12,Quechultenango,12051,18088,18970,37058
2021,Guerrero,12,San Luis Acatlán,12052,22260,22888,45148
2021,Guerrero,12,San Marcos,12053,25073,25911,50984
2021,Guerrero,12,San Miguel Totolapan,12054,13863,14380,28243
2021,Guerrero,12,Taxco de Alarcón,12055,54119,58774,112893
2021,Guerrero,12,Tecoanapa,12056,23497,24173,47670
2021,Guerrero,12,Teloloapan,12058,28002,31407,59409
2021,Guerrero,12,Tepecoacuilco de Trujano,12059,15900,17204,33104
2021,Guerrero,12,Tetipac,12060,7268,7697,14965
2021,Guerrero,12,Tixtla de Guerrero,12061,21473,23229,44702
2021,Guerrero,12,Tlacoachistlahuaca,12062,11473,12926,24399
2021,Guerrero,12,Tlacoapa,12063,4985,5496,10481
2021,Guerrero,12,Tlalchapa,12064,6402,6394,12796
2021,Guerrero,12,Tlalixtaquilla de Maldonado,12065,3675,3985,7660
2021,Guerrero,12,Tlapa de Comonfort,12066,44728,49609,94337
2021,Guerrero,12,Tlapehuala,12067,10967,11749,22716
2021,Guerrero,12,Técpan de Galeana,12057,33383,33873,67256
2021,Guerrero,12,Xalpatláhuac,12069,5637,6602,12239
2021,Guerrero,12,Xochihuehuetlán,12070,3471,3937,7408
2021,Guerrero,12,Xochistlahuaca,12071,14720,15610,30330
2021,Guerrero,12,Zapotitlán Tablas,12072,6108,6737,12845
2021,Guerrero,12,Zihuatanejo de Azueta,12038,64835,66496,131331
2021,Guerrero,12,Zirándaro,12073,9256,8851,18107
2021,Guerrero,12,Zitlala,12074,11318,12670,23988
2021,Hidalgo,13,Acatlán,13001,10750,11541,22291
2021,Hidalgo,13,Acaxochitlán,13002,22435,24260,46695
2021,Hidalgo,13,Actopan,13003,29396,32554,61950
2021,Hidalgo,13,Agua Blanca de Iturbide,13004,4634,5138,9772
2021,Hidalgo,13,Ajacuba,13005,9832,10267,20099
2021,Hidalgo,13,Alfajayucan,13006,10854,11515,22369
2021,Hidalgo,13,Almoloya,13007,6589,6667,13256
2021,Hidalgo,13,Apan,13008,23261,25224,48485
2021,Hidalgo,13,Atitalaquia,13010,16135,16473,32608
2021,Hidalgo,13,Atlapexco,13011,10522,11332,21854
2021,Hidalgo,13,Atotonilco de Tula,13013,20253,21405,41658
2021,Hidalgo,13,Atotonilco el Grande,13012,14057,15697,29754
2021,Hidalgo,13,Calnali,13014,9084,9778,18862
2021,Hidalgo,13,Cardonal,13015,9607,10454,20061
2021,Hidalgo,13,Chapantongo,13017,7223,7621,14844
2021,Hidalgo,13,Chapulhuacán,13018,12927,12778,25705
2021,Hidalgo,13,Chilcuautla,13019,9740,10106,19846
2021,Hidalgo,13,Cuautepec de Hinojosa,13016,30085,32976,63061
2021,Hidalgo,13,El Arenal,13009,9785,10652,20437
2021,Hidalgo,13,Eloxochitlán,13020,1406,1600,3006
2021,Hidalgo,13,Emiliano Zapata,13021,7589,8396,15985
2021,Hidalgo,13,Epazoyucan,13022,7907,8364,16271
2021,Hidalgo,13,Francisco I. Madero,13023,18815,20520,39335
2021,Hidalgo,13,Huasca de Ocampo,13024,9202,10060,19262
2021,Hidalgo,13,Huautla,13025,11183,12140,23323
2021,Hidalgo,13,Huazalingo,13026,7404,7769,15173
2021,Hidalgo,13,Huehuetla,13027,13333,14222,27555
2021,Hidalgo,13,Huejutla de Reyes,13028,69263,71604,140867
2021,Hidalgo,13,Huichapan,13029,24103,26196,50299
2021,Hidalgo,13,Ixmiquilpan,13030,47604,53267,100871
2021,Hidalgo,13,Jacala de Ledezma,13031,6929,7711,14640
2021,Hidalgo,13,Jaltocán,13032,6387,6560,12947
2021,Hidalgo,13,Juárez Hidalgo,13033,1647,1800,3447
2021,Hidalgo,13,La Misión,13040,5410,5577,10987
2021,Hidalgo,13,Lolotla,13034,5028,5277,10305
2021,Hidalgo,13,Metepec,13035,5913,6712,12625
2021,Hidalgo,13,Metztitlán,13037,10596,11763,22359
2021,Hidalgo,13,Mineral de la Reforma,13051,90764,99405,190169
2021,Hidalgo,13,Mineral del Chico,13038,4759,5047,9806
2021,Hidalgo,13,Mineral del Monte,13039,7599,8322,15921
2021,Hidalgo,13,Mixquiahuala de Juárez,13041,24300,26229,50529
2021,Hidalgo,13,Molango de Escamilla,13042,6193,6453,12646
2021,Hidalgo,13,Nicolás Flores,13043,3509,3956,7465
2021,Hidalgo,13,Nopala de Villagrán,13044,8993,9315,18308
2021,Hidalgo,13,Omitlán de Juárez,13045,5108,5582,10690
2021,Hidalgo,13,Pachuca de Soto,13048,134526,147288,281814
2021,Hidalgo,13,Pacula,13047,2503,2887,5390
2021,Hidalgo,13,Pisaflores,13049,9460,9463,18923
2021,Hidalgo,13,Progreso de Obregón,13050,12153,13501,25654
2021,Hidalgo,13,San Agustín Metzquititlán,13036,4994,5440,10434
2021,Hidalgo,13,San Agustín Tlaxiaca,13052,19436,20319,39755
2021,Hidalgo,13,San Bartolo Tutotepec,13053,10000,10226,20226
2021,Hidalgo,13,San Felipe Orizatlán,13046,20609,21365,41974
2021,Hidalgo,13,San Salvador,13054,18566,19862,38428
2021,Hidalgo,13,Santiago Tulantepec de Lugo Guerrero,13056,19395,21176,40571
2021,Hidalgo,13,Santiago de Anaya,13055,9080,9523,18603
2021,Hidalgo,13,Singuilucan,13057,8677,8905,17582
2021,Hidalgo,13,Tasquillo,13058,8129,9585,17714
2021,Hidalgo,13,Tecozautla,13059,19649,21310,40959
2021,Hidalgo,13,Tenango de Doria,13060,9416,10410,19826
2021,Hidalgo,13,Tepeapulco,13061,28735,30591,59326
2021,Hidalgo,13,Tepehuacán de Guerrero,13062,16812,16283,33095
2021,Hidalgo,13,Tepeji del Río de Ocampo,13063,46670,47971,94641
2021,Hidalgo,13,Tepetitlán,13064,5820,6122,11942
2021,Hidalgo,13,Tetepango,13065,6303,6351,12654
2021,Hidalgo,13,Tezontepec de Aldama,13067,28523,29174,57697
2021,Hidalgo,13,Tianguistengo,13068,7921,8276,16197
2021,Hidalgo,13,Tizayuca,13069,69195,70955,140150
2021,Hidalgo,13,Tlahuelilpan,13070,10336,10656,20992
2021,Hidalgo,13,Tlahuiltepa,13071,5484,5549,11033
2021,Hidalgo,13,Tlanalapa,13072,5458,5814,11272
2021,Hidalgo,13,Tlanchinol,13073,21112,21475,42587
2021,Hidalgo,13,Tlaxcoapan,13074,15311,15707,31018
2021,Hidalgo,13,Tolcayuca,13075,8726,9223,17949
2021,Hidalgo,13,Tula de Allende,13076,58389,61696,120085
2021,Hidalgo,13,Tulancingo de Bravo,13077,81355,90172,171527
2021,Hidalgo,13,Villa de Tezontepec,13066,6660,6923,13583
2021,Hidalgo,13,Xochiatipan,13078,10417,10991,21408
2021,Hidalgo,13,Xochicoatlán,13079,4126,4258,8384
2021,Hidalgo,13,Yahualica,13080,12911,13444,26355
2021,Hidalgo,13,Zacualtipán de Ángeles,13081,18215,19898,38113
2021,Hidalgo,13,Zapotlán de Juárez,13082,9908,10686,20594
2021,Hidalgo,13,Zempoala,13083,25057,26478,51535
2021,Hidalgo,13,Zimapán,13084,19874,23093,42967
2021,Jalisco,14,Acatic,14001,11391,11835,23226
2021,Jalisco,14,Acatlán de Juárez,14002,12479,11735,24214
2021,Jalisco,14,Ahualulco de Mercado,14003,12300,12695,24995
2021,Jalisco,14,Amacueca,14004,2872,3013,5885
2021,Jalisco,14,Amatitán,14005,8254,8339,16593
2021,Jalisco,14,Ameca,14006,32168,33453,65621
2021,Jalisco,14,Arandas,14008,38905,41731,80636
2021,Jalisco,14,Atemajac de Brizuela,14010,3573,3619,7192
2021,Jalisco,14,Atengo,14011,3106,2874,5980
2021,Jalisco,14,Atenguillo,14012,2108,2177,4285
2021,Jalisco,14,Atotonilco el Alto,14013,32157,33207,65364
2021,Jalisco,14,Atoyac,14014,4214,4557,8771
2021,Jalisco,14,Autlán de Navarro,14015,32617,33621,66238
2021,Jalisco,14,Ayotlán,14016,20038,20911,40949
2021,Jalisco,14,Ayutla,14017,6744,6734,13478
2021,Jalisco,14,Bolaños,14019,4157,4167,8324
2021,Jalisco,14,Cabo Corrientes,14020,5827,5380,11207
2021,Jalisco,14,Casimiro Castillo,14021,11722,11740,23462
2021,Jalisco,14,Cañadas de Obregón,14117,2197,2289,4486
2021,Jalisco,14,Chapala,14030,27080,28316,55396
2021,Jalisco,14,Chimaltitán,14031,1768,1814,3582
2021,Jalisco,14,Chiquilistlán,14032,3292,3239,6531
2021,Jalisco,14,Cihuatlán,14022,22593,22032,44625
2021,Jalisco,14,Cocula,14024,14049,14740,28789
2021,Jalisco,14,Colotlán,14025,9392,10052,19444
2021,Jalisco,14,Concepción de Buenos Aires,14026,3385,3246,6631
2021,Jalisco,14,Cuautitlán de García Barragán,14027,9770,9498,19268
2021,Jalisco,14,Cuautla,14028,1125,1203,2328
2021,Jalisco,14,Cuquío,14029,9353,10205,19558
2021,Jalisco,14,Degollado,14033,11174,11865,23039
2021,Jalisco,14,Ejutla,14034,1072,999,2071
2021,Jalisco,14,El Arenal,14009,10571,10704,21275
2021,Jalisco,14,El Grullo,14037,12940,13629,26569
2021,Jalisco,14,El Limón,14054,2980,2977,5957
2021,Jalisco,14,El Salto,14070,101243,102142,203385
2021,Jalisco,14,Encarnación de Díaz,14035,27858,29907,57765
2021,Jalisco,14,Etzatlán,14036,10453,10928,21381
2021,Jalisco,14,Guachinango,14038,2326,2248,4574
2021,Jalisco,14,Guadalajara,14039,734138,775200,1509338
2021,Jalisco,14,Gómez Farías,14079,7502,7984,15486
2021,Jalisco,14,Hostotipaquillo,14040,5956,5144,11100
2021,Jalisco,14,Huejuquilla el Alto,14042,4596,4949,9545
2021,Jalisco,14,Huejúcar,14041,2985,3279,6264
2021,Jalisco,14,Ixtlahuacán de los Membrillos,14044,30336,30938,61274
2021,Jalisco,14,Ixtlahuacán del Río,14045,9959,10577,20536
2021,Jalisco,14,Jalostotitlán,14046,18010,18433,36443
2021,Jalisco,14,Jamay,14047,13394,13384,26778
2021,Jalisco,14,Jesús María,14048,9407,11146,20553
2021,Jalisco,14,Jilotlán de los Dolores,14049,5207,4989,10196
2021,Jalisco,14,Jocotepec,14050,24831,25133,49964
2021,Jalisco,14,Juanacatlán,14051,9759,9742,19501
2021,Jalisco,14,Juchitlán,14052,2951,3123,6074
2021,Jalisco,14,La Barca,14018,34171,36305,70476
2021,Jalisco,14,La Huerta,14043,13395,12923,26318
2021,Jalisco,14,La Manzanilla de la Paz,14057,1958,2108,4066
2021,Jalisco,14,Lagos de Moreno,14053,86827,90520,177347
2021,Jalisco,14,Magdalena,14055,12176,12172,24348
2021,Jalisco,14,Mascota,14058,7769,8028,15797
2021,Jalisco,14,Mazamitla,14059,7263,7864,15127
2021,Jalisco,14,Mexticacán,14060,2514,2940,5454
2021,Jalisco,14,Mezquitic,14061,10196,10792,20988
2021,Jalisco,14,Mixtlán,14062,1914,1887,3801
2021,Jalisco,14,Ocotlán,14063,52624,54318,106942
2021,Jalisco,14,Ojuelos de Jalisco,14064,16756,17586,34342
2021,Jalisco,14,Pihuamo,14065,6089,5995,12084
2021,Jalisco,14,Poncitlán,14066,27485,28190,55675
2021,Jalisco,14,Puerto Vallarta,14067,153179,149541,302720
2021,Jalisco,14,Quitupan,14069,4182,4662,8844
2021,Jalisco,14,San Cristóbal de la Barranca,14071,1577,1587,3164
2021,Jalisco,14,San Diego de Alejandría,14072,3755,4024,7779
2021,Jalisco,14,San Gabriel,14113,8629,8964,17593
2021,Jalisco,14,San Ignacio Cerro Gordo,14125,9892,10493,20385
2021,Jalisco,14,San Juan de los Lagos,14073,37229,37700,74929
2021,Jalisco,14,San Juanito de Escobedo,14007,5063,4991,10054
2021,Jalisco,14,San Julián,14074,8170,9001,17171
2021,Jalisco,14,San Marcos,14075,2068,2018,4086
2021,Jalisco,14,San Martín Hidalgo,14077,14546,15253,29799
2021,Jalisco,14,San Martín de Bolaños,14076,1632,1627,3259
2021,Jalisco,14,San Miguel el Alto,14078,17293,18141,35434
2021,Jalisco,14,San Pedro Tlaquepaque,14098,355993,359147,715140
2021,Jalisco,14,San Sebastián del Oeste,14080,3150,2841,5991
2021,Jalisco,14,Santa María de los Ángeles,14081,1623,1794,3417
2021,Jalisco,14,Santa María del Oro,14056,1115,1102,2217
2021,Jalisco,14,Sayula,14082,19133,20560,39693
2021,Jalisco,14,Tala,14083,43177,43753,86930
2021,Jalisco,14,Talpa de Allende,14084,8145,8027,16172
2021,Jalisco,14,Tamazula de Gordiano,14085,20295,21189,41484
2021,Jalisco,14,Tapalpa,14086,10209,10622,20831
2021,Jalisco,14,Tecalitlán,14087,8728,9111,17839
2021,Jalisco,14,Techaluta de Montenegro,14089,1994,2053,4047
2021,Jalisco,14,Tecolotlán,14088,9344,9331,18675
2021,Jalisco,14,Tenamaxtlán,14090,3783,3762,7545
2021,Jalisco,14,Teocaltiche,14091,21276,23319,44595
2021,Jalisco,14,Teocuitatlán de Corona,14092,5536,5720,11256
2021,Jalisco,14,Tepatitlán de Morelos,14093,74817,77432,152249
2021,Jalisco,14,Tequila,14094,22411,22669,45080
2021,Jalisco,14,Teuchitlán,14095,5135,5324,10459
2021,Jalisco,14,Tizapán el Alto,14096,11096,11642,22738
2021,Jalisco,14,Tlajomulco de Zúñiga,14097,327153,332394,659547
2021,Jalisco,14,Tolimán,14099,5479,5558,11037
2021,Jalisco,14,Tomatlán,14100,19576,18617,38193
2021,Jalisco,14,Tonalá,14101,292053,291655,583708
2021,Jalisco,14,Tonaya,14102,3176,3306,6482
2021,Jalisco,14,Tonila,14103,4244,4266,8510
2021,Jalisco,14,Totatiche,14104,2362,2384,4746
2021,Jalisco,14,Tototlán,14105,12323,12612,24935
2021,Jalisco,14,Tuxcacuesco,14106,2394,2289,4683
2021,Jalisco,14,Tuxcueca,14107,3256,3470,6726
2021,Jalisco,14,Tuxpan,14108,18214,19339,37553
2021,Jalisco,14,Unión de San Antonio,14109,9394,10036,19430
2021,Jalisco,14,Unión de Tula,14110,7039,7504,14543
2021,Jalisco,14,Valle de Guadalupe,14111,3772,3790,7562
2021,Jalisco,14,Valle de Juárez,14112,2895,3049,5944
2021,Jalisco,14,Villa Corona,14114,9553,9782,19335
2021,Jalisco,14,Villa Guerrero,14115,2925,3010,5935
2021,Jalisco,14,Villa Hidalgo,14116,10657,11371,22028
2021,Jalisco,14,Villa Purificación,14068,6081,5650,11731
2021,Jalisco,14,Yahualica de González Gallo,14118,11519,12553,24072
2021,Jalisco,14,Zacoalco de Torres,14119,15248,15465,30713
2021,Jalisco,14,Zapopan,14120,711604,734640,1446244
2021,Jalisco,14,Zapotiltic,14121,15467,16090,31557
2021,Jalisco,14,Zapotitlán de Vadillo,14122,3791,3754,7545
2021,Jalisco,14,Zapotlanejo,14124,36086,37013,73099
2021,Jalisco,14,Zapotlán del Rey,14123,9735,9784,19519
2021,Jalisco,14,Zapotlán el Grande,14023,56106,58857,114963
2021,Michoacán,16,Acuitzio,16001,5832,6268,12100
2021,Michoacán,16,Aguililla,16002,7697,7528,15225
2021,Michoacán,16,Angamacutiro,16004,7595,8395,15990
2021,Michoacán,16,Angangueo,16005,5756,6092,11848
2021,Michoacán,16,Apatzingán,16006,66782,67730,134512
2021,Michoacán,16,Aporo,16007,1674,1784,3458
2021,Michoacán,16,Aquila,16008,13387,12955,26342
2021,Michoacán,16,Ario,16009,18978,19975,38953
2021,Michoacán,16,Arteaga,16010,11391,11495,22886
2021,Michoacán,16,Briseñas,16011,5883,6176,12059
2021,Michoacán,16,Buenavista,16012,25533,24367,49900
2021,Michoacán,16,Carácuaro,16013,4847,4818,9665
2021,Michoacán,16,Charapan,16021,6144,6947,13091
2021,Michoacán,16,Charo,16022,12111,11291,23402
2021,Michoacán,16,Chavinda,16023,5303,5555,10858
2021,Michoacán,16,Cherán,16024,9715,10448,20163
2021,Michoacán,16,Chilchota,16025,19983,21533,41516
2021,Michoacán,16,Chinicuila,16026,2603,2389,4992
2021,Michoacán,16,Chucándiro,16027,2071,2458,4529
2021,Michoacán,16,Churintzio,16028,2533,2845,5378
2021,Michoacán,16,Churumuco,16029,8011,7986,15997
2021,Michoacán,16,Coahuayana,16014,7936,7338,15274
2021,Michoacán,16,Coalcomán de Vázquez Pallares,16015,9116,9317,18433
2021,Michoacán,16,Coeneo,16016,10130,11768,21898
2021,Michoacán,16,Cojumatlán de Régules,16074,5399,5611,11010
2021,Michoacán,16,Contepec,16017,17539,18522,36061
2021,Michoacán,16,Copándaro,16018,4506,5030,9536
2021,Michoacán,16,Cotija,16019,9363,10339,19702
2021,Michoacán,16,Cuitzeo,16020,15013,16551,31564
2021,Michoacán,16,Ecuandureo,16030,6051,7160,13211
2021,Michoacán,16,Epitacio Huerta,16031,8614,9000,17614
2021,Michoacán,16,Erongarícuaro,16032,7825,8403,16228
2021,Michoacán,16,Gabriel Zamora,16033,12000,12060,24060
2021,Michoacán,16,Hidalgo,16034,63301,66525,129826
2021,Michoacán,16,Huandacareo,16036,5888,6700,12588
2021,Michoacán,16,Huaniqueo,16037,3905,4580,8485
2021,Michoacán,16,Huetamo,16038,20885,21810,42695
2021,Michoacán,16,Huiramba,16039,4589,4743,9332
2021,Michoacán,16,Indaparapeo,16040,8593,9084,17677
2021,Michoacán,16,Irimbo,16041,7655,8377,16032
2021,Michoacán,16,Ixtlán,16042,6697,6868,13565
2021,Michoacán,16,Jacona,16043,35546,37536,73082
2021,Michoacán,16,Jiménez,16044,6435,6992,13427
2021,Michoacán,16,Jiquilpan,16045,16607,18240,34847
2021,Michoacán,16,José Sixto Verduzco,16113,13178,14528,27706
2021,Michoacán,16,Jungapeo,16047,11159,11320,22479
2021,Michoacán,16,Juárez,16046,7519,7898,15417
2021,Michoacán,16,La Huacana,16035,17815,17967,35782
2021,Michoacán,16,La Piedad,16069,53300,57933,111233
2021,Michoacán,16,Lagunillas,16048,2907,2994,5901
2021,Michoacán,16,Los Reyes,16075,36168,37757,73925
2021,Michoacán,16,Lázaro Cárdenas,16052,96841,95992,192833
2021,Michoacán,16,Madero,16049,9537,9340,18877
2021,Michoacán,16,Maravatío,16050,44972,48550,93522
2021,Michoacán,16,Marcos Castellanos,16051,7076,7576,14652
2021,Michoacán,16,Morelia,16053,400494,430834,831328
2021,Michoacán,16,Morelos,16054,3559,4298,7857
2021,Michoacán,16,Múgica,16055,23800,24305,48105
2021,Michoacán,16,Nahuatzen,16056,14615,15486,30101
2021,Michoacán,16,Nocupétaro,16057,4242,4304,8546
2021,Michoacán,16,Nuevo Parangaricutiro,16058,10325,10689,21014
2021,Michoacán,16,Nuevo Urecho,16059,4251,4267,8518
2021,Michoacán,16,Numarán,16060,4925,5416,10341
2021,Michoacán,16,Ocampo,16061,12771,12777,25548
2021,Michoacán,16,Pajacuarán,16062,9879,10540,20419
2021,Michoacán,16,Panindícuaro,16063,7828,8792,16620
2021,Michoacán,16,Paracho,16065,18940,20713,39653
2021,Michoacán,16,Parácuaro,16064,14252,13923,28175
2021,Michoacán,16,Penjamillo,16067,8351,9505,17856
2021,Michoacán,16,Peribán,16068,14928,14733,29661
2021,Michoacán,16,Puruándiro,16071,33403,37207,70610
2021,Michoacán,16,Purépero,16070,7905,8246,16151
2021,Michoacán,16,Pátzcuaro,16066,47449,51349,98798
2021,Michoacán,16,Queréndaro,16072,7034,7389,14423
2021,Michoacán,16,Quiroga,16073,14019,15331,29350
2021,Michoacán,16,Sahuayo,16076,40157,41917,82074
2021,Michoacán,16,Salvador Escalante,16079,25325,26754,52079
2021,Michoacán,16,San Lucas,16077,9440,9582,19022
2021,Michoacán,16,Santa Ana Maya,16078,6169,7027,13196
2021,Michoacán,16,Senguio,16080,9738,10376,20114
2021,Michoacán,16,Susupuato,16081,4585,4618,9203
2021,Michoacán,16,Tacámbaro,16082,40082,41841,81923
2021,Michoacán,16,Tancítaro,16083,16681,16244,32925
2021,Michoacán,16,Tangamandapio,16084,15008,16134,31142
2021,Michoacán,16,Tangancícuaro,16085,17241,18298,35539
2021,Michoacán,16,Tanhuato,16086,7989,8382,16371
2021,Michoacán,16,Taretan,16087,7709,7886,15595
2021,Michoacán,16,Tarímbaro,16088,58395,63048,121443
2021,Michoacán,16,Tepalcatepec,16089,12671,12379,25050
2021,Michoacán,16,Tingambato,16090,7781,8221,16002
2021,Michoacán,16,Tingüindín,16091,7444,8024,15468
2021,Michoacán,16,Tiquicheo de Nicolás Romero,16092,6989,7092,14081
2021,Michoacán,16,Tlalpujahua,16093,14474,16049,30523
2021,Michoacán,16,Tlazazalca,16094,3247,3445,6692
2021,Michoacán,16,Tocumbo,16095,6301,6404,12705
2021,Michoacán,16,Tumbiscatío,16096,3522,3395,6917
2021,Michoacán,16,Turicato,16097,15909,16694,32603
2021,Michoacán,16,Tuxpan,16098,13787,14804,28591
2021,Michoacán,16,Tuzantla,16099,7945,8024,15969
2021,Michoacán,16,Tzintzuntzan,16100,7249,8006,15255
2021,Michoacán,16,Tzitzio,16101,4568,4433,9001
2021,Michoacán,16,Uruapan,16102,173489,183922,357411
2021,Michoacán,16,Venustiano Carranza,16103,12915,13383,26298
2021,Michoacán,16,Villamar,16104,8418,9111,17529
2021,Michoacán,16,Vista Hermosa,16105,10742,11129,21871
2021,Michoacán,16,Yurécuaro,16106,16283,17110,33393
2021,Michoacán,16,Zacapu,16107,38668,41542,80210
2021,Michoacán,16,Zamora,16108,101886,107578,209464
2021,Michoacán,16,Zinapécuaro,16110,23880,25829,49709
2021,Michoacán,16,Zináparo,16109,1557,1809,3366
2021,Michoacán,16,Ziracuaretiro,16111,9126,9304,18430
2021,Michoacán,16,Zitácuaro,16112,82910,90200,173110
2021,Michoacán,16,Álvaro Obregón,16003,11171,11920,23091
2021,Morelos,17,Amacuzac,17001,9292,9735,19027
2021,Morelos,17,Atlatlahucan,17002,12040,12499,24539
2021,Morelos,17,Axochiapan,17003,19088,19542,38630
2021,Morelos,17,Ayala,17004,44541,47467,92008
2021,Morelos,17,Coatlán del Río,17005,5232,5366,10598
2021,Morelos,17,Cuautla,17006,101696,108930,210626
2021,Morelos,17,Cuernavaca,17007,189630,213012,402642
2021,Morelos,17,Emiliano Zapata,17008,53313,54968,108281
2021,Morelos,17,Huitzilac,17009,10273,10325,20598
2021,Morelos,17,Jantetelco,17010,9097,9484,18581
2021,Morelos,17,Jiutepec,17011,111284,118203,229487
2021,Morelos,17,Jojutla,17012,29923,32004,61927
2021,Morelos,17,Jonacatepec,17013,8136,8762,16898
2021,Morelos,17,Mazatepec,17014,5285,5507,10792
2021,Morelos,17,Miacatlán,17015,13907,14616,28523
2021,Morelos,17,Ocuituco,17016,9834,10073,19907
2021,Morelos,17,Puente de Ixtla,17017,35140,36499,71639
2021,Morelos,17,Temixco,17018,61199,63767,124966
2021,Morelos,17,Temoac,17033,8347,8815,17162
2021,Morelos,17,Tepalcingo,17019,14278,14884,29162
2021,Morelos,17,Tepoztlán,17020,25657,26521,52178
2021,Morelos,17,Tetecala,17021,4199,4217,8416
2021,Morelos,17,Tetela del Volcán,17022,10825,11428,22253
2021,Morelos,17,Tlalnepantla,17023,3956,3844,7800
2021,Morelos,17,Tlaltizapán de Zapata,17024,27390,28708,56098
2021,Morelos,17,Tlaquiltenango,17025,18047,18482,36529
2021,Morelos,17,Tlayacapan,17026,9579,9763,19342
2021,Morelos,17,Totolapan,17027,6385,6555,12940
2021,Morelos,17,Xochitepec,17028,38266,37333,75599
2021,Morelos,17,Yautepec,17029,54053,56924,110977
2021,Morelos,17,Yecapixtla,17030,28242,28839,57081
2021,Morelos,17,Zacatepec,17031,19008,20500,39508
2021,Morelos,17,Zacualpan,17032,5041,5259,10300
2021,Nayarit,18,Acaponeta,18001,20476,20342,40818
2021,Nayarit,18,Ahuacatlán,18002,8762,8662,17424
2021,Nayarit,18,Amatlán de Cañas,18003,6570,6325,12895
2021,Nayarit,18,Bahía de Banderas,18020,90911,87432,178343
2021,Nayarit,18,Compostela,18004,41664,41266,82930
2021,Nayarit,18,Del Nayar,18009,23035,22913,45948
2021,Nayarit,18,Huajicori,18005,6979,6717,13696
2021,Nayarit,18,Ixtlán del Río,18006,15584,16553,32137
2021,Nayarit,18,Jala,18007,10040,10187,20227
2021,Nayarit,18,La Yesca,18019,7754,7311,15065
2021,Nayarit,18,Rosamorada,18010,19158,18289,37447
2021,Nayarit,18,Ruíz,18011,13815,13445,27260
2021,Nayarit,18,San Blas,18012,25646,22967,48613
2021,Nayarit,18,San Pedro Lagunillas,18013,4224,4096,8320
2021,Nayarit,18,Santa María del Oro,18014,13165,12597,25762
2021,Nayarit,18,Santiago Ixcuintla,18015,54661,52706,107367
2021,Nayarit,18,Tecuala,18016,22117,21367,43484
2021,Nayarit,18,Tepic,18017,220785,230942,451727
2021,Nayarit,18,Tuxpan,18018,16818,16916,33734
2021,Nayarit,18,Xalisco,18008,30865,32083,62948
2021,Nuevo León,19,Abasolo,19001,1463,1463,2926
2021,Nuevo León,19,Agualeguas,19002,1331,1264,2595
2021,Nuevo León,19,Allende,19004,19546,19251,38797
2021,Nuevo León,19,Anáhuac,19005,10025,10109,20134
2021,Nuevo León,19,Apodaca,19006,340840,335222,676062
2021,Nuevo León,19,Aramberri,19007,9104,8927,18031
2021,Nuevo León,19,Bustamante,19008,2225,2216,4441
2021,Nuevo León,19,Cadereyta Jiménez,19009,54544,51981,106525
2021,Nuevo León,19,Cerralvo,19011,4312,4040,8352
2021,Nuevo León,19,China,19013,6193,5893,12086
2021,Nuevo León,19,Ciénega de Flores,19012,26436,25429,51865
2021,Nuevo León,19,Doctor Arroyo,19014,19303,18963,38266
2021,Nuevo León,19,Doctor Coss,19015,955,919,1874
2021,Nuevo León,19,Doctor González,19016,1696,1618,3314
2021,Nuevo León,19,El Carmen,19010,24610,24085,48695
2021,Nuevo León,19,Galeana,19017,22992,22491,45483
2021,Nuevo León,19,García,19018,155645,153808,309453
2021,Nuevo León,19,General Bravo,19020,3181,3023,6204
2021,Nuevo León,19,General Escobedo,19021,237001,235872,472873
2021,Nuevo León,19,General Terán,19022,8214,8265,16479
2021,Nuevo León,19,General Treviño,19023,585,614,1199
2021,Nuevo León,19,General Zaragoza,19024,3449,3223,6672
2021,Nuevo León,19,General Zuazua,19025,47683,46833,94516
2021,Nuevo León,19,Guadalupe,19026,362494,352948,715442
2021,Nuevo León,19,Hidalgo,19047,8021,7939,15960
2021,Nuevo León,19,Higueras,19028,900,832,1732
2021,Nuevo León,19,Hualahuises,19029,3882,3951,7833
2021,Nuevo León,19,Iturbide,19030,2093,1932,4025
2021,Nuevo León,19,Juárez,19031,205663,200921,406584
2021,Nuevo León,19,Lampazos de Naranjo,19032,2968,2887,5855
2021,Nuevo León,19,Linares,19033,44821,44918,89739
2021,Nuevo León,19,Los Aldamas,19003,777,758,1535
2021,Nuevo León,19,Los Herreras,19027,998,1021,2019
2021,Nuevo León,19,Los Ramones,19042,2641,2580,5221
2021,Nuevo León,19,Marín,19034,3226,3022,6248
2021,Nuevo León,19,Melchor Ocampo,19035,553,534,1087
2021,Nuevo León,19,Mier y Noriega,19036,3869,3793,7662
2021,Nuevo León,19,Mina,19037,3030,2893,5923
2021,Nuevo León,19,Montemorelos,19038,34328,34190,68518
2021,Nuevo León,19,Monterrey,19039,556978,579330,1136308
2021,Nuevo León,19,Parás,19040,551,542,1093
2021,Nuevo León,19,Pesquería,19041,58256,57703,115959
2021,Nuevo León,19,Rayones,19043,1565,1464,3029
2021,Nuevo León,19,Sabinas Hidalgo,19044,19452,20066,39518
2021,Nuevo León,19,Salinas Victoria,19045,32287,30927,63214
2021,Nuevo León,19,San Nicolás de los Garza,19046,234110,241941,476051
2021,Nuevo León,19,San Pedro Garza García,19019,65641,73304,138945
2021,Nuevo León,19,Santa Catarina,19048,163702,161766,325468
2021,Nuevo León,19,Santiago,19049,23869,23631,47500
2021,Nuevo León,19,Vallecillo,19050,1064,899,1963
2021,Nuevo León,19,Villaldama,19051,2315,2300,4615
2021,Oaxaca,20,Abejones,20001,435,584,1019
2021,Oaxaca,20,Acatlán de Pérez Figueroa,20002,23371,24436,47807
2021,Oaxaca,20,Asunción Cacalotepec,20003,1052,1120,2172
2021,Oaxaca,20,Asunción Cuyotepeji,20004,481,554,1035
2021,Oaxaca,20,Asunción Ixtaltepec,20005,7906,7998,15904
2021,Oaxaca,20,Asunción Nochixtlán,20006,9355,10465,19820
2021,Oaxaca,20,Asunción Ocotlán,20007,1100,1370,2470
2021,Oaxaca,20,Asunción Tlacolulita,20008,393,413,806
2021,Oaxaca,20,Ayoquezco de Aldama,20398,2083,2351,4434
2021,Oaxaca,20,Ayotzintepec,20009,3720,3777,7497
2021,Oaxaca,20,Calihualá,20011,587,615,1202
2021,Oaxaca,20,Candelaria Loxicha,20012,5281,5612,10893
2021,Oaxaca,20,Capulálpam de Méndez,20247,735,899,1634
2021,Oaxaca,20,Chahuites,20025,6012,6100,12112
2021,Oaxaca,20,Chalcatongo de Hidalgo,20026,4445,5063,9508
2021,Oaxaca,20,Chiquihuitlán de Benito Juárez,20027,1111,1315,2426
2021,Oaxaca,20,Ciudad Ixtepec,20014,14688,15952,30640
2021,Oaxaca,20,Ciénega de Zimatlán,20013,1497,1629,3126
2021,Oaxaca,20,Coatecas Altas,20015,2200,2502,4702
2021,Oaxaca,20,Coicoyán de las Flores,20016,4921,5559,10480
2021,Oaxaca,20,Concepción Buenavista,20018,402,426,828
2021,Oaxaca,20,Concepción Pápalo,20019,1541,1544,3085
2021,Oaxaca,20,Constancia del Rosario,20020,1896,2201,4097
2021,Oaxaca,20,Cosolapa,20021,7844,8471,16315
2021,Oaxaca,20,Cosoltepec,20022,360,423,783
2021,Oaxaca,20,Cuilápam de Guerrero,20023,11198,11852,23050
2021,Oaxaca,20,Cuyamecalco Villa de Zaragoza,20024,1923,1882,3805
2021,Oaxaca,20,El Barrio de la Soledad,20010,7192,7761,14953
2021,Oaxaca,20,El Espinal,20030,4488,4682,9170
2021,Oaxaca,20,Eloxochitlán de Flores Magón,20029,2106,2360,4466
2021,Oaxaca,20,Fresnillo de Trujano,20032,518,554,1072
2021,Oaxaca,20,Guadalupe Etla,20033,1350,1497,2847
2021,Oaxaca,20,Guadalupe de Ramírez,20034,654,672,1326
2021,Oaxaca,20,Guelatao de Juárez,20035,281,291,572
2021,Oaxaca,20,Guevea de Humboldt,20036,2677,2804,5481
2021,Oaxaca,20,Heroica Ciudad de Ejutla de Crespo,20028,10457,11669,22126
2021,Oaxaca,20,Heroica Ciudad de Huajuapan de León,20039,38856,43186,82042
2021,Oaxaca,20,Heroica Ciudad de Juchitán de Zaragoza,20043,50678,53184,103862
2021,Oaxaca,20,Heroica Ciudad de Tlaxiaco,20397,20171,22810,42981
2021,Oaxaca,20,Huautepec,20040,3009,3452,6461
2021,Oaxaca,20,Huautla de Jiménez,20041,15117,17364,32481
2021,Oaxaca,20,Ixpantepec Nieves,20065,523,655,1178
2021,Oaxaca,20,Ixtlán de Juárez,20042,4214,4351,8565
2021,Oaxaca,20,La Compañía,20017,1613,1787,3400
2021,Oaxaca,20,La Pe,20069,1337,1429,2766
2021,Oaxaca,20,La Reforma,20076,1584,1742,3326
2021,Oaxaca,20,La Trinidad Vista Hermosa,20556,117,144,261
2021,Oaxaca,20,Loma Bonita,20044,21394,23420,44814
2021,Oaxaca,20,Magdalena Apasco,20045,4464,4966,9430
2021,Oaxaca,20,Magdalena Jaltepec,20046,1528,1791,3319
2021,Oaxaca,20,Magdalena Mixtepec,20048,688,713,1401
2021,Oaxaca,20,Magdalena Ocotlán,20049,585,630,1215
2021,Oaxaca,20,Magdalena Peñasco,20050,1687,1962,3649
2021,Oaxaca,20,Magdalena Teitipac,20051,2316,2485,4801
2021,Oaxaca,20,Magdalena Tequisistlán,20052,3111,3271,6382
2021,Oaxaca,20,Magdalena Tlacotepec,20053,625,681,1306
2021,Oaxaca,20,Magdalena Yodocono de Porfirio Díaz,20562,784,831,1615
2021,Oaxaca,20,Magdalena Zahuatlán,20054,200,228,428
2021,Oaxaca,20,Mariscala de Juárez,20055,1778,1931,3709
2021,Oaxaca,20,Matías Romero Avendaño,20057,19658,21114,40772
2021,Oaxaca,20,Mazatlán Villa de Flores,20058,6701,6826,13527
2021,Oaxaca,20,Mesones Hidalgo,20037,2096,2480,4576
2021,Oaxaca,20,Miahuatlán de Porfirio Díaz,20059,21999,24089,46088
2021,Oaxaca,20,Mixistlán de la Reforma,20060,1282,1432,2714
2021,Oaxaca,20,Monjas,20061,1316,1555,2871
2021,Oaxaca,20,Mártires de Tacubaya,20056,722,782,1504
2021,Oaxaca,20,Natividad,20062,302,341,643
2021,Oaxaca,20,Nazareno Etla,20063,2028,2236,4264
2021,Oaxaca,20,Nejapa de Madero,20064,3805,3956,7761
2021,Oaxaca,20,Nuevo Zoquiápam,20504,808,882,1690
2021,Oaxaca,20,Oaxaca de Juárez,20067,121022,137751,258773
2021,Oaxaca,20,Ocotlán de Morelos,20068,11045,12013,23058
2021,Oaxaca,20,Pinotepa de Don Luis,20070,3570,3660,7230
2021,Oaxaca,20,Pluma Hidalgo,20071,1464,1535,2999
2021,Oaxaca,20,Putla Villa de Guerrero,20073,16358,18434,34792
2021,Oaxaca,20,Reforma de Pineda,20075,1407,1502,2909
2021,Oaxaca,20,Reyes Etla,20077,2003,2132,4135
2021,Oaxaca,20,Rojas de Cuauhtémoc,20078,550,615,1165
2021,Oaxaca,20,Salina Cruz,20079,44742,48362,93104
2021,Oaxaca,20,San Agustín Amatengo,20080,695,790,1485
2021,Oaxaca,20,San Agustín Atenango,20081,838,962,1800
2021,Oaxaca,20,San Agustín Chayuco,20082,1934,2148,4082
2021,Oaxaca,20,San Agustín Etla,20084,2052,2262,4314
2021,Oaxaca,20,San Agustín Loxicha,20085,12691,13190,25881
2021,Oaxaca,20,San Agustín Tlacotepec,20086,419,564,983
2021,Oaxaca,20,San Agustín Yatareni,20087,2177,2474,4651
2021,Oaxaca,20,San Agustín de las Juntas,20083,5043,5244,10287
2021,Oaxaca,20,San Andrés Cabecera Nueva,20088,1421,1454,2875
2021,Oaxaca,20,San Andrés Dinicuiti,20089,1069,1131,2200
2021,Oaxaca,20,San Andrés Huaxpaltepec,20090,3115,3290,6405
2021,Oaxaca,20,San Andrés Huayápam,20091,2719,2972,5691
2021,Oaxaca,20,San Andrés Ixtlahuaca,20092,790,892,1682
2021,Oaxaca,20,San Andrés Lagunas,20093,234,273,507
2021,Oaxaca,20,San Andrés Nuxiño,20094,863,943,1806
2021,Oaxaca,20,San Andrés Paxtlán,20095,2258,2267,4525
2021,Oaxaca,20,San Andrés Sinaxtla,20096,366,415,781
2021,Oaxaca,20,San Andrés Solaga,20097,868,919,1787
2021,Oaxaca,20,San Andrés Teotilálpam,20098,2205,2393,4598
2021,Oaxaca,20,San Andrés Tepetlapa,20099,247,282,529
2021,Oaxaca,20,San Andrés Yaá,20100,211,254,465
2021,Oaxaca,20,San Andrés Zabache,20101,325,409,734
2021,Oaxaca,20,San Andrés Zautla,20102,2368,2511,4879
2021,Oaxaca,20,San Antonino Castillo Velasco,20103,3044,3335,6379
2021,Oaxaca,20,San Antonino Monte Verde,20105,3456,4035,7491
2021,Oaxaca,20,San Antonino el Alto,20104,1385,1428,2813
2021,Oaxaca,20,San Antonio Acutla,20106,120,145,265
2021,Oaxaca,20,San Antonio Huitepec,20108,2121,2461,4582
2021,Oaxaca,20,San Antonio Nanahuatípam,20109,637,643,1280
2021,Oaxaca,20,San Antonio Sinicahua,20110,763,881,1644
2021,Oaxaca,20,San Antonio Tepetlapa,20111,2154,2325,4479
2021,Oaxaca,20,San Antonio de la Cal,20107,12235,13614,25849
2021,Oaxaca,20,San Baltazar Chichicápam,20112,1221,1396,2617
2021,Oaxaca,20,San Baltazar Loxicha,20113,1507,1574,3081
2021,Oaxaca,20,San Baltazar Yatzachi el Bajo,20114,319,360,679
2021,Oaxaca,20,San Bartolo Coyotepec,20115,4883,5414,10297
2021,Oaxaca,20,San Bartolo Soyaltepec,20121,300,374,674
2021,Oaxaca,20,San Bartolo Yautepec,20122,335,343,678
2021,Oaxaca,20,San Bartolomé Ayautla,20116,2272,2417,4689
2021,Oaxaca,20,San Bartolomé Loxicha,20117,1188,1224,2412
2021,Oaxaca,20,San Bartolomé Quialana,20118,1051,1494,2545
2021,Oaxaca,20,San Bartolomé Yucuañe,20119,161,232,393
2021,Oaxaca,20,San Bartolomé Zoogocho,20120,130,182,312
2021,Oaxaca,20,San Bernardo Mixtepec,20123,1347,1458,2805
2021,Oaxaca,20,San Blas Atempa,20124,9540,9431,18971
2021,Oaxaca,20,San Carlos Yautepec,20125,6374,6279,12653
2021,Oaxaca,20,San Cristóbal Amatlán,20126,2561,2900,5461
2021,Oaxaca,20,San Cristóbal Amoltepec,20127,522,624,1146
2021,Oaxaca,20,San Cristóbal Lachirioag,20128,630,683,1313
2021,Oaxaca,20,San Cristóbal Suchixtlahuaca,20129,184,195,379
2021,Oaxaca,20,San Dionisio Ocotepec,20131,5220,5948,11168
2021,Oaxaca,20,San Dionisio Ocotlán,20132,593,610,1203
2021,Oaxaca,20,San Dionisio del Mar,20130,2746,2633,5379
2021,Oaxaca,20,San Esteban Atatlahuca,20133,1910,2001,3911
2021,Oaxaca,20,San Felipe Jalapa de Díaz,20134,14095,15040,29135
2021,Oaxaca,20,San Felipe Tejalápam,20135,3939,4313,8252
2021,Oaxaca,20,San Felipe Usila,20136,5778,6263,12041
2021,Oaxaca,20,San Francisco Cahuacuá,20137,1745,1776,3521
2021,Oaxaca,20,San Francisco Cajonos,20138,213,239,452
2021,Oaxaca,20,San Francisco Chapulapa,20139,1034,1114,2148
2021,Oaxaca,20,San Francisco Chindúa,20140,412,436,848
2021,Oaxaca,20,San Francisco Huehuetlán,20142,491,621,1112
2021,Oaxaca,20,San Francisco Ixhuatán,20143,4615,4696,9311
2021,Oaxaca,20,San Francisco Jaltepetongo,20144,504,524,1028
2021,Oaxaca,20,San Francisco Lachigoló,20145,2269,2356,4625
2021,Oaxaca,20,San Francisco Logueche,20146,1427,1627,3054
2021,Oaxaca,20,San Francisco Nuxaño,20147,201,189,390
2021,Oaxaca,20,San Francisco Ozolotepec,20148,958,1019,1977
2021,Oaxaca,20,San Francisco Sola,20149,850,941,1791
2021,Oaxaca,20,San Francisco Telixtlahuaca,20150,6562,7031,13593
2021,Oaxaca,20,San Francisco Teopan,20151,180,163,343
2021,Oaxaca,20,San Francisco Tlapancingo,20152,1050,1319,2369
2021,Oaxaca,20,San Francisco del Mar,20141,4120,4022,8142
2021,Oaxaca,20,San Gabriel Mixtepec,20153,2481,2641,5122
2021,Oaxaca,20,San Ildefonso Amatlán,20154,1212,1389,2601
2021,Oaxaca,20,San Ildefonso Sola,20155,510,503,1013
2021,Oaxaca,20,San Ildefonso Villa Alta,20156,1727,1828,3555
2021,Oaxaca,20,San Jacinto Amilpas,20157,8806,9708,18514
2021,Oaxaca,20,San Jacinto Tlacotepec,20158,1093,1158,2251
2021,Oaxaca,20,San Jerónimo Coatlán,20159,2674,2828,5502
2021,Oaxaca,20,San Jerónimo Silacayoapilla,20160,686,718,1404
2021,Oaxaca,20,San Jerónimo Sosola,20161,1276,1430,2706
2021,Oaxaca,20,San Jerónimo Taviche,20162,962,1048,2010
2021,Oaxaca,20,San Jerónimo Tecóatl,20163,790,887,1677
2021,Oaxaca,20,San Jerónimo Tlacochahuaya,20550,2724,3064,5788
2021,Oaxaca,20,San Jorge Nuchita,20164,1345,1591,2936
2021,Oaxaca,20,San José Ayuquila,20165,744,866,1610
2021,Oaxaca,20,San José Chiltepec,20166,6153,6517,12670
2021,Oaxaca,20,San José Estancia Grande,20168,550,552,1102
2021,Oaxaca,20,San José Independencia,20169,1840,1979,3819
2021,Oaxaca,20,San José Lachiguiri,20170,1618,2005,3623
2021,Oaxaca,20,San José Tenango,20171,9116,9861,18977
2021,Oaxaca,20,San José del Peñasco,20167,1087,1130,2217
2021,Oaxaca,20,San José del Progreso,20072,3445,3651,7096
2021,Oaxaca,20,San Juan Achiutla,20172,204,214,418
2021,Oaxaca,20,San Juan Atepec,20173,730,820,1550
2021,Oaxaca,20,San Juan Bautista Atatlahuca,20175,801,856,1657
2021,Oaxaca,20,San Juan Bautista Coixtlahuaca,20176,1308,1450,2758
2021,Oaxaca,20,San Juan Bautista Cuicatlán,20177,5052,5351,10403
2021,Oaxaca,20,San Juan Bautista Guelache,20178,3774,4213,7987
2021,Oaxaca,20,San Juan Bautista Jayacatlán,20179,791,775,1566
2021,Oaxaca,20,San Juan Bautista Lo de Soto,20180,1325,1352,2677
2021,Oaxaca,20,San Juan Bautista Suchitepec,20181,209,250,459
2021,Oaxaca,20,San Juan Bautista Tlachichilco,20183,668,774,1442
2021,Oaxaca,20,San Juan Bautista Tlacoatzintepec,20182,1061,1181,2242
2021,Oaxaca,20,San Juan Bautista Tuxtepec,20184,82301,89121,171422
2021,Oaxaca,20,San Juan Bautista Valle Nacional,20559,11202,12231,23433
2021,Oaxaca,20,San Juan Cacahuatepec,20185,4556,4759,9315
2021,Oaxaca,20,San Juan Chicomezúchil,20191,158,189,347
2021,Oaxaca,20,San Juan Chilateca,20192,739,861,1600
2021,Oaxaca,20,San Juan Cieneguilla,20186,289,316,605
2021,Oaxaca,20,San Juan Coatzóspam,20187,1093,1073,2166
2021,Oaxaca,20,San Juan Colorado,20188,5035,5350,10385
2021,Oaxaca,20,San Juan Comaltepec,20189,1444,1515,2959
2021,Oaxaca,20,San Juan Cotzocón,20190,11995,12634,24629
2021,Oaxaca,20,San Juan Diuxi,20195,548,562,1110
2021,Oaxaca,20,San Juan Evangelista Analco,20196,211,227,438
2021,Oaxaca,20,San Juan Guelavía,20197,1665,1767,3432
2021,Oaxaca,20,San Juan Guichicovi,20198,14558,16429,30987
2021,Oaxaca,20,San Juan Ihualtepec,20199,296,349,645
2021,Oaxaca,20,San Juan Juquila Mixes,20200,1884,2108,3992
2021,Oaxaca,20,San Juan Juquila Vijanos,20201,972,1058,2030
2021,Oaxaca,20,San Juan Lachao,20202,2412,2580,4992
2021,Oaxaca,20,San Juan Lachigalla,20203,1657,1782,3439
2021,Oaxaca,20,San Juan Lajarcia,20204,305,373,678
2021,Oaxaca,20,San Juan Lalana,20205,8587,9008,17595
2021,Oaxaca,20,San Juan Mazatlán,20207,9589,9729,19318
2021,Oaxaca,20,San Juan Mixtepec Distrito 08,20208,3325,3802,7127
2021,Oaxaca,20,San Juan Mixtepec Distrito 26,20209,288,411,699
2021,Oaxaca,20,San Juan Ozolotepec,20211,1395,1372,2767
2021,Oaxaca,20,San Juan Petlapa,20212,1476,1575,3051
2021,Oaxaca,20,San Juan Quiahije,20213,1934,2197,4131
2021,Oaxaca,20,San Juan Quiotepec,20214,1049,1082,2131
2021,Oaxaca,20,San Juan Sayultepec,20215,389,458,847
2021,Oaxaca,20,San Juan Tabaá,20216,666,728,1394
2021,Oaxaca,20,San Juan Tamazola,20217,1498,1575,3073
2021,Oaxaca,20,San Juan Teita,20218,313,326,639
2021,Oaxaca,20,San Juan Teitipac,20219,1297,1422,2719
2021,Oaxaca,20,San Juan Tepeuxila,20220,1411,1328,2739
2021,Oaxaca,20,San Juan Teposcolula,20221,630,663,1293
2021,Oaxaca,20,San Juan Yaeé,20222,736,829,1565
2021,Oaxaca,20,San Juan Yatzona,20223,212,271,483
2021,Oaxaca,20,San Juan Yucuita,20224,280,335,615
2021,Oaxaca,20,San Juan de los Cués,20206,1238,1266,2504
2021,Oaxaca,20,San Juan del Estado,20193,1343,1451,2794
2021,Oaxaca,20,San Juan del Río,20194,604,721,1325
2021,Oaxaca,20,San Juan Ñumí,20210,2861,3284,6145
2021,Oaxaca,20,San Lorenzo,20225,3070,3310,6380
2021,Oaxaca,20,San Lorenzo Albarradas,20226,1469,1427,2896
2021,Oaxaca,20,San Lorenzo Cacaotepec,20227,8062,8757,16819
2021,Oaxaca,20,San Lorenzo Cuaunecuiltitla,20228,445,401,846
2021,Oaxaca,20,San Lorenzo Texmelúcan,20229,3968,4620,8588
2021,Oaxaca,20,San Lorenzo Victoria,20230,501,518,1019
2021,Oaxaca,20,San Lucas Camotlán,20231,1515,1625,3140
2021,Oaxaca,20,San Lucas Ojitlán,20232,10210,10851,21061
2021,Oaxaca,20,San Lucas Quiaviní,20233,743,1054,1797
2021,Oaxaca,20,San Lucas Zoquiápam,20234,3759,3972,7731
2021,Oaxaca,20,San Luis Amatlán,20235,1746,2052,3798
2021,Oaxaca,20,San Marcial Ozolotepec,20236,741,819,1560
2021,Oaxaca,20,San Marcos Arteaga,20237,639,738,1377
2021,Oaxaca,20,San Martín Huamelúlpam,20239,499,593,1092
2021,Oaxaca,20,San Martín Itunyoso,20240,1014,1289,2303
2021,Oaxaca,20,San Martín Lachilá,20241,500,624,1124
2021,Oaxaca,20,San Martín Peras,20242,6056,6517,12573
2021,Oaxaca,20,San Martín Tilcajete,20243,841,1049,1890
2021,Oaxaca,20,San Martín Toxpalan,20244,1939,2051,3990
2021,Oaxaca,20,San Martín Zacatepec,20245,658,673,1331
2021,Oaxaca,20,San Martín de los Cansecos,20238,440,450,890
2021,Oaxaca,20,San Mateo Cajonos,20246,296,356,652
2021,Oaxaca,20,San Mateo Etlatongo,20250,575,613,1188
2021,Oaxaca,20,San Mateo Nejápam,20251,565,620,1185
2021,Oaxaca,20,San Mateo Peñasco,20252,1036,1193,2229
2021,Oaxaca,20,San Mateo Piñas,20253,963,973,1936
2021,Oaxaca,20,San Mateo Río Hondo,20254,1596,1667,3263
2021,Oaxaca,20,San Mateo Sindihui,20255,1002,1116,2118
2021,Oaxaca,20,San Mateo Tlapiltepec,20256,105,126,231
2021,Oaxaca,20,San Mateo Yoloxochitlán,20249,1795,1981,3776
2021,Oaxaca,20,San Mateo Yucutindoo,20566,1566,1600,3166
2021,Oaxaca,20,San Mateo del Mar,20248,8074,7823,15897
2021,Oaxaca,20,San Melchor Betaza,20257,499,573,1072
2021,Oaxaca,20,San Miguel Achiutla,20258,368,413,781
2021,Oaxaca,20,San Miguel Ahuehuetitlán,20259,1182,1311,2493
2021,Oaxaca,20,San Miguel Aloápam,20260,1066,1213,2279
2021,Oaxaca,20,San Miguel Amatitlán,20261,3713,4151,7864
2021,Oaxaca,20,San Miguel Amatlán,20262,495,526,1021
2021,Oaxaca,20,San Miguel Chicahua,20264,1001,1230,2231
2021,Oaxaca,20,San Miguel Chimalapa,20265,3680,3471,7151
2021,Oaxaca,20,San Miguel Coatlán,20263,1571,1852,3423
2021,Oaxaca,20,San Miguel Ejutla,20268,481,564,1045
2021,Oaxaca,20,San Miguel Huautla,20270,532,622,1154
2021,Oaxaca,20,San Miguel Mixtepec,20271,1643,1697,3340
2021,Oaxaca,20,San Miguel Panixtlahuaca,20272,3038,3711,6749
2021,Oaxaca,20,San Miguel Peras,20273,1670,1806,3476
2021,Oaxaca,20,San Miguel Piedras,20274,652,688,1340
2021,Oaxaca,20,San Miguel Quetzaltepec,20275,4334,4274,8608
2021,Oaxaca,20,San Miguel Santa Flor,20276,366,362,728
2021,Oaxaca,20,San Miguel Soyaltepec,20278,19707,20933,40640
2021,Oaxaca,20,San Miguel Suchixtepec,20279,1348,1493,2841
2021,Oaxaca,20,San Miguel Tecomatlán,20281,169,145,314
2021,Oaxaca,20,San Miguel Tenango,20282,385,372,757
2021,Oaxaca,20,San Miguel Tequixtepec,20283,509,548,1057
2021,Oaxaca,20,San Miguel Tilquiápam,20284,1415,1800,3215
2021,Oaxaca,20,San Miguel Tlacamama,20285,1877,1934,3811
2021,Oaxaca,20,San Miguel Tlacotepec,20286,1514,1737,3251
2021,Oaxaca,20,San Miguel Tulancingo,20287,126,190,316
2021,Oaxaca,20,San Miguel Yotao,20288,296,329,625
2021,Oaxaca,20,San Miguel del Puerto,20266,4265,4362,8627
2021,Oaxaca,20,San Miguel del Río,20267,142,136,278
2021,Oaxaca,20,San Miguel el Grande,20269,2090,2349,4439
2021,Oaxaca,20,San Nicolás,20289,543,657,1200
2021,Oaxaca,20,San Nicolás Hidalgo,20290,483,565,1048
2021,Oaxaca,20,San Pablo Coatlán,20291,2142,2243,4385
2021,Oaxaca,20,San Pablo Cuatro Venados,20292,676,776,1452
2021,Oaxaca,20,San Pablo Etla,20293,9223,10217,19440
2021,Oaxaca,20,San Pablo Huitzo,20294,3538,3974,7512
2021,Oaxaca,20,San Pablo Huixtepec,20295,4689,5155,9844
2021,Oaxaca,20,San Pablo Macuiltianguis,20296,452,477,929
2021,Oaxaca,20,San Pablo Tijaltepec,20297,1126,1356,2482
2021,Oaxaca,20,San Pablo Villa de Mitla,20298,6361,6926,13287
2021,Oaxaca,20,San Pablo Yaganiza,20299,524,588,1112
2021,Oaxaca,20,San Pedro Amuzgos,20300,3290,3768,7058
2021,Oaxaca,20,San Pedro Apóstol,20301,737,864,1601
2021,Oaxaca,20,San Pedro Atoyac,20302,2190,2449,4639
2021,Oaxaca,20,San Pedro Cajonos,20303,518,630,1148
2021,Oaxaca,20,San Pedro Comitancillo,20305,2129,2332,4461
2021,Oaxaca,20,San Pedro Coxcaltepec Cántaros,20304,365,403,768
2021,Oaxaca,20,San Pedro Huamelula,20307,5133,5158,10291
2021,Oaxaca,20,San Pedro Huilotepec,20308,1631,1663,3294
2021,Oaxaca,20,San Pedro Ixcatlán,20309,5789,6053,11842
2021,Oaxaca,20,San Pedro Ixtlahuaca,20310,4600,4880,9480
2021,Oaxaca,20,San Pedro Jaltepetongo,20311,269,307,576
2021,Oaxaca,20,San Pedro Jicayán,20312,6131,6719,12850
2021,Oaxaca,20,San Pedro Jocotipac,20313,363,440,803
2021,Oaxaca,20,San Pedro Juchatengo,20314,795,880,1675
2021,Oaxaca,20,San Pedro Mixtepec Distrito 22,20318,25228,26466,51694
2021,Oaxaca,20,San Pedro Mixtepec Distrito 26,20319,532,583,1115
2021,Oaxaca,20,San Pedro Molinos,20320,332,370,702
2021,Oaxaca,20,San Pedro Mártir,20315,758,965,1723
2021,Oaxaca,20,San Pedro Mártir Quiechapa,20316,340,387,727
2021,Oaxaca,20,San Pedro Mártir Yucuxaco,20317,596,701,1297
2021,Oaxaca,20,San Pedro Nopala,20321,357,392,749
2021,Oaxaca,20,San Pedro Ocopetatillo,20322,393,456,849
2021,Oaxaca,20,San Pedro Ocotepec,20323,1068,1141,2209
2021,Oaxaca,20,San Pedro Pochutla,20324,24417,25251,49668
2021,Oaxaca,20,San Pedro Quiatoni,20325,5546,5863,11409
2021,Oaxaca,20,San Pedro Sochiápam,20326,2598,2661,5259
2021,Oaxaca,20,San Pedro Tapanatepec,20327,7613,7790,15403
2021,Oaxaca,20,San Pedro Taviche,20328,619,638,1257
2021,Oaxaca,20,San Pedro Teozacoalco,20329,618,662,1280
2021,Oaxaca,20,San Pedro Teutila,20330,2180,2249,4429
2021,Oaxaca,20,San Pedro Tidaá,20331,434,506,940
2021,Oaxaca,20,San Pedro Topiltepec,20332,179,199,378
2021,Oaxaca,20,San Pedro Totolápam,20333,1305,1444,2749
2021,Oaxaca,20,San Pedro Yaneri,20335,462,495,957
2021,Oaxaca,20,San Pedro Yucunama,20341,101,137,238
2021,Oaxaca,20,San Pedro Yólox,20336,865,932,1797
2021,Oaxaca,20,San Pedro el Alto,20306,1822,1931,3753
2021,Oaxaca,20,San Pedro y San Pablo Ayutla,20337,2480,2950,5430
2021,Oaxaca,20,San Pedro y San Pablo Teposcolula,20339,2056,2270,4326
2021,Oaxaca,20,San Pedro y San Pablo Tequixtepec,20340,806,986,1792
2021,Oaxaca,20,San Raymundo Jalpan,20342,1717,2056,3773
2021,Oaxaca,20,San Sebastián Abasolo,20343,959,1044,2003
2021,Oaxaca,20,San Sebastián Coatlán,20344,1364,1447,2811
2021,Oaxaca,20,San Sebastián Ixcapa,20345,2098,2154,4252
2021,Oaxaca,20,San Sebastián Nicananduta,20346,649,858,1507
2021,Oaxaca,20,San Sebastián Río Hondo,20347,1882,1918,3800
2021,Oaxaca,20,San Sebastián Tecomaxtlahuaca,20348,4078,4495,8573
2021,Oaxaca,20,San Sebastián Teitipac,20349,930,1110,2040
2021,Oaxaca,20,San Sebastián Tutla,20350,8938,10303,19241
2021,Oaxaca,20,San Simón Almolongas,20351,1346,1547,2893
2021,Oaxaca,20,San Simón Zahuatlán,20352,2172,2229,4401
2021,Oaxaca,20,San Vicente Coatlán,20534,1849,2219,4068
2021,Oaxaca,20,San Vicente Lachixío,20535,1362,1552,2914
2021,Oaxaca,20,San Vicente Nuñú,20536,204,242,446
2021,Oaxaca,20,Santa Ana,20353,1093,1187,2280
2021,Oaxaca,20,Santa Ana Ateixtlahuaca,20354,268,264,532
2021,Oaxaca,20,Santa Ana Cuauhtémoc,20355,355,384,739
2021,Oaxaca,20,Santa Ana Tavela,20357,406,432,838
2021,Oaxaca,20,Santa Ana Tlapacoyan,20358,1003,1087,2090
2021,Oaxaca,20,Santa Ana Yareni,20359,428,497,925
2021,Oaxaca,20,Santa Ana Zegache,20360,1851,2089,3940
2021,Oaxaca,20,Santa Ana del Valle,20356,1048,1110,2158
2021,Oaxaca,20,Santa Catalina Quierí,20361,423,526,949
2021,Oaxaca,20,Santa Catarina Cuixtla,20362,676,846,1522
2021,Oaxaca,20,Santa Catarina Ixtepeji,20363,1309,1416,2725
2021,Oaxaca,20,Santa Catarina Juquila,20364,7946,8423,16369
2021,Oaxaca,20,Santa Catarina Lachatao,20365,547,592,1139
2021,Oaxaca,20,Santa Catarina Loxicha,20366,1955,2013,3968
2021,Oaxaca,20,Santa Catarina Mechoacán,20367,2321,2362,4683
2021,Oaxaca,20,Santa Catarina Minas,20368,1000,1032,2032
2021,Oaxaca,20,Santa Catarina Quiané,20369,983,1042,2025
2021,Oaxaca,20,Santa Catarina Quioquitani,20074,266,292,558
2021,Oaxaca,20,Santa Catarina Tayata,20370,311,372,683
2021,Oaxaca,20,Santa Catarina Ticuá,20371,495,611,1106
2021,Oaxaca,20,Santa Catarina Yosonotú,20372,787,957,1744
2021,Oaxaca,20,Santa Catarina Zapoquila,20373,175,208,383
2021,Oaxaca,20,Santa Cruz Acatepec,20374,785,857,1642
2021,Oaxaca,20,Santa Cruz Amilpas,20375,6435,7423,13858
2021,Oaxaca,20,Santa Cruz Itundujia,20377,5772,6251,12023
2021,Oaxaca,20,Santa Cruz Mixtepec,20378,1751,1929,3680
2021,Oaxaca,20,Santa Cruz Nundaco,20379,1416,1661,3077
2021,Oaxaca,20,Santa Cruz Papalutla,20380,1094,1158,2252
2021,Oaxaca,20,Santa Cruz Tacache de Mina,20381,1336,1468,2804
2021,Oaxaca,20,Santa Cruz Tacahua,20382,543,610,1153
2021,Oaxaca,20,Santa Cruz Tayata,20383,308,319,627
2021,Oaxaca,20,Santa Cruz Xitla,20384,2368,2638,5006
2021,Oaxaca,20,Santa Cruz Xoxocotlán,20385,47191,52933,100124
2021,Oaxaca,20,Santa Cruz Zenzontepec,20386,9311,9766,19077
2021,Oaxaca,20,Santa Cruz de Bravo,20376,183,196,379
2021,Oaxaca,20,Santa Gertrudis,20387,1425,1527,2952
2021,Oaxaca,20,Santa Inés Yatzeche,20389,406,542,948
2021,Oaxaca,20,Santa Inés de Zaragoza,20569,781,894,1675
2021,Oaxaca,20,Santa Inés del Monte,20388,1218,1272,2490
2021,Oaxaca,20,Santa Lucía Miahuatlán,20391,1739,1826,3565
2021,Oaxaca,20,Santa Lucía Monteverde,20392,3200,3495,6695
2021,Oaxaca,20,Santa Lucía Ocotlán,20393,1830,2171,4001
2021,Oaxaca,20,Santa Lucía del Camino,20390,25061,27168,52229
2021,Oaxaca,20,Santa Magdalena Jicotlán,20047,44,53,97
2021,Oaxaca,20,Santa María Alotepec,20394,1439,1471,2910
2021,Oaxaca,20,Santa María Apazco,20395,796,999,1795
2021,Oaxaca,20,Santa María Atzompa,20399,18187,19537,37724
2021,Oaxaca,20,Santa María Camotlán,20400,786,912,1698
2021,Oaxaca,20,Santa María Chachoápam,20404,360,413,773
2021,Oaxaca,20,Santa María Chilchotla,20406,10317,10716,21033
2021,Oaxaca,20,Santa María Chimalapa,20407,4779,4631,9410
2021,Oaxaca,20,Santa María Colotepec,20401,12582,12766,25348
2021,Oaxaca,20,Santa María Cortijo,20402,533,573,1106
2021,Oaxaca,20,Santa María Coyotepec,20403,1561,1728,3289
2021,Oaxaca,20,Santa María Ecatepec,20410,1736,1776,3512
2021,Oaxaca,20,Santa María Guelacé,20411,383,473,856
2021,Oaxaca,20,Santa María Guienagati,20412,1636,1641,3277
2021,Oaxaca,20,Santa María Huatulco,20413,23109,24063,47172
2021,Oaxaca,20,Santa María Huazolotitlán,20414,5860,6055,11915
2021,Oaxaca,20,Santa María Ipalapa,20415,2450,2726,5176
2021,Oaxaca,20,Santa María Ixcatlán,20416,240,269,509
2021,Oaxaca,20,Santa María Jacatepec,20417,4545,5085,9630
2021,Oaxaca,20,Santa María Jalapa del Marqués,20418,6668,7056,13724
2021,Oaxaca,20,Santa María Jaltianguis,20419,245,294,539
2021,Oaxaca,20,Santa María Lachixío,20420,940,1092,2032
2021,Oaxaca,20,Santa María Mixtequilla,20421,2362,2499,4861
2021,Oaxaca,20,Santa María Nativitas,20422,282,336,618
2021,Oaxaca,20,Santa María Nduayaco,20423,253,254,507
2021,Oaxaca,20,Santa María Ozolotepec,20424,1920,2044,3964
2021,Oaxaca,20,Santa María Petapa,20427,8308,8900,17208
2021,Oaxaca,20,Santa María Peñoles,20426,4304,4520,8824
2021,Oaxaca,20,Santa María Pápalo,20425,1104,1099,2203
2021,Oaxaca,20,Santa María Quiegolani,20428,1017,999,2016
2021,Oaxaca,20,Santa María Sola,20429,728,795,1523
2021,Oaxaca,20,Santa María Tataltepec,20430,188,203,391
2021,Oaxaca,20,Santa María Tecomavaca,20431,841,906,1747
2021,Oaxaca,20,Santa María Temaxcalapa,20432,469,492,961
2021,Oaxaca,20,Santa María Temaxcaltepec,20433,1263,1423,2686
2021,Oaxaca,20,Santa María Teopoxco,20434,2066,2344,4410
2021,Oaxaca,20,Santa María Tepantlali,20435,1933,2007,3940
2021,Oaxaca,20,Santa María Texcatitlán,20436,490,536,1026
2021,Oaxaca,20,Santa María Tlahuitoltepec,20437,4673,4975,9648
2021,Oaxaca,20,Santa María Tlalixtac,20438,854,913,1767
2021,Oaxaca,20,Santa María Tonameca,20439,13139,13392,26531
2021,Oaxaca,20,Santa María Totolapilla,20440,404,448,852
2021,Oaxaca,20,Santa María Xadani,20441,4639,4558,9197
2021,Oaxaca,20,Santa María Yalina,20442,130,156,286
2021,Oaxaca,20,Santa María Yavesía,20443,233,288,521
2021,Oaxaca,20,Santa María Yolotepec,20444,205,223,428
2021,Oaxaca,20,Santa María Yosoyúa,20445,863,847,1710
2021,Oaxaca,20,Santa María Yucuhiti,20446,3101,3382,6483
2021,Oaxaca,20,Santa María Zacatepec,20447,7819,8812,16631
2021,Oaxaca,20,Santa María Zaniza,20448,1115,1183,2298
2021,Oaxaca,20,Santa María Zoquitlán,20449,1546,1587,3133
2021,Oaxaca,20,Santa María del Rosario,20408,270,252,522
2021,Oaxaca,20,Santa María del Tule,20409,4412,5050,9462
2021,Oaxaca,20,Santa María la Asunción,20396,1498,1895,3393
2021,Oaxaca,20,Santiago Amoltepec,20450,6378,6789,13167
2021,Oaxaca,20,Santiago Apoala,20451,427,502,929
2021,Oaxaca,20,Santiago Apóstol,20452,1832,2277,4109
2021,Oaxaca,20,Santiago Astata,20453,2059,2083,4142
2021,Oaxaca,20,Santiago Atitlán,20454,1592,1535,3127
2021,Oaxaca,20,Santiago Ayuquililla,20455,1344,1474,2818
2021,Oaxaca,20,Santiago Cacaloxtepec,20456,804,877,1681
2021,Oaxaca,20,Santiago Camotlán,20457,1634,1650,3284
2021,Oaxaca,20,Santiago Chazumba,20459,2073,2583,4656
2021,Oaxaca,20,Santiago Choápam,20460,2587,2760,5347
2021,Oaxaca,20,Santiago Comaltepec,20458,466,517,983
2021,Oaxaca,20,Santiago Huajolotitlán,20462,1980,2359,4339
2021,Oaxaca,20,Santiago Huauclilla,20463,254,282,536
2021,Oaxaca,20,Santiago Ihuitlán Plumas,20464,163,203,366
2021,Oaxaca,20,Santiago Ixcuintepec,20465,833,857,1690
2021,Oaxaca,20,Santiago Ixtayutla,20466,6507,6871,13378
2021,Oaxaca,20,Santiago Jamiltepec,20467,9510,10304,19814
2021,Oaxaca,20,Santiago Jocotepec,20468,7165,7361,14526
2021,Oaxaca,20,Santiago Juxtlahuaca,20469,17831,19728,37559
2021,Oaxaca,20,Santiago Lachiguiri,20470,2401,2454,4855
2021,Oaxaca,20,Santiago Lalopa,20471,251,268,519
2021,Oaxaca,20,Santiago Laollaga,20472,1770,1788,3558
2021,Oaxaca,20,Santiago Laxopa,20473,643,720,1363
2021,Oaxaca,20,Santiago Llano Grande,20474,1698,1713,3411
2021,Oaxaca,20,Santiago Matatlán,20475,4828,5468,10296
2021,Oaxaca,20,Santiago Miltepec,20476,213,216,429
2021,Oaxaca,20,Santiago Minas,20477,705,724,1429
2021,Oaxaca,20,Santiago Nacaltepec,20478,859,964,1823
2021,Oaxaca,20,Santiago Nejapilla,20479,113,99,212
2021,Oaxaca,20,Santiago Niltepec,20066,2779,2823,5602
2021,Oaxaca,20,Santiago Nundiche,20480,452,499,951
2021,Oaxaca,20,Santiago Nuyoó,20481,849,937,1786
2021,Oaxaca,20,Santiago Pinotepa Nacional,20482,27146,28431,55577
2021,Oaxaca,20,Santiago Suchilquitongo,20483,5315,5719,11034
2021,Oaxaca,20,Santiago Tamazola,20484,2162,2482,4644
2021,Oaxaca,20,Santiago Tapextla,20485,1620,1570,3190
2021,Oaxaca,20,Santiago Tenango,20487,1066,1063,2129
2021,Oaxaca,20,Santiago Tepetlapa,20488,60,68,128
2021,Oaxaca,20,Santiago Tetepec,20489,2520,2575,5095
2021,Oaxaca,20,Santiago Texcalcingo,20490,1557,1673,3230
2021,Oaxaca,20,Santiago Textitlán,20491,2288,2299,4587
2021,Oaxaca,20,Santiago Tilantongo,20492,1384,1624,3008
2021,Oaxaca,20,Santiago Tillo,20493,264,302,566
2021,Oaxaca,20,Santiago Tlazoyaltepec,20494,2245,2681,4926
2021,Oaxaca,20,Santiago Xanica,20495,1564,1555,3119
2021,Oaxaca,20,Santiago Xiacuí,20496,1035,1137,2172
2021,Oaxaca,20,Santiago Yaitepec,20497,2064,2431,4495
2021,Oaxaca,20,Santiago Yaveo,20498,3588,3569,7157
2021,Oaxaca,20,Santiago Yolomécatl,20499,1022,1200,2222
2021,Oaxaca,20,Santiago Yosondúa,20500,4120,4622,8742
2021,Oaxaca,20,Santiago Yucuyachi,20501,456,497,953
2021,Oaxaca,20,Santiago Zacatepec,20502,2704,2786,5490
2021,Oaxaca,20,Santiago Zoochila,20503,190,213,403
2021,Oaxaca,20,Santiago del Río,20461,272,295,567
2021,Oaxaca,20,Santo Domingo Albarradas,20506,371,429,800
2021,Oaxaca,20,Santo Domingo Armenta,20507,1764,1781,3545
2021,Oaxaca,20,Santo Domingo Chihuitán,20508,780,801,1581
2021,Oaxaca,20,Santo Domingo Ingenio,20505,4175,4174,8349
2021,Oaxaca,20,Santo Domingo Ixcatlán,20510,307,360,667
2021,Oaxaca,20,Santo Domingo Nuxaá,20511,1614,1725,3339
2021,Oaxaca,20,Santo Domingo Ozolotepec,20512,403,439,842
2021,Oaxaca,20,Santo Domingo Petapa,20513,4823,4754,9577
2021,Oaxaca,20,Santo Domingo Roayaga,20514,508,556,1064
2021,Oaxaca,20,Santo Domingo Tehuantepec,20515,33341,35116,68457
2021,Oaxaca,20,Santo Domingo Teojomulco,20516,2534,2675,5209
2021,Oaxaca,20,Santo Domingo Tepuxtepec,20517,2782,3155,5937
2021,Oaxaca,20,Santo Domingo Tlatayápam,20518,65,77,142
2021,Oaxaca,20,Santo Domingo Tomaltepec,20519,1525,1572,3097
2021,Oaxaca,20,Santo Domingo Tonaltepec,20521,110,139,249
2021,Oaxaca,20,Santo Domingo Tonalá,20520,3431,3797,7228
2021,Oaxaca,20,Santo Domingo Xagacía,20522,564,649,1213
2021,Oaxaca,20,Santo Domingo Yanhuitlán,20523,766,858,1624
2021,Oaxaca,20,Santo Domingo Yodohino,20524,149,159,308
2021,Oaxaca,20,Santo Domingo Zanatepec,20525,6328,6395,12723
2021,Oaxaca,20,Santo Domingo de Morelos,20509,5470,6113,11583
2021,Oaxaca,20,Santo Tomás Jalieza,20530,1780,1965,3745
2021,Oaxaca,20,Santo Tomás Mazaltepec,20531,1323,1454,2777
2021,Oaxaca,20,Santo Tomás Ocotepec,20532,1833,2103,3936
2021,Oaxaca,20,Santo Tomás Tamazulapan,20533,1139,1210,2349
2021,Oaxaca,20,Santos Reyes Nopala,20526,8915,9488,18403
2021,Oaxaca,20,Santos Reyes Pápalo,20527,1319,1427,2746
2021,Oaxaca,20,Santos Reyes Tepejillo,20528,427,588,1015
2021,Oaxaca,20,Santos Reyes Yucuná,20529,667,676,1343
2021,Oaxaca,20,Silacayoápam,20537,3248,3679,6927
2021,Oaxaca,20,Sitio de Xitlapehua,20538,337,378,715
2021,Oaxaca,20,Soledad Etla,20539,2929,3071,6000
2021,Oaxaca,20,Tamazulápam del Espíritu Santo,20031,3499,4214,7713
2021,Oaxaca,20,Tanetze de Zaragoza,20541,818,889,1707
2021,Oaxaca,20,Taniche,20542,380,461,841
2021,Oaxaca,20,Tataltepec de Valdés,20543,2940,3078,6018
2021,Oaxaca,20,Teococuilco de Marcos Pérez,20544,439,529,968
2021,Oaxaca,20,Teotitlán de Flores Magón,20545,4938,5474,10412
2021,Oaxaca,20,Teotitlán del Valle,20546,2894,3210,6104
2021,Oaxaca,20,Teotongo,20547,454,539,993
2021,Oaxaca,20,Tepelmeme Villa de Morelos,20548,777,931,1708
2021,Oaxaca,20,Tlacolula de Matamoros,20551,11464,12879,24343
2021,Oaxaca,20,Tlacotepec Plumas,20552,225,247,472
2021,Oaxaca,20,Tlalixtac de Cabrera,20553,5230,5783,11013
2021,Oaxaca,20,Totontepec Villa de Morelos,20554,2683,2908,5591
2021,Oaxaca,20,Trinidad Zaachila,20555,1473,1634,3107
2021,Oaxaca,20,Unión Hidalgo,20557,7871,8331,16202
2021,Oaxaca,20,Valerio Trujano,20558,661,810,1471
2021,Oaxaca,20,Villa Díaz Ordaz,20560,3215,3825,7040
2021,Oaxaca,20,Villa Hidalgo,20038,961,1063,2024
2021,Oaxaca,20,Villa Sola de Vega,20277,6291,6425,12716
2021,Oaxaca,20,Villa Talea de Castro,20280,1135,1244,2379
2021,Oaxaca,20,Villa Tejúpam de la Unión,20486,1244,1328,2572
2021,Oaxaca,20,Villa Tezoatlán de Segura y Luna,20549,5247,6171,11418
2021,Oaxaca,20,Villa de Chilapa de Díaz,20405,983,1253,2236
2021,Oaxaca,20,Villa de Etla,20338,5510,6040,11550
2021,Oaxaca,20,Villa de Tamazulápam del Progreso,20540,3821,4260,8081
2021,Oaxaca,20,Villa de Tututepec de Melchor Ocampo,20334,23216,24222,47438
2021,Oaxaca,20,Villa de Zaachila,20565,22734,24805,47539
2021,Oaxaca,20,Yaxe,20561,1418,1536,2954
2021,Oaxaca,20,Yogana,20563,591,702,1293
2021,Oaxaca,20,Yutanduchi de Guerrero,20564,569,632,1201
2021,Oaxaca,20,Zapotitlán Lagunas,20567,1545,1734,3279
2021,Oaxaca,20,Zapotitlán Palmas,20568,669,830,1499
2021,Oaxaca,20,Zimatlán de Álvarez,20570,9829,11168,20997
2021,Oaxaca,20,Ánimas Trujano,20174,2017,2229,4246
2021,Puebla,21,Acajete,21001,33812,35960,69772
2021,Puebla,21,Acateno,21002,4914,4866,9780
2021,Puebla,21,Acatlán,21003,17572,20415,37987
2021,Puebla,21,Acatzingo,21004,31007,32174,63181
2021,Puebla,21,Acteopan,21005,1476,1669,3145
2021,Puebla,21,Ahuacatlán,21006,8044,8869,16913
2021,Puebla,21,Ahuatlán,21007,1654,1783,3437
2021,Puebla,21,Ahuazotepec,21008,6014,6193,12207
2021,Puebla,21,Ahuehuetitla,21009,882,1010,1892
2021,Puebla,21,Ajalpan,21010,34439,36319,70758
2021,Puebla,21,Albino Zertuche,21011,885,1033,1918
2021,Puebla,21,Aljojuca,21012,3317,3661,6978
2021,Puebla,21,Altepexi,21013,11141,11682,22823
2021,Puebla,21,Amixtlán,21014,2507,2772,5279
2021,Puebla,21,Amozoc,21015,62599,65190,127789
2021,Puebla,21,Aquixtla,21016,4638,4650,9288
2021,Puebla,21,Atempan,21017,14358,15989,30347
2021,Puebla,21,Atexcal,21018,1944,2092,4036
2021,Puebla,21,Atlequizayan,21080,1330,1494,2824
2021,Puebla,21,Atlixco,21019,68609,76574,145183
2021,Puebla,21,Atoyatempan,21020,3625,3856,7481
2021,Puebla,21,Atzala,21021,663,736,1399
2021,Puebla,21,Atzitzihuacán,21022,6076,6982,13058
2021,Puebla,21,Atzitzintla,21023,4842,4965,9807
2021,Puebla,21,Axutla,21024,458,531,989
2021,Puebla,21,Ayotoxco de Guerrero,21025,4508,4662,9170
2021,Puebla,21,Calpan,21026,7349,8119,15468
2021,Puebla,21,Caltepec,21027,1939,2219,4158
2021,Puebla,21,Camocuautla,21028,1395,1424,2819
2021,Puebla,21,Caxhuacan,21029,1882,2066,3948
2021,Puebla,21,Cañada Morelos,21099,9956,10613,20569
2021,Puebla,21,Chalchicomula de Sesma,21045,24311,26367,50678
2021,Puebla,21,Chapulco,21046,4030,4313,8343
2021,Puebla,21,Chiautla,21047,10314,10967,21281
2021,Puebla,21,Chiautzingo,21048,10334,11358,21692
2021,Puebla,21,Chichiquila,21050,13410,14207,27617
2021,Puebla,21,Chiconcuautla,21049,8723,9072,17795
2021,Puebla,21,Chietla,21051,17738,19023,36761
2021,Puebla,21,Chigmecatitlán,21052,578,685,1263
2021,Puebla,21,Chignahuapan,21053,32931,34098,67029
2021,Puebla,21,Chignautla,21054,17790,18851,36641
2021,Puebla,21,Chila,21055,2297,2593,4890
2021,Puebla,21,Chila de la Sal,21056,732,782,1514
2021,Puebla,21,Chilchotla,21058,10566,10548,21114
2021,Puebla,21,Chinantla,21059,1136,1278,2414
2021,Puebla,21,Coatepec,21030,378,423,801
2021,Puebla,21,Coatzingo,21031,1487,1643,3130
2021,Puebla,21,Cohetzala,21032,720,707,1427
2021,Puebla,21,Cohuecan,21033,2490,2718,5208
2021,Puebla,21,Coronango,21034,21455,22260,43715
2021,Puebla,21,Coxcatlán,21035,10463,11506,21969
2021,Puebla,21,Coyomeapan,21036,7125,7791,14916
2021,Puebla,21,Coyotepec,21037,1137,1331,2468
2021,Puebla,21,Cuapiaxtla de Madero,21038,5392,5438,10830
2021,Puebla,21,Cuautempan,21039,4799,5150,9949
2021,Puebla,21,Cuautinchán,21040,5492,5545,11037
2021,Puebla,21,Cuautlancingo,21041,62958,66476,129434
2021,Puebla,21,Cuayuca de Andrade,21042,1603,1712,3315
2021,Puebla,21,Cuetzalan del Progreso,21043,25146,26374,51520
2021,Puebla,21,Cuyoaco,21044,8066,8736,16802
2021,Puebla,21,Domingo Arenas,21060,3803,4224,8027
2021,Puebla,21,Eloxochitlán,21061,6604,6957,13561
2021,Puebla,21,Epatlán,21062,2504,2636,5140
2021,Puebla,21,Esperanza,21063,7700,8221,15921
2021,Puebla,21,Francisco Z. Mena,21064,9151,8999,18150
2021,Puebla,21,General Felipe Ángeles,21065,10627,11485,22112
2021,Puebla,21,Guadalupe,21066,2848,3286,6134
2021,Puebla,21,Guadalupe Victoria,21067,8862,9335,18197
2021,Puebla,21,Hermenegildo Galeana,21068,4072,4135,8207
2021,Puebla,21,Honey,21057,4037,4409,8446
2021,Puebla,21,Huaquechula,21069,12369,14045,26414
2021,Puebla,21,Huatlatlauca,21070,3147,3757,6904
2021,Puebla,21,Huauchinango,21071,53436,59007,112443
2021,Puebla,21,Huehuetla,21072,9818,10081,19899
2021,Puebla,21,Huehuetlán el Chico,21073,4398,4634,9032
2021,Puebla,21,Huehuetlán el Grande,21150,3744,3974,7718
2021,Puebla,21,Huejotzingo,21074,38754,40601,79355
2021,Puebla,21,Hueyapan,21075,6623,7033,13656
2021,Puebla,21,Hueytamalco,21076,13782,14131,27913
2021,Puebla,21,Hueytlalpan,21077,2838,2985,5823
2021,Puebla,21,Huitzilan de Serdán,21078,8130,7942,16072
2021,Puebla,21,Huitziltepec,21079,2816,3039,5855
2021,Puebla,21,Ixcamilpa de Guerrero,21081,1810,2007,3817
2021,Puebla,21,Ixcaquixtla,21082,4543,4975,9518
2021,Puebla,21,Ixtacamaxtitlán,21083,12759,13102,25861
2021,Puebla,21,Ixtepec,21084,3665,3879,7544
2021,Puebla,21,Izúcar de Matamoros,21085,39386,43777,83163
2021,Puebla,21,Jalpan,21086,6191,6683,12874
2021,Puebla,21,Jolalpan,21087,6679,7230,13909
2021,Puebla,21,Jonotla,21088,2381,2476,4857
2021,Puebla,21,Jopala,21089,6779,7095,13874
2021,Puebla,21,Juan C. Bonilla,21090,10939,11931,22870
2021,Puebla,21,Juan Galindo,21091,5381,6125,11506
2021,Puebla,21,Juan N. Méndez,21092,2779,2839,5618
2021,Puebla,21,La Magdalena Tlatlauquitepec,21095,304,298,602
2021,Puebla,21,Lafragua,21093,4102,4221,8323
2021,Puebla,21,Libres,21094,17708,18646,36354
2021,Puebla,21,Los Reyes de Juárez,21118,14463,14938,29401
2021,Puebla,21,Mazapiltepec de Juárez,21096,1507,1530,3037
2021,Puebla,21,Mixtla,21097,1192,1326,2518
2021,Puebla,21,Molcaxac,21098,3096,3492,6588
2021,Puebla,21,Naupan,21100,5047,5507,10554
2021,Puebla,21,Nauzontla,21101,1727,1941,3668
2021,Puebla,21,Nealtican,21102,6373,6922,13295
2021,Puebla,21,Nicolás Bravo,21103,3258,3467,6725
2021,Puebla,21,Nopalucan,21104,16500,16918,33418
2021,Puebla,21,Ocotepec,21105,2444,2653,5097
2021,Puebla,21,Ocoyucan,21106,14212,16057,30269
2021,Puebla,21,Olintla,21107,6064,6362,12426
2021,Puebla,21,Oriental,21108,9514,10055,19569
2021,Puebla,21,Pahuatlán,21109,11171,12373,23544
2021,Puebla,21,Palmar de Bravo,21110,24422,24937,49359
2021,Puebla,21,Pantepec,21111,9523,10107,19630
2021,Puebla,21,Petlalcingo,21112,4820,5505,10325
2021,Puebla,21,Piaxtla,21113,2244,2424,4668
2021,Puebla,21,Puebla,21114,820879,890650,1711529
2021,Puebla,21,Quecholac,21115,26758,27738,54496
2021,Puebla,21,Quimixtlán,21116,11604,11891,23495
2021,Puebla,21,Rafael Lara Grajales,21117,7135,7666,14801
2021,Puebla,21,San Andrés Cholula,21119,77814,79528,157342
2021,Puebla,21,San Antonio Cañada,21120,2793,3126,5919
2021,Puebla,21,San Diego la Mesa Tochimiltzingo,21121,631,641,1272
2021,Puebla,21,San Felipe Teotlalcingo,21122,5396,5752,11148
2021,Puebla,21,San Felipe Tepatlán,21123,2040,2114,4154
2021,Puebla,21,San Gabriel Chilac,21124,8004,8845,16849
2021,Puebla,21,San Gregorio Atzompa,21125,4722,5007,9729
2021,Puebla,21,San Jerónimo Tecuanipan,21126,3190,3513,6703
2021,Puebla,21,San Jerónimo Xayacatlán,21127,1713,1967,3680
2021,Puebla,21,San José Chiapa,21128,4649,4753,9402
2021,Puebla,21,San José Miahuatlán,21129,6821,7442,14263
2021,Puebla,21,San Juan Atenco,21130,1648,1910,3558
2021,Puebla,21,San Juan Atzompa,21131,483,461,944
2021,Puebla,21,San Martín Texmelucan,21132,79206,84716,163922
2021,Puebla,21,San Martín Totoltepec,21133,322,347,669
2021,Puebla,21,San Matías Tlalancaleca,21134,10739,11114,21853
2021,Puebla,21,San Miguel Ixitlán,21135,252,285,537
2021,Puebla,21,San Miguel Xoxtla,21136,6542,6895,13437
2021,Puebla,21,San Nicolás Buenos Aires,21137,5176,5409,10585
2021,Puebla,21,San Nicolás de los Ranchos,21138,6145,6423,12568
2021,Puebla,21,San Pablo Anicano,21139,1816,1985,3801
2021,Puebla,21,San Pedro Cholula,21140,67727,73275,141002
2021,Puebla,21,San Pedro Yeloixtlahuaca,21141,1701,1838,3539
2021,Puebla,21,San Salvador Huixcolotla,21144,7939,8074,16013
2021,Puebla,21,San Salvador el Seco,21142,15881,16687,32568
2021,Puebla,21,San Salvador el Verde,21143,16636,17209,33845
2021,Puebla,21,San Sebastián Tlacotepec,21145,7362,7451,14813
2021,Puebla,21,Santa Catarina Tlaltempan,21146,432,429,861
2021,Puebla,21,Santa Inés Ahuatempan,21147,3236,3535,6771
2021,Puebla,21,Santa Isabel Cholula,21148,4538,4920,9458
2021,Puebla,21,Santiago Miahuatlán,21149,13428,14125,27553
2021,Puebla,21,Santo Tomás Hueyotlipan,21151,4422,4762,9184
2021,Puebla,21,Soltepec,21152,6431,6752,13183
2021,Puebla,21,Tecali de Herrera,21153,11578,12187,23765
2021,Puebla,21,Tecamachalco,21154,40127,42527,82654
2021,Puebla,21,Tecomatlán,21155,2980,3099,6079
2021,Puebla,21,Tehuacán,21156,162418,180333,342751
2021,Puebla,21,Tehuitzingo,21157,5660,6294,11954
2021,Puebla,21,Tenampulco,21158,3730,3870,7600
2021,Puebla,21,Teopantlán,21159,1756,2191,3947
2021,Puebla,21,Teotlalco,21160,1637,1718,3355
2021,Puebla,21,Tepanco de López,21161,10457,11565,22022
2021,Puebla,21,Tepango de Rodríguez,21162,2066,2303,4369
2021,Puebla,21,Tepatlaxco de Hidalgo,21163,9081,9551,18632
2021,Puebla,21,Tepeaca,21164,41455,44932,86387
2021,Puebla,21,Tepemaxalco,21165,563,597,1160
2021,Puebla,21,Tepeojuma,21166,4204,4891,9095
2021,Puebla,21,Tepetzintla,21167,5884,6298,12182
2021,Puebla,21,Tepexco,21168,3523,3716,7239
2021,Puebla,21,Tepexi de Rodríguez,21169,11334,11271,22605
2021,Puebla,21,Tepeyahualco,21170,8992,9146,18138
2021,Puebla,21,Tepeyahualco de Cuauhtémoc,21171,1825,2002,3827
2021,Puebla,21,Tetela de Ocampo,21172,14511,15562,30073
2021,Puebla,21,Teteles de Ávila Castillo,21173,2904,3407,6311
2021,Puebla,21,Teziutlán,21174,50089,55658,105747
2021,Puebla,21,Tianguismanalco,21175,6531,7047,13578
2021,Puebla,21,Tilapa,21176,4412,4736,9148
2021,Puebla,21,Tlachichuca,21179,15305,15903,31208
2021,Puebla,21,Tlacotepec de Benito Juárez,21177,26654,29000,55654
2021,Puebla,21,Tlacuilotepec,21178,8735,9034,17769
2021,Puebla,21,Tlahuapan,21180,21278,21540,42818
2021,Puebla,21,Tlaltenango,21181,3753,3816,7569
2021,Puebla,21,Tlanepantla,21182,2566,2763,5329
2021,Puebla,21,Tlaola,21183,10424,11035,21459
2021,Puebla,21,Tlapacoya,21184,3372,3528,6900
2021,Puebla,21,Tlapanalá,21185,4286,4722,9008
2021,Puebla,21,Tlatlauquitepec,21186,27518,30200,57718
2021,Puebla,21,Tlaxco,21187,2833,2865,5698
2021,Puebla,21,Tochimilco,21188,9073,10113,19186
2021,Puebla,21,Tochtepec,21189,10892,11747,22639
2021,Puebla,21,Totoltepec de Guerrero,21190,586,711,1297
2021,Puebla,21,Tulcingo,21191,4682,5348,10030
2021,Puebla,21,Tuzamapan de Galeana,21192,3337,3495,6832
2021,Puebla,21,Tzicatlacoyan,21193,3716,3790,7506
2021,Puebla,21,Venustiano Carranza,21194,15175,16288,31463
2021,Puebla,21,Vicente Guerrero,21195,12513,13579,26092
2021,Puebla,21,Xayacatlán de Bravo,21196,765,915,1680
2021,Puebla,21,Xicotepec,21197,41871,44901,86772
2021,Puebla,21,Xicotlán,21198,611,673,1284
2021,Puebla,21,Xiutetelco,21199,20754,22274,43028
2021,Puebla,21,Xochiapulco,21200,1722,1896,3618
2021,Puebla,21,Xochiltepec,21201,1597,1922,3519
2021,Puebla,21,Xochitlán Todos Santos,21203,3266,3621,6887
2021,Puebla,21,Xochitlán de Vicente Suárez,21202,6521,6972,13493
2021,Puebla,21,Yaonáhuac,21204,4078,4468,8546
2021,Puebla,21,Yehualtepec,21205,12993,13691,26684
2021,Puebla,21,Zacapala,21206,2222,2488,4710
2021,Puebla,21,Zacapoaxtla,21207,28226,30996,59222
2021,Puebla,21,Zacatlán,21208,42127,46424,88551
2021,Puebla,21,Zapotitlán,21209,4124,4923,9047
2021,Puebla,21,Zapotitlán de Méndez,21210,2965,3015,5980
2021,Puebla,21,Zaragoza,21211,8034,9386,17420
2021,Puebla,21,Zautla,21212,9540,10784,20324
2021,Puebla,21,Zihuateutla,21213,6892,7284,14176
2021,Puebla,21,Zinacatepec,21214,8719,9546,18265
2021,Puebla,21,Zongozotla,21215,2616,2668,5284
2021,Puebla,21,Zoquiapan,21216,1209,1376,2585
2021,Puebla,21,Zoquitlán,21217,9585,10149,19734
2021,Querétaro,22,Amealco de Bonfil,22001,33645,35617,69262
2021,Querétaro,22,Arroyo Seco,22003,7220,7794,15014
2021,Querétaro,22,Cadereyta de Montes,22004,37416,40639,78055
2021,Querétaro,22,Colón,22005,35419,34691,70110
2021,Querétaro,22,Corregidora,22006,103693,109833,213526
2021,Querétaro,22,El Marqués,22011,92361,90873,183234
2021,Querétaro,22,Ezequiel Montes,22007,22570,24031,46601
2021,Querétaro,22,Huimilpan,22008,20613,22303,42916
2021,Querétaro,22,Jalpan de Serra,22009,14358,15717,30075
2021,Querétaro,22,Landa de Matamoros,22010,9807,10693,20500
2021,Querétaro,22,Pedro Escobedo,22012,38539,39061,77600
2021,Querétaro,22,Peñamiller,22013,11020,11317,22337
2021,Querétaro,22,Pinal de Amoles,22002,13775,14675,28450
2021,Querétaro,22,Querétaro,22014,492917,499506,992423
2021,Querétaro,22,San Joaquín,22015,4897,5578,10475
2021,Querétaro,22,San Juan del Río,22016,150718,156163,306881
2021,Querétaro,22,Tequisquiapan,22017,39340,40792,80132
2021,Querétaro,22,Tolimán,22018,15674,16272,31946
2021,Quintana Roo,23,Bacalar,23010,23189,23046,46235
2021,Quintana Roo,23,Benito Juárez,23005,434130,428993,863123
2021,Quintana Roo,23,Cozumel,23001,51780,51735,103515
2021,Quintana Roo,23,Felipe Carrillo Puerto,23002,47845,47409,95254
2021,Quintana Roo,23,Isla Mujeres,23003,12386,11435,23821
2021,Quintana Roo,23,José María Morelos,23006,22428,21252,43680
2021,Quintana Roo,23,Lázaro Cárdenas,23007,16413,15699,32112
2021,Quintana Roo,23,Othón P. Blanco,23004,132439,137705,270144
2021,Quintana Roo,23,Solidaridad,23008,128559,117257,245816
2021,Quintana Roo,23,Tulum,23009,19819,17870,37689
2021,San Luis Potosí,24,Ahualulco,24001,8981,10091,19072
2021,San Luis Potosí,24,Alaquines,24002,4298,4437,8735
2021,San Luis Potosí,24,Aquismón,24003,25819,25285,51104
2021,San Luis Potosí,24,Armadillo de los Infante,24004,2121,2202,4323
2021,San Luis Potosí,24,Axtla de Terrazas,24053,19360,19816,39176
2021,San Luis Potosí,24,Catorce,24006,5230,5052,10282
2021,San Luis Potosí,24,Cedral,24007,9888,10345,20233
2021,San Luis Potosí,24,Cerritos,24008,11093,11788,22881
2021,San Luis Potosí,24,Cerro de San Pedro,24009,2432,2376,4808
2021,San Luis Potosí,24,Charcas,24015,10800,11206,22006
2021,San Luis Potosí,24,Ciudad Fernández,24011,23253,24538,47791
2021,San Luis Potosí,24,Ciudad Valles,24013,91436,97730,189166
2021,San Luis Potosí,24,Ciudad del Maíz,24010,18022,18219,36241
2021,San Luis Potosí,24,Coxcatlán,24014,8154,8048,16202
2021,San Luis Potosí,24,Cárdenas,24005,9499,10331,19830
2021,San Luis Potosí,24,Ebano,24016,22581,23462,46043
2021,San Luis Potosí,24,El Naranjo,24058,11723,11582,23305
2021,San Luis Potosí,24,Guadalcázar,24017,14072,13808,27880
2021,San Luis Potosí,24,Huehuetlán,24018,8282,8530,16812
2021,San Luis Potosí,24,Lagunillas,24019,2838,2967,5805
2021,San Luis Potosí,24,Matehuala,24020,51079,54040,105119
2021,San Luis Potosí,24,Matlapa,24057,16057,16188,32245
2021,San Luis Potosí,24,Mexquitic de Carmona,24021,28599,31194,59793
2021,San Luis Potosí,24,Moctezuma,24022,9787,10636,20423
2021,San Luis Potosí,24,Rayón,24023,7990,8429,16419
2021,San Luis Potosí,24,Rioverde,24024,48254,51329,99583
2021,San Luis Potosí,24,Salinas,24025,16088,17355,33443
2021,San Luis Potosí,24,San Antonio,24026,4990,4791,9781
2021,San Luis Potosí,24,San Ciro de Acosta,24027,5239,5624,10863
2021,San Luis Potosí,24,San Luis Potosí,24028,423550,452405,875955
2021,San Luis Potosí,24,San Martín Chalchicuautla,24029,10994,11147,22141
2021,San Luis Potosí,24,San Nicolás Tolentino,24030,2558,2847,5405
2021,San Luis Potosí,24,San Vicente Tancuayalab,24034,7770,7800,15570
2021,San Luis Potosí,24,Santa Catarina,24031,5996,6343,12339
2021,San Luis Potosí,24,Santa María del Río,24032,19991,21961,41952
2021,San Luis Potosí,24,Santo Domingo,24033,6279,6360,12639
2021,San Luis Potosí,24,Soledad de Graciano Sánchez,24035,162515,170636,333151
2021,San Luis Potosí,24,Tamasopo,24036,16046,15759,31805
2021,San Luis Potosí,24,Tamazunchale,24037,49946,50849,100795
2021,San Luis Potosí,24,Tampacán,24038,8169,8039,16208
2021,San Luis Potosí,24,Tampamolón Corona,24039,7996,8168,16164
2021,San Luis Potosí,24,Tamuín,24040,20232,20737,40969
2021,San Luis Potosí,24,Tancanhuitz,24012,10711,11021,21732
2021,San Luis Potosí,24,Tanlajás,24041,10436,10228,20664
2021,San Luis Potosí,24,Tanquián de Escobedo,24042,7813,8166,15979
2021,San Luis Potosí,24,Tierra Nueva,24043,4504,5121,9625
2021,San Luis Potosí,24,Vanegas,24044,4068,4003,8071
2021,San Luis Potosí,24,Venado,24045,7506,7790,15296
2021,San Luis Potosí,24,Villa Hidalgo,24051,7737,7889,15626
2021,San Luis Potosí,24,Villa Juárez,24052,5261,5414,10675
2021,San Luis Potosí,24,Villa de Arista,24056,8014,8106,16120
2021,San Luis Potosí,24,Villa de Arriaga,24046,9301,9457,18758
2021,San Luis Potosí,24,Villa de Guadalupe,24047,5137,5133,10270
2021,San Luis Potosí,24,Villa de Ramos,24049,19038,20131,39169
2021,San Luis Potosí,24,Villa de Reyes,24050,25806,26055,51861
2021,San Luis Potosí,24,Villa de la Paz,24048,2831,2800,5631
2021,San Luis Potosí,24,Xilitla,24054,26746,27692,54438
2021,San Luis Potosí,24,Zaragoza,24055,13474,13859,27333
2021,Sinaloa,25,Ahome,25001,238336,246507,484843
2021,Sinaloa,25,Angostura,25002,25613,25458,51071
2021,Sinaloa,25,Badiraguato,25003,16624,15418,32042
2021,Sinaloa,25,Choix,25007,17797,16857,34654
2021,Sinaloa,25,Concordia,25004,14973,14542,29515
2021,Sinaloa,25,Cosalá,25005,8823,8401,17224
2021,Sinaloa,25,Culiacán,25006,476465,493514,969979
2021,Sinaloa,25,El Fuerte,25010,55186,53936,109122
2021,Sinaloa,25,Elota,25008,30742,28575,59317
2021,Sinaloa,25,Escuinapa,25009,32101,31163,63264
2021,Sinaloa,25,Guasave,25011,158094,160416,318510
2021,Sinaloa,25,Mazatlán,25012,266624,272919,539543
2021,Sinaloa,25,Mocorito,25013,25005,23585,48590
2021,Sinaloa,25,Navolato,25018,82164,79021,161185
2021,Sinaloa,25,Rosario,25014,29259,28255,57514
2021,Sinaloa,25,Salvador Alvarado,25015,42732,44748,87480
2021,Sinaloa,25,San Ignacio,25016,11513,10714,22227
2021,Sinaloa,25,Sinaloa,25017,48410,47119,95529
2021,Sonora,26,Aconchi,26001,1609,1457,3066
2021,Sonora,26,Agua Prieta,26002,44947,44328,89275
2021,Sonora,26,Alamos,26003,14582,13623,28205
2021,Sonora,26,Altar,26004,5200,5222,10422
2021,Sonora,26,Arivechi,26005,662,634,1296
2021,Sonora,26,Arizpe,26006,1527,1450,2977
2021,Sonora,26,Atil,26007,326,311,637
2021,Sonora,26,Bacadéhuachi,26008,649,579,1228
2021,Sonora,26,Bacanora,26009,458,417,875
2021,Sonora,26,Bacerac,26010,800,755,1555
2021,Sonora,26,Bacoachi,26011,876,878,1754
2021,Sonora,26,Banámichi,26013,921,900,1821
2021,Sonora,26,Bavispe,26015,872,783,1655
2021,Sonora,26,Baviácora,26014,1904,1807,3711
2021,Sonora,26,Benito Juárez,26071,12045,12029,24074
2021,Sonora,26,Benjamín Hill,26016,2749,2872,5621
2021,Sonora,26,Bácum,26012,12654,12493,25147
2021,Sonora,26,Caborca,26017,46963,46285,93248
2021,Sonora,26,Cajeme,26018,231839,242569,474408
2021,Sonora,26,Cananea,26019,19014,19445,38459
2021,Sonora,26,Carbó,26020,2779,2558,5337
2021,Sonora,26,Cucurpe,26022,598,485,1083
2021,Sonora,26,Cumpas,26023,3432,3404,6836
2021,Sonora,26,Divisaderos,26024,422,406,828
2021,Sonora,26,Empalme,26025,30462,30794,61256
2021,Sonora,26,Etchojoa,26026,34301,33157,67458
2021,Sonora,26,Fronteras,26027,4801,4636,9437
2021,Sonora,26,General Plutarco Elías Calles,26070,9478,9280,18758
2021,Sonora,26,Granados,26028,599,582,1181
2021,Sonora,26,Guaymas,26029,85983,87275,173258
2021,Sonora,26,Hermosillo,26030,473171,485254,958425
2021,Sonora,26,Huachinera,26031,737,694,1431
2021,Sonora,26,Huatabampo,26033,43931,43804,87735
2021,Sonora,26,Huásabas,26032,532,471,1003
2021,Sonora,26,Huépac,26034,562,538,1100
2021,Sonora,26,Imuris,26035,7029,6967,13996
2021,Sonora,26,La Colorada,26021,1193,962,2155
2021,Sonora,26,Magdalena,26036,17033,17286,34319
2021,Sonora,26,Mazatán,26037,708,620,1328
2021,Sonora,26,Moctezuma,26038,2698,2767,5465
2021,Sonora,26,Naco,26039,3418,3388,6806
2021,Sonora,26,Nacozari de García,26041,7174,7155,14329
2021,Sonora,26,Navojoa,26042,87619,91365,178984
2021,Sonora,26,Nogales,26043,127900,128394,256294
2021,Sonora,26,Nácori Chico,26040,1149,1053,2202
2021,Sonora,26,Onavas,26044,269,229,498
2021,Sonora,26,Opodepe,26045,1582,1400,2982
2021,Sonora,26,Oquitoa,26046,205,232,437
2021,Sonora,26,Pitiquito,26047,5268,4956,10224
2021,Sonora,26,Puerto Peñasco,26048,37420,36132,73552
2021,Sonora,26,Quiriego,26049,1675,1460,3135
2021,Sonora,26,Rayón,26050,876,796,1672
2021,Sonora,26,Rosario,26051,2887,2649,5536
2021,Sonora,26,Sahuaripa,26052,3173,2992,6165
2021,Sonora,26,San Felipe de Jesús,26053,231,226,457
2021,Sonora,26,San Ignacio Río Muerto,26072,8134,7701,15835
2021,Sonora,26,San Javier,26054,393,301,694
2021,Sonora,26,San Luis Río Colorado,26055,105259,104135,209394
2021,Sonora,26,San Miguel de Horcasitas,26056,5498,4694,10192
2021,Sonora,26,San Pedro de la Cueva,26057,892,777,1669
2021,Sonora,26,Santa Ana,26058,8885,9135,18020
2021,Sonora,26,Santa Cruz,26059,1005,1039,2044
2021,Sonora,26,Soyopa,26061,817,681,1498
2021,Sonora,26,Suaqui Grande,26062,669,565,1234
2021,Sonora,26,Sáric,26060,878,839,1717
2021,Sonora,26,Tepache,26063,815,745,1560
2021,Sonora,26,Trincheras,26064,974,803,1777
2021,Sonora,26,Tubutama,26065,676,643,1319
2021,Sonora,26,Ures,26066,4948,4732,9680
2021,Sonora,26,Villa Hidalgo,26067,885,820,1705
2021,Sonora,26,Villa Pesqueira,26068,691,577,1268
2021,Sonora,26,Yécora,26069,3227,3190,6417
2021,Tabasco,27,Balancán,27001,32430,32551,64981
2021,Tabasco,27,Centla,27003,59542,59573,119115
2021,Tabasco,27,Centro,27004,365890,382047,747937
2021,Tabasco,27,Comalcalco,27005,108326,111481,219807
2021,Tabasco,27,Cunduacán,27006,73790,76094,149884
2021,Tabasco,27,Cárdenas,27002,136733,141851,278584
2021,Tabasco,27,Emiliano Zapata,27007,15929,17380,33309
2021,Tabasco,27,Huimanguillo,27008,99957,102519,202476
2021,Tabasco,27,Jalapa,27009,20893,20799,41692
2021,Tabasco,27,Jalpa de Méndez,27010,47483,47784,95267
2021,Tabasco,27,Jonuta,27011,16608,16475,33083
2021,Tabasco,27,Macuspana,27012,87720,91053,178773
2021,Tabasco,27,Nacajuca,27013,74371,77308,151679
2021,Tabasco,27,Paraíso,27014,51366,51735,103101
2021,Tabasco,27,Tacotalpa,27015,26360,26218,52578
2021,Tabasco,27,Teapa,27016,30964,32120,63084
2021,Tabasco,27,Tenosique,27017,31273,33035,64308
2021,Tamaulipas,28,Abasolo,28001,6420,6444,12864
2021,Tamaulipas,28,Aldama,28002,15645,15411,31056
2021,Tamaulipas,28,Altamira,28003,128800,130237,259037
2021,Tamaulipas,28,Antiguo Morelos,28004,5245,5256,10501
2021,Tamaulipas,28,Burgos,28005,2474,2293,4767
2021,Tamaulipas,28,Bustamante,28006,4436,4083,8519
2021,Tamaulipas,28,Camargo,28007,8277,8063,16340
2021,Tamaulipas,28,Casas,28008,2326,2104,4430
2021,Tamaulipas,28,Ciudad Madero,28009,107477,117782,225259
2021,Tamaulipas,28,Cruillas,28010,1008,981,1989
2021,Tamaulipas,28,El Mante,28021,61493,65128,126621
2021,Tamaulipas,28,González,28012,23210,23498,46708
2021,Tamaulipas,28,Guerrero,28014,2500,2336,4836
2021,Tamaulipas,28,Gustavo Díaz Ordaz,28015,8486,8287,16773
2021,Tamaulipas,28,Gómez Farías,28011,5007,4766,9773
2021,Tamaulipas,28,Güémez,28013,8642,8008,16650
2021,Tamaulipas,28,Hidalgo,28016,12635,12025,24660
2021,Tamaulipas,28,Jaumave,28017,8382,8105,16487
2021,Tamaulipas,28,Jiménez,28018,4281,4276,8557
2021,Tamaulipas,28,Llera,28019,9148,8860,18008
2021,Tamaulipas,28,Mainero,28020,1374,1338,2712
2021,Tamaulipas,28,Matamoros,28022,270650,278822,549472
2021,Tamaulipas,28,Mier,28024,2140,2227,4367
2021,Tamaulipas,28,Miguel Alemán,28025,14548,14679,29227
2021,Tamaulipas,28,Miquihuana,28026,2009,1836,3845
2021,Tamaulipas,28,Méndez,28023,2141,1954,4095
2021,Tamaulipas,28,Nuevo Laredo,28027,211906,211846,423752
2021,Tamaulipas,28,Nuevo Morelos,28028,1972,1800,3772
2021,Tamaulipas,28,Ocampo,28029,7482,7184,14666
2021,Tamaulipas,28,Padilla,28030,7521,7413,14934
2021,Tamaulipas,28,Palmillas,28031,944,913,1857
2021,Tamaulipas,28,Reynosa,28032,346435,346853,693288
2021,Tamaulipas,28,Río Bravo,28033,67349,67047,134396
2021,Tamaulipas,28,San Carlos,28034,4980,4498,9478
2021,Tamaulipas,28,San Fernando,28035,29824,29574,59398
2021,Tamaulipas,28,San Nicolás,28036,589,518,1107
2021,Tamaulipas,28,Soto la Marina,28037,13612,13001,26613
2021,Tamaulipas,28,Tampico,28038,161494,175463,336957
2021,Tamaulipas,28,Tula,28039,15524,15648,31172
2021,Tamaulipas,28,Valle Hermoso,28040,33617,34691,68308
2021,Tamaulipas,28,Victoria,28041,181111,189273,370384
2021,Tamaulipas,28,Villagrán,28042,3405,3194,6599
2021,Tamaulipas,28,Xicoténcatl,28043,12690,12699,25389
2021,Tlaxcala,29,Acuamanala de Miguel Hidalgo,29022,3541,3525,7066
2021,Tlaxcala,29,Altzayanca,29004,9417,9371,18788
2021,Tlaxcala,29,Amaxac de Guerrero,29001,6012,6180,12192
2021,Tlaxcala,29,Apetatitlán de Antonio Carvajal,29002,7960,8485,16445
2021,Tlaxcala,29,Apizaco,29005,40894,44826,85720
2021,Tlaxcala,29,Atlangatepec,29003,3475,3619,7094
2021,Tlaxcala,29,Benito Juárez,29045,3210,3290,6500
2021,Tlaxcala,29,Calpulalpan,29006,25588,26869,52457
2021,Tlaxcala,29,Chiautempan,29010,37887,40512,78399
2021,Tlaxcala,29,Contla de Juan Cuamatzi,29018,20576,21098,41674
2021,Tlaxcala,29,Cuapiaxtla,29008,8280,8252,16532
2021,Tlaxcala,29,Cuaxomulco,29009,2873,2903,5776
2021,Tlaxcala,29,El Carmen Tequexquitla,29007,9123,9344,18467
2021,Tlaxcala,29,Emiliano Zapata,29046,2386,2491,4877
2021,Tlaxcala,29,Españita,29012,4700,4789,9489
2021,Tlaxcala,29,Huamantla,29013,49725,51570,101295
2021,Tlaxcala,29,Hueyotlipan,29014,7773,7937,15710
2021,Tlaxcala,29,Ixtacuixtla de Mariano Matamoros,29015,20623,21753,42376
2021,Tlaxcala,29,Ixtenco,29016,3779,4068,7847
2021,Tlaxcala,29,La Magdalena Tlaltelulco,29048,9721,10445,20166
2021,Tlaxcala,29,Lázaro Cárdenas,29047,1645,1671,3316
2021,Tlaxcala,29,Mazatecochco de José María Morelos,29017,5816,5907,11723
2021,Tlaxcala,29,Muñoz de Domingo Arenas,29011,2483,2454,4937
2021,Tlaxcala,29,Nanacamilpa de Mariano Arista,29021,9580,10013,19593
2021,Tlaxcala,29,Natívitas,29023,13357,14258,27615
2021,Tlaxcala,29,Panotla,29024,14144,15152,29296
2021,Tlaxcala,29,Papalotla de Xicohténcatl,29041,15948,17003,32951
2021,Tlaxcala,29,San Damián Texóloc,29049,3045,3054,6099
2021,Tlaxcala,29,San Francisco Tetlanohcan,29050,5679,5900,11579
2021,Tlaxcala,29,San Jerónimo Zacualpan,29051,1978,2181,4159
2021,Tlaxcala,29,San José Teacalco,29052,3168,3315,6483
2021,Tlaxcala,29,San Juan Huactzinco,29053,3891,4241,8132
2021,Tlaxcala,29,San Lorenzo Axocomanitla,29054,2942,3152,6094
2021,Tlaxcala,29,San Lucas Tecopilco,29055,1635,1726,3361
2021,Tlaxcala,29,San Pablo del Monte,29025,41616,41715,83331
2021,Tlaxcala,29,Sanctórum de Lázaro Cárdenas,29020,5348,5451,10799
2021,Tlaxcala,29,Santa Ana Nopalucan,29056,4155,4283,8438
2021,Tlaxcala,29,Santa Apolonia Teacalco,29057,2367,2629,4996
2021,Tlaxcala,29,Santa Catarina Ayometla,29058,4633,4982,9615
2021,Tlaxcala,29,Santa Cruz Quilehtla,29059,3885,3883,7768
2021,Tlaxcala,29,Santa Cruz Tlaxcala,29026,11019,11363,22382
2021,Tlaxcala,29,Santa Isabel Xiloxoxtla,29060,2655,2779,5434
2021,Tlaxcala,29,Tenancingo,29027,6948,7168,14116
2021,Tlaxcala,29,Teolocholco,29028,12806,13553,26359
2021,Tlaxcala,29,Tepetitla de Lardizábal,29019,11099,11920,23019
2021,Tlaxcala,29,Tepeyanco,29029,7071,7700,14771
2021,Tlaxcala,29,Terrenate,29030,8335,8241,16576
2021,Tlaxcala,29,Tetla de la Solidaridad,29031,17417,17861,35278
2021,Tlaxcala,29,Tetlatlahuca,29032,7549,7987,15536
2021,Tlaxcala,29,Tlaxcala,29033,49775,54610,104385
2021,Tlaxcala,29,Tlaxco,29034,22667,23474,46141
2021,Tlaxcala,29,Tocatlán,29035,3151,3211,6362
2021,Tlaxcala,29,Totolac,29036,11721,12724,24445
2021,Tlaxcala,29,Tzompantepec,29038,9136,9774,18910
2021,Tlaxcala,29,Xaloztoc,29039,13078,12986,26064
2021,Tlaxcala,29,Xaltocan,29040,5710,6113,11823
2021,Tlaxcala,29,Xicohtzinco,29042,7127,7830,14957
2021,Tlaxcala,29,Yauhquemehcan,29043,20542,21834,42376
2021,Tlaxcala,29,Zacatelco,29044,22955,24934,47889
2021,Tlaxcala,29,Ziltlaltépec de Trinidad Sánchez Santos,29037,4587,4980,9567
2021,Veracruz,30,Acajete,30001,4686,4482,9168
2021,Veracruz,30,Acatlán,30002,1654,1706,3360
2021,Veracruz,30,Acayucan,30003,44051,47463,91514
2021,Veracruz,30,Actopan,30004,22670,23485,46155
2021,Veracruz,30,Acula,30005,2868,2860,5728
2021,Veracruz,30,Acultzingo,30006,11832,12239,24071
2021,Veracruz,30,Agua Dulce,30204,24763,26203,50966
2021,Veracruz,30,Alpatláhuac,30008,5295,5314,10609
2021,Veracruz,30,Alto Lucero de Gutiérrez Barrios,30009,15507,15433,30940
2021,Veracruz,30,Altotonga,30010,33167,35541,68708
2021,Veracruz,30,Alvarado,30011,28174,28813,56987
2021,Veracruz,30,Amatitlán,30012,4171,4357,8528
2021,Veracruz,30,Amatlán de los Reyes,30014,23340,25014,48354
2021,Veracruz,30,Angel R. Cabada,30015,17527,18548,36075
2021,Veracruz,30,Apazapan,30017,2143,2173,4316
2021,Veracruz,30,Aquila,30018,955,1019,1974
2021,Veracruz,30,Astacinga,30019,3144,3576,6720
2021,Veracruz,30,Atlahuilco,30020,5559,5821,11380
2021,Veracruz,30,Atoyac,30021,12222,12938,25160
2021,Veracruz,30,Atzacan,30022,11100,11439,22539
2021,Veracruz,30,Atzalan,30023,26457,26658,53115
2021,Veracruz,30,Ayahualulco,30025,14004,14151,28155
2021,Veracruz,30,Banderilla,30026,11773,13092,24865
2021,Veracruz,30,Benito Juárez,30027,9027,9479,18506
2021,Veracruz,30,Boca del Río,30028,72247,81337,153584
2021,Veracruz,30,Calcahualco,30029,6771,6745,13516
2021,Veracruz,30,Camarón de Tejeda,30007,3437,3426,6863
2021,Veracruz,30,Camerino Z. Mendoza,30030,21222,23827,45049
2021,Veracruz,30,Carlos A. Carrillo,30208,12545,13634,26179
2021,Veracruz,30,Carrillo Puerto,30031,8782,9103,17885
2021,Veracruz,30,Castillo de Teayo,30157,10512,10327,20839
2021,Veracruz,30,Catemaco,30032,25272,27016,52288
2021,Veracruz,30,Cazones de Herrera,30033,12149,12898,25047
2021,Veracruz,30,Cerro Azul,30034,13606,15139,28745
2021,Veracruz,30,Chacaltianguis,30054,6402,6792,13194
2021,Veracruz,30,Chalma,30055,6984,7230,14214
2021,Veracruz,30,Chiconamel,30056,3399,3644,7043
2021,Veracruz,30,Chiconquiaco,30057,7381,7476,14857
2021,Veracruz,30,Chicontepec,30058,28679,30140,58819
2021,Veracruz,30,Chinameca,30059,8386,8791,17177
2021,Veracruz,30,Chinampa de Gorostiza,30060,8693,8930,17623
2021,Veracruz,30,Chocamán,30062,11097,11141,22238
2021,Veracruz,30,Chontla,30063,7587,7677,15264
2021,Veracruz,30,Chumatlán,30064,1998,2114,4112
2021,Veracruz,30,Citlaltépetl,30035,6119,6421,12540
2021,Veracruz,30,Coacoatzintla,30036,5398,5649,11047
2021,Veracruz,30,Coahuitlán,30037,4372,4523,8895
2021,Veracruz,30,Coatepec,30038,47521,51041,98562
2021,Veracruz,30,Coatzacoalcos,30039,165315,175621,340936
2021,Veracruz,30,Coatzintla,30040,29490,31020,60510
2021,Veracruz,30,Coetzala,30041,1180,1210,2390
2021,Veracruz,30,Colipa,30042,2888,3010,5898
2021,Veracruz,30,Comapa,30043,10872,10428,21300
2021,Veracruz,30,Cosamaloapan de Carpio,30045,28842,31405,60247
2021,Veracruz,30,Cosautlán de Carvajal,30046,8533,8640,17173
2021,Veracruz,30,Coscomatepec,30047,30173,31121,61294
2021,Veracruz,30,Cosoleacaque,30048,70816,75752,146568
2021,Veracruz,30,Cotaxtla,30049,11022,11047,22069
2021,Veracruz,30,Coxquihui,30050,8610,9004,17614
2021,Veracruz,30,Coyutla,30051,11352,12221,23573
2021,Veracruz,30,Cuichapa,30052,6139,6761,12900
2021,Veracruz,30,Cuitláhuac,30053,14261,15513,29774
2021,Veracruz,30,Córdoba,30044,108297,121847,230144
2021,Veracruz,30,El Higo,30205,10315,10405,20720
2021,Veracruz,30,Emiliano Zapata,30065,41264,44155,85419
2021,Veracruz,30,Espinal,30066,14001,14695,28696
2021,Veracruz,30,Filomeno Mata,30067,9838,9773,19611
2021,Veracruz,30,Fortín,30068,33695,37347,71042
2021,Veracruz,30,Gutiérrez Zamora,30069,12201,13751,25952
2021,Veracruz,30,Hidalgotitlán,30070,10083,9772,19855
2021,Veracruz,30,Huatusco,30071,31007,33117,64124
2021,Veracruz,30,Huayacocotla,30072,10998,11718,22716
2021,Veracruz,30,Hueyapan de Ocampo,30073,22180,23393,45573
2021,Veracruz,30,Huiloapan de Cuauhtémoc,30074,3710,3972,7682
2021,Veracruz,30,Ignacio de la Llave,30075,8777,9569,18346
2021,Veracruz,30,Ilamatlán,30076,6824,7457,14281
2021,Veracruz,30,Isla,30077,22290,23300,45590
2021,Veracruz,30,Ixcatepec,30078,7120,7103,14223
2021,Veracruz,30,Ixhuacán de los Reyes,30079,6090,5974,12064
2021,Veracruz,30,Ixhuatlancillo,30081,13294,14427,27721
2021,Veracruz,30,Ixhuatlán de Madero,30083,27749,29102,56851
2021,Veracruz,30,Ixhuatlán del Café,30080,12028,12084,24112
2021,Veracruz,30,Ixhuatlán del Sureste,30082,8325,8270,16595
2021,Veracruz,30,Ixmatlahuacan,30084,3009,3073,6082
2021,Veracruz,30,Ixtaczoquitlán,30085,35369,37487,72856
2021,Veracruz,30,Jalacingo,30086,22849,23848,46697
2021,Veracruz,30,Jalcomulco,30088,2725,2682,5407
2021,Veracruz,30,Jamapa,30090,5901,6157,12058
2021,Veracruz,30,Jesús Carranza,30091,15267,15360,30627
2021,Veracruz,30,Jilotepec,30093,8640,9065,17705
2021,Veracruz,30,José Azueta,30169,11834,12279,24113
2021,Veracruz,30,Juan Rodríguez Clara,30094,20442,20932,41374
2021,Veracruz,30,Juchique de Ferrer,30095,8250,8421,16671
2021,Veracruz,30,Jáltipan,30089,21084,23005,44089
2021,Veracruz,30,La Antigua,30016,13806,14803,28609
2021,Veracruz,30,La Perla,30127,14334,14872,29206
2021,Veracruz,30,Landero y Coss,30096,817,863,1680
2021,Veracruz,30,Las Choapas,30061,42077,43591,85668
2021,Veracruz,30,Las Minas,30107,1603,1539,3142
2021,Veracruz,30,Las Vigas de Ramírez,30132,10391,10441,20832
2021,Veracruz,30,Lerdo de Tejada,30097,9843,11241,21084
2021,Veracruz,30,Los Reyes,30137,3102,3141,6243
2021,Veracruz,30,Magdalena,30098,1621,1634,3255
2021,Veracruz,30,Maltrata,30099,9174,9780,18954
2021,Veracruz,30,Manlio Fabio Altamirano,30100,12308,12698,25006
2021,Veracruz,30,Mariano Escobedo,30101,18633,20032,38665
2021,Veracruz,30,Martínez de la Torre,30102,53364,57929,111293
2021,Veracruz,30,Mecatlán,30103,6408,6593,13001
2021,Veracruz,30,Mecayapan,30104,8609,9008,17617
2021,Veracruz,30,Medellín,30105,40726,44037,84763
2021,Veracruz,30,Miahuatlán,30106,2439,2514,4953
2021,Veracruz,30,Minatitlán,30108,79948,85116,165064
2021,Veracruz,30,Misantla,30109,33190,34854,68044
2021,Veracruz,30,Mixtla de Altamirano,30110,6207,6089,12296
2021,Veracruz,30,Moloacán,30111,8863,9351,18214
2021,Veracruz,30,Nanchital de Lázaro Cárdenas del Rio,30206,15254,16128,31382
2021,Veracruz,30,Naolinco,30112,11289,11804,23093
2021,Veracruz,30,Naranjal,30113,2341,2491,4832
2021,Veracruz,30,Naranjos Amatlán,30013,14363,15917,30280
2021,Veracruz,30,Nautla,30114,5698,5905,11603
2021,Veracruz,30,Nogales,30115,19136,20907,40043
2021,Veracruz,30,Oluta,30116,8384,9028,17412
2021,Veracruz,30,Omealca,30117,12226,13068,25294
2021,Veracruz,30,Orizaba,30118,62239,72953,135192
2021,Veracruz,30,Otatitlán,30119,2869,3129,5998
2021,Veracruz,30,Oteapan,30120,8465,8752,17217
2021,Veracruz,30,Ozuluama de Mascareñas,30121,12544,12000,24544
2021,Veracruz,30,Pajapan,30122,9176,9101,18277
2021,Veracruz,30,Papantla,30124,82566,84125,166691
2021,Veracruz,30,Paso de Ovejas,30126,17755,17881,35636
2021,Veracruz,30,Paso del Macho,30125,16586,16953,33539
2021,Veracruz,30,Perote,30128,38579,38852,77431
2021,Veracruz,30,Platón Sánchez,30129,9404,9803,19207
2021,Veracruz,30,Playa Vicente,30130,18992,20650,39642
2021,Veracruz,30,Poza Rica de Hidalgo,30131,104196,115307,219503
2021,Veracruz,30,Pueblo Viejo,30133,30675,30577,61252
2021,Veracruz,30,Puente Nacional,30134,11835,12194,24029
2021,Veracruz,30,Pánuco,30123,53030,53401,106431
2021,Veracruz,30,Rafael Delgado,30135,12145,12522,24667
2021,Veracruz,30,Rafael Lucio,30136,4181,4415,8596
2021,Veracruz,30,Río Blanco,30138,21039,23728,44767
2021,Veracruz,30,Saltabarranca,30139,3178,3390,6568
2021,Veracruz,30,San Andrés Tenejapan,30140,1528,1588,3116
2021,Veracruz,30,San Andrés Tuxtla,30141,83641,90276,173917
2021,Veracruz,30,San Juan Evangelista,30142,17575,18197,35772
2021,Veracruz,30,San Rafael,30211,15500,16076,31576
2021,Veracruz,30,Santiago Sochiapan,30212,7315,7792,15107
2021,Veracruz,30,Santiago Tuxtla,30143,29262,31482,60744
2021,Veracruz,30,Sayula de Alemán,30144,16961,17527,34488
2021,Veracruz,30,Sochiapa,30146,1931,1921,3852
2021,Veracruz,30,Soconusco,30145,8402,8835,17237
2021,Veracruz,30,Soledad Atzompa,30147,12156,12252,24408
2021,Veracruz,30,Soledad de Doblado,30148,14477,14770,29247
2021,Veracruz,30,Soteapan,30149,17821,18403,36224
2021,Veracruz,30,Tamalín,30150,6153,6118,12271
2021,Veracruz,30,Tamiahua,30151,12307,12234,24541
2021,Veracruz,30,Tampico Alto,30152,6810,6363,13173
2021,Veracruz,30,Tancoco,30153,2957,3134,6091
2021,Veracruz,30,Tantima,30154,6967,6737,13704
2021,Veracruz,30,Tantoyuca,30155,54083,55288,109371
2021,Veracruz,30,Tatahuicapan de Juárez,30209,8012,8350,16362
2021,Veracruz,30,Tatatila,30156,3244,2971,6215
2021,Veracruz,30,Tecolutla,30158,12498,12885,25383
2021,Veracruz,30,Tehuipango,30159,13327,14122,27449
2021,Veracruz,30,Tempoal,30161,18483,19079,37562
2021,Veracruz,30,Tenampa,30162,3490,3636,7126
2021,Veracruz,30,Tenochtitlán,30163,2627,2816,5443
2021,Veracruz,30,Teocelo,30164,8565,9063,17628
2021,Veracruz,30,Tepatlaxco,30165,4576,4345,8921
2021,Veracruz,30,Tepetlán,30166,5178,5020,10198
2021,Veracruz,30,Tepetzintla,30167,7645,7839,15484
2021,Veracruz,30,Tequila,30168,7903,8155,16058
2021,Veracruz,30,Texcatepec,30170,5648,5930,11578
2021,Veracruz,30,Texhuacán,30171,2670,2982,5652
2021,Veracruz,30,Texistepec,30172,10974,10936,21910
2021,Veracruz,30,Tezonapa,30173,29577,30242,59819
2021,Veracruz,30,Tierra Blanca,30174,53835,57911,111746
2021,Veracruz,30,Tihuatlán,30175,49851,51801,101652
2021,Veracruz,30,Tlachichilco,30180,5996,6210,12206
2021,Veracruz,30,Tlacojalpan,30176,2557,2656,5213
2021,Veracruz,30,Tlacolulan,30177,6053,5844,11897
2021,Veracruz,30,Tlacotalpan,30178,6792,7366,14158
2021,Veracruz,30,Tlacotepec de Mejía,30179,2069,2109,4178
2021,Veracruz,30,Tlalixcoyan,30181,19815,20454,40269
2021,Veracruz,30,Tlalnelhuayocan,30182,9808,10130,19938
2021,Veracruz,30,Tlaltetela,30024,8374,8142,16516
2021,Veracruz,30,Tlapacoyan,30183,31813,33625,65438
2021,Veracruz,30,Tlaquilpa,30184,3770,4306,8076
2021,Veracruz,30,Tlilapan,30185,2744,2873,5617
2021,Veracruz,30,Tomatlán,30186,3628,3733,7361
2021,Veracruz,30,Tonayán,30187,2917,3097,6014
2021,Veracruz,30,Totutla,30188,9172,9240,18412
2021,Veracruz,30,Tres Valles,30207,23806,25092,48898
2021,Veracruz,30,Tuxpan,30189,83506,87631,171137
2021,Veracruz,30,Tuxtilla,30190,1170,1199,2369
2021,Veracruz,30,Ursulo Galván,30191,15900,16804,32704
2021,Veracruz,30,Uxpanapa,30210,15499,15100,30599
2021,Veracruz,30,Vega de Alatorre,30192,10359,11072,21431
2021,Veracruz,30,Veracruz,30193,303162,328011,631173
2021,Veracruz,30,Villa Aldama,30194,6183,6311,12494
2021,Veracruz,30,Xalapa,30087,243338,272927,516265
2021,Veracruz,30,Xico,30092,20101,20582,40683
2021,Veracruz,30,Xoxocotla,30195,2926,2790,5716
2021,Veracruz,30,Yanga,30196,8981,10128,19109
2021,Veracruz,30,Yecuatla,30197,6197,6416,12613
2021,Veracruz,30,Zacualpan,30198,3654,3923,7577
2021,Veracruz,30,Zaragoza,30199,5842,6090,11932
2021,Veracruz,30,Zentla,30200,7137,7001,14138
2021,Veracruz,30,Zongolica,30201,22772,23223,45995
2021,Veracruz,30,Zontecomatlán de López y Fuentes,30202,7574,7748,15322
2021,Veracruz,30,Zozocolco de Hidalgo,30203,7757,8079,15836
2021,Veracruz,30,Álamo Temapache,30160,55031,55699,110730
2021,Yucatán,31,Abalá,31001,3629,3467,7096
2021,Yucatán,31,Acanceh,31002,8792,8777,17569
2021,Yucatán,31,Akil,31003,5873,6105,11978
2021,Yucatán,31,Baca,31004,3206,3280,6486
2021,Yucatán,31,Bokobá,31005,1210,1163,2373
2021,Yucatán,31,Buctzotz,31006,4837,4813,9650
2021,Yucatán,31,Cacalchén,31007,4028,3825,7853
2021,Yucatán,31,Calotmul,31008,2190,2179,4369
2021,Yucatán,31,Cansahcab,31009,2500,2539,5039
2021,Yucatán,31,Cantamayec,31010,1413,1298,2711
2021,Yucatán,31,Celestún,31011,4283,4072,8355
2021,Yucatán,31,Cenotillo,31012,2049,2195,4244
2021,Yucatán,31,Chacsinkín,31016,1631,1597,3228
2021,Yucatán,31,Chankom,31017,2510,2428,4938
2021,Yucatán,31,Chapab,31018,1712,1709,3421
2021,Yucatán,31,Chemax,31019,19854,19536,39390
2021,Yucatán,31,Chichimilá,31021,4559,4491,9050
2021,Yucatán,31,Chicxulub Pueblo,31020,2496,2367,4863
2021,Yucatán,31,Chikindzonot,31022,2268,2203,4471
2021,Yucatán,31,Chocholá,31023,2608,2513,5121
2021,Yucatán,31,Chumayel,31024,1733,1801,3534
2021,Yucatán,31,Conkal,31013,6049,6030,12079
2021,Yucatán,31,Cuncunul,31014,885,857,1742
2021,Yucatán,31,Cuzamá,31015,2843,2759,5602
2021,Yucatán,31,Dzemul,31026,2023,2007,4030
2021,Yucatán,31,Dzidzantún,31027,4526,4424,8950
2021,Yucatán,31,Dzilam González,31029,3385,3210,6595
2021,Yucatán,31,Dzilam de Bravo,31028,1503,1422,2925
2021,Yucatán,31,Dzitás,31030,2089,1990,4079
2021,Yucatán,31,Dzoncauich,31031,1415,1442,2857
2021,Yucatán,31,Dzán,31025,2808,2943,5751
2021,Yucatán,31,Espita,31032,8872,8598,17470
2021,Yucatán,31,Halachó,31033,11047,10795,21842
2021,Yucatán,31,Hocabá,31034,3343,3329,6672
2021,Yucatán,31,Hoctún,31035,3177,3239,6416
2021,Yucatán,31,Homún,31036,4240,4084,8324
2021,Yucatán,31,Huhí,31037,2875,2768,5643
2021,Yucatán,31,Hunucmá,31038,17573,17635,35208
2021,Yucatán,31,Ixil,31039,2263,2173,4436
2021,Yucatán,31,Izamal,31040,14460,14714,29174
2021,Yucatán,31,Kanasín,31041,55199,55951,111150
2021,Yucatán,31,Kantunil,31042,2860,2990,5850
2021,Yucatán,31,Kaua,31043,1709,1636,3345
2021,Yucatán,31,Kinchil,31044,3917,3830,7747
2021,Yucatán,31,Kopomá,31045,1422,1337,2759
2021,Yucatán,31,Mama,31046,1615,1790,3405
2021,Yucatán,31,Maní,31047,2965,3097,6062
2021,Yucatán,31,Maxcanú,31048,12375,12189,24564
2021,Yucatán,31,Mayapán,31049,2045,1901,3946
2021,Yucatán,31,Mocochá,31051,1800,1758,3558
2021,Yucatán,31,Motul,31052,19606,19905,39511
2021,Yucatán,31,Muna,31053,6710,6977,13687
2021,Yucatán,31,Muxupip,31054,1523,1586,3109
2021,Yucatán,31,Mérida,31050,469898,504904,974802
2021,Yucatán,31,Opichén,31055,3725,3602,7327
2021,Yucatán,31,Oxkutzcab,31056,16021,17495,33516
2021,Yucatán,31,Panabá,31057,4151,4165,8316
2021,Yucatán,31,Peto,31058,13480,13674,27154
2021,Yucatán,31,Progreso,31059,31722,31997,63719
2021,Yucatán,31,Quintana Roo,31060,520,517,1037
2021,Yucatán,31,Río Lagartos,31061,1974,1876,3850
2021,Yucatán,31,Sacalum,31062,2677,2530,5207
2021,Yucatán,31,Samahil,31063,2804,2785,5589
2021,Yucatán,31,San Felipe,31065,1075,1012,2087
2021,Yucatán,31,Sanahcat,31064,926,923,1849
2021,Yucatán,31,Santa Elena,31066,2102,2210,4312
2021,Yucatán,31,Seyé,31067,5337,5102,10439
2021,Yucatán,31,Sinanché,31068,1778,1634,3412
2021,Yucatán,31,Sotuta,31069,4880,4700,9580
2021,Yucatán,31,Sucilá,31070,2152,2080,4232
2021,Yucatán,31,Sudzal,31071,972,873,1845
2021,Yucatán,31,Suma,31072,1011,976,1987
2021,Yucatán,31,Tahdziú,31073,2807,2636,5443
2021,Yucatán,31,Tahmek,31074,2050,1980,4030
2021,Yucatán,31,Teabo,31075,3532,3577,7109
2021,Yucatán,31,Tecoh,31076,9538,9447,18985
2021,Yucatán,31,Tekal de Venegas,31077,1456,1415,2871
2021,Yucatán,31,Tekantó,31078,2037,2045,4082
2021,Yucatán,31,Tekax,31079,22572,23296,45868
2021,Yucatán,31,Tekit,31080,5618,5451,11069
2021,Yucatán,31,Tekom,31081,1728,1743,3471
2021,Yucatán,31,Telchac Pueblo,31082,2065,2042,4107
2021,Yucatán,31,Telchac Puerto,31083,1010,916,1926
2021,Yucatán,31,Temax,31084,3929,3902,7831
2021,Yucatán,31,Temozón,31085,8497,8244,16741
2021,Yucatán,31,Tepakán,31086,1229,1173,2402
2021,Yucatán,31,Tetiz,31087,2722,2748,5470
2021,Yucatán,31,Teya,31088,1043,1067,2110
2021,Yucatán,31,Ticul,31089,21399,21969,43368
2021,Yucatán,31,Timucuy,31090,4068,3889,7957
2021,Yucatán,31,Tinum,31091,6568,6328,12896
2021,Yucatán,31,Tixcacalcupul,31092,3872,3816,7688
2021,Yucatán,31,Tixkokob,31093,9688,9856,19544
2021,Yucatán,31,Tixmehuac,31094,2636,2611,5247
2021,Yucatán,31,Tixpéhual,31095,2945,3038,5983
2021,Yucatán,31,Tizimín,31096,41268,42253,83521
2021,Yucatán,31,Tunkás,31097,1930,1853,3783
2021,Yucatán,31,Tzucacab,31098,7994,7826,15820
2021,Yucatán,31,Uayma,31099,2263,2164,4427
2021,Yucatán,31,Ucú,31100,2020,1990,4010
2021,Yucatán,31,Umán,31101,29275,29216,58491
2021,Yucatán,31,Valladolid,31102,43208,43897,87105
2021,Yucatán,31,Xocchel,31103,1922,1845,3767
2021,Yucatán,31,Yaxcabá,31104,8476,7981,16457
2021,Yucatán,31,Yaxkukul,31105,1702,1721,3423
2021,Yucatán,31,Yobaín,31106,1251,1203,2454
2021,Zacatecas,32,Apozol,32001,3077,3280,6357
2021,Zacatecas,32,Apulco,32002,2426,2688,5114
2021,Zacatecas,32,Atolinga,32003,1276,1352,2628
2021,Zacatecas,32,Benito Juárez,32004,2200,2124,4324
2021,Zacatecas,32,Calera,32005,23891,23826,47717
2021,Zacatecas,32,Cañitas de Felipe Pescador,32006,4314,4422,8736
2021,Zacatecas,32,Chalchihuites,32009,5806,6123,11929
2021,Zacatecas,32,Concepción del Oro,32007,7099,6948,14047
2021,Zacatecas,32,Cuauhtémoc,32008,6484,6813,13297
2021,Zacatecas,32,El Plateado de Joaquín Amaro,32015,666,677,1343
2021,Zacatecas,32,El Salvador,32041,1281,1238,2519
2021,Zacatecas,32,Fresnillo,32010,120851,123731,244582
2021,Zacatecas,32,Genaro Codina,32012,4191,4407,8598
2021,Zacatecas,32,General Enrique Estrada,32013,3293,3359,6652
2021,Zacatecas,32,General Francisco R. Murguía,32014,11078,11805,22883
2021,Zacatecas,32,General Pánfilo Natera,32016,11969,12424,24393
2021,Zacatecas,32,Guadalupe,32017,98733,103281,202014
2021,Zacatecas,32,Huanusco,32018,2093,2179,4272
2021,Zacatecas,32,Jalpa,32019,12505,13049,25554
2021,Zacatecas,32,Jerez,32020,30873,32656,63529
2021,Zacatecas,32,Jiménez del Teul,32021,2208,2243,4451
2021,Zacatecas,32,Juan Aldama,32022,11144,11787,22931
2021,Zacatecas,32,Juchipila,32023,6388,7063,13451
2021,Zacatecas,32,Loreto,32024,28312,28700,57012
2021,Zacatecas,32,Luis Moya,32025,7002,7059,14061
2021,Zacatecas,32,Mazapil,32026,9751,8844,18595
2021,Zacatecas,32,Melchor Ocampo,32027,1676,1472,3148
2021,Zacatecas,32,Mezquital del Oro,32028,1252,1363,2615
2021,Zacatecas,32,Miguel Auza,32029,12267,12728,24995
2021,Zacatecas,32,Momax,32030,1229,1316,2545
2021,Zacatecas,32,Monte Escobedo,32031,4845,4933,9778
2021,Zacatecas,32,Morelos,32032,6594,6622,13216
2021,Zacatecas,32,Moyahua de Estrada,32033,1981,2234,4215
2021,Zacatecas,32,Nochistlán de Mejía,32034,14067,15449,29516
2021,Zacatecas,32,Noria de Ángeles,32035,8759,9024,17783
2021,Zacatecas,32,Ojocaliente,32036,22288,23257,45545
2021,Zacatecas,32,Pinos,32038,37829,39452,77281
2021,Zacatecas,32,Pánuco,32037,9485,9443,18928
2021,Zacatecas,32,Río Grande,32039,32933,34950,67883
2021,Zacatecas,32,Sain Alto,32040,11409,12012,23421
2021,Zacatecas,32,Santa María de la Paz,32058,1422,1442,2864
2021,Zacatecas,32,Sombrerete,32042,32358,33256,65614
2021,Zacatecas,32,Susticacán,32043,690,751,1441
2021,Zacatecas,32,Tabasco,32044,8021,8414,16435
2021,Zacatecas,32,Tepechitlán,32045,4428,4814,9242
2021,Zacatecas,32,Tepetongo,32046,3662,3877,7539
2021,Zacatecas,32,Teúl de González Ortega,32047,2508,2635,5143
2021,Zacatecas,32,Tlaltenango de Sánchez Román,32048,13909,14431,28340
2021,Zacatecas,32,Trancoso,32057,10117,10323,20440
2021,Zacatecas,32,Trinidad García de la Cadena,32011,1491,1540,3031
2021,Zacatecas,32,Valparaíso,32049,17267,17728,34995
2021,Zacatecas,32,Vetagrande,32050,5247,5376,10623
2021,Zacatecas,32,Villa García,32052,10069,10237,20306
2021,Zacatecas,32,Villa González Ortega,32053,6815,7220,14035
2021,Zacatecas,32,Villa Hidalgo,32054,10078,10200,20278
2021,Zacatecas,32,Villa de Cos,32051,18787,18526,37313
2021,Zacatecas,32,Villanueva,32055,15673,16307,31980
2021,Zacatecas,32,Zacatecas,32056,76082,80352,156434
2022,Aguascalientes,01,Aguascalientes,01001,484011,502908,986919
2022,Aguascalientes,01,Asientos,01002,25839,26072,51911
2022,Aguascalientes,01,Calvillo,01003,30408,31670,62078
2022,Aguascalientes,01,Cosío,01004,8472,8770,17242
2022,Aguascalientes,01,El Llano,01010,11371,11063,22434
2022,Aguascalientes,01,Jesús María,01005,67506,66791,134297
2022,Aguascalientes,01,Pabellón de Arteaga,01006,24986,26121,51107
2022,Aguascalientes,01,Rincón de Romos,01007,29433,29785,59218
2022,Aguascalientes,01,San Francisco de los Romo,01011,26678,26789,53467
2022,Aguascalientes,01,San José de Gracia,01008,4797,5089,9886
2022,Aguascalientes,01,Tepezalá,01009,11479,11821,23300
2022,Baja California,02,Ensenada,02001,276084,276768,552852
2022,Baja California,02,Mexicali,02002,560037,563019,1123056
2022,Baja California,02,Playas de Rosarito,02005,55785,55627,111412
2022,Baja California,02,Tecate,02003,60318,56862,117180
2022,Baja California,02,Tijuana,02004,916723,923192,1839915
2022,Baja California Sur,03,Comondú,03001,43722,42534,86256
2022,Baja California Sur,03,La Paz,03003,155724,157135,312859
2022,Baja California Sur,03,Loreto,03009,11829,10846,22675
2022,Baja California Sur,03,Los Cabos,03008,177830,167883,345713
2022,Baja California Sur,03,Mulegé,03002,36085,33580,69665
2022,Campeche,04,Calakmul,04010,16593,16011,32604
2022,Campeche,04,Calkiní,04001,32098,33152,65250
2022,Campeche,04,Campeche,04002,158187,169867,328054
2022,Campeche,04,Candelaria,04011,25451,24768,50219
2022,Campeche,04,Carmen,04003,141806,142893,284699
2022,Campeche,04,Champotón,04004,51895,51508,103403
2022,Campeche,04,Escárcega,04009,32270,33004,65274
2022,Campeche,04,Hecelchakán,04005,17839,17914,35753
2022,Campeche,04,Hopelchén,04006,23264,22252,45516
2022,Campeche,04,Palizada,04007,5128,5012,10140
2022,Campeche,04,Tenabo,04008,6316,5995,12311
2022,Chiapas,07,Acacoyagua,07001,10244,10183,20427
2022,Chiapas,07,Acala,07002,17598,17901,35499
2022,Chiapas,07,Acapetahua,07003,15968,15942,31910
2022,Chiapas,07,Aldama,07113,3542,3831,7373
2022,Chiapas,07,Altamirano,07004,18654,18420,37074
2022,Chiapas,07,Amatenango de la Frontera,07006,16904,17899,34803
2022,Chiapas,07,Amatenango del Valle,07007,5319,5751,11070
2022,Chiapas,07,Amatán,07005,11228,10929,22157
2022,Chiapas,07,Angel Albino Corzo,07008,15724,15855,31579
2022,Chiapas,07,Arriaga,07009,21874,23403,45277
2022,Chiapas,07,Bejucal de Ocampo,07010,4282,4246,8528
2022,Chiapas,07,Bella Vista,07011,11220,11383,22603
2022,Chiapas,07,Benemérito de las Américas,07114,11261,11037,22298
2022,Chiapas,07,Berriozábal,07012,29503,29688,59191
2022,Chiapas,07,Bochil,07013,19425,19803,39228
2022,Chiapas,07,Cacahoatán,07015,25226,26533,51759
2022,Chiapas,07,Catazajá,07016,9817,9664,19481
2022,Chiapas,07,Chalchihuitán,07022,9148,9321,18469
2022,Chiapas,07,Chamula,07023,45377,52980,98357
2022,Chiapas,07,Chanal,07024,6869,6906,13775
2022,Chiapas,07,Chapultenango,07025,4211,4197,8408
2022,Chiapas,07,Chenalhó,07026,22180,22663,44843
2022,Chiapas,07,Chiapa de Corzo,07027,56533,58601,115134
2022,Chiapas,07,Chiapilla,07028,3353,3225,6578
2022,Chiapas,07,Chicoasén,07029,2849,2863,5712
2022,Chiapas,07,Chicomuselo,07030,19547,19808,39355
2022,Chiapas,07,Chilón,07031,71481,73142,144623
2022,Chiapas,07,Cintalapa,07017,47966,48311,96277
2022,Chiapas,07,Coapilla,07018,5082,5218,10300
2022,Chiapas,07,Comitán de Domínguez,07019,83835,91905,175740
2022,Chiapas,07,Copainalá,07021,12007,12575,24582
2022,Chiapas,07,El Bosque,07014,12193,13048,25241
2022,Chiapas,07,El Porvenir,07070,7927,7972,15899
2022,Chiapas,07,Escuintla,07032,17488,18033,35521
2022,Chiapas,07,Francisco León,07033,4313,4182,8495
2022,Chiapas,07,Frontera Comalapa,07034,40473,42885,83358
2022,Chiapas,07,Frontera Hidalgo,07035,7933,8335,16268
2022,Chiapas,07,Huehuetán,07037,19039,20119,39158
2022,Chiapas,07,Huitiupán,07039,12930,12758,25688
2022,Chiapas,07,Huixtla,07040,29274,31449,60723
2022,Chiapas,07,Huixtán,07038,12973,13403,26376
2022,Chiapas,07,Ixhuatán,07042,6258,6425,12683
2022,Chiapas,07,Ixtacomitán,07043,5975,6072,12047
2022,Chiapas,07,Ixtapa,07044,15221,15394,30615
2022,Chiapas,07,Ixtapangajoya,07045,3109,3021,6130
2022,Chiapas,07,Jiquipilas,07046,21864,22638,44502
2022,Chiapas,07,Jitotol,07047,11820,11498,23318
2022,Chiapas,07,Juárez,07048,11907,12218,24125
2022,Chiapas,07,La Concordia,07020,26028,25731,51759
2022,Chiapas,07,La Grandeza,07036,3977,4072,8049
2022,Chiapas,07,La Independencia,07041,25071,26000,51071
2022,Chiapas,07,La Libertad,07050,2714,2808,5522
2022,Chiapas,07,La Trinitaria,07099,43042,45138,88180
2022,Chiapas,07,Larráinzar,07049,13053,13507,26560
2022,Chiapas,07,Las Margaritas,07052,68893,70141,139034
2022,Chiapas,07,Las Rosas,07075,15661,15995,31656
2022,Chiapas,07,Mapastepec,07051,26245,27170,53415
2022,Chiapas,07,Maravilla Tenejapa,07115,7177,6936,14113
2022,Chiapas,07,Marqués de Comillas,07116,6408,6226,12634
2022,Chiapas,07,Mazapa de Madero,07053,4312,4470,8782
2022,Chiapas,07,Mazatán,07054,16144,16659,32803
2022,Chiapas,07,Metapa,07055,3062,3303,6365
2022,Chiapas,07,Mitontic,07056,6796,6860,13656
2022,Chiapas,07,Montecristo de Guerrero,07117,4334,4221,8555
2022,Chiapas,07,Motozintla,07057,40176,41734,81910
2022,Chiapas,07,Nicolás Ruíz,07058,2477,2342,4819
2022,Chiapas,07,Ocosingo,07059,122702,123621,246323
2022,Chiapas,07,Ocotepec,07060,6907,7191,14098
2022,Chiapas,07,Ocozocoautla de Espinosa,07061,50939,52249,103188
2022,Chiapas,07,Ostuacán,07062,10313,10183,20496
2022,Chiapas,07,Osumacinta,07063,2097,2098,4195
2022,Chiapas,07,Oxchuc,07064,26636,26365,53001
2022,Chiapas,07,Palenque,07065,66459,68563,135022
2022,Chiapas,07,Pantelhó,07066,12237,12427,24664
2022,Chiapas,07,Pantepec,07067,6837,6936,13773
2022,Chiapas,07,Pichucalco,07068,17384,17782,35166
2022,Chiapas,07,Pijijiapan,07069,29447,30288,59735
2022,Chiapas,07,Pueblo Nuevo Solistahuacán,07072,17212,18680,35892
2022,Chiapas,07,Rayón,07073,5378,5470,10848
2022,Chiapas,07,Reforma,07074,25295,25749,51044
2022,Chiapas,07,Sabanilla,07076,15111,14930,30041
2022,Chiapas,07,Salto de Agua,07077,35114,35489,70603
2022,Chiapas,07,San Andrés Duraznal,07118,2949,3108,6057
2022,Chiapas,07,San Cristóbal de las Casas,07078,113154,125087,238241
2022,Chiapas,07,San Fernando,07079,22424,22011,44435
2022,Chiapas,07,San Juan Cancuc,07112,19162,20011,39173
2022,Chiapas,07,San Lucas,07110,4044,4058,8102
2022,Chiapas,07,Santiago el Pinar,07119,2054,2012,4066
2022,Chiapas,07,Siltepec,07080,20415,19792,40207
2022,Chiapas,07,Simojovel,07081,24557,24954,49511
2022,Chiapas,07,Sitalá,07082,7996,8072,16068
2022,Chiapas,07,Socoltenango,07083,10279,10365,20644
2022,Chiapas,07,Solosuchiapa,07084,4499,4462,8961
2022,Chiapas,07,Soyaló,07085,6069,6012,12081
2022,Chiapas,07,Suchiapa,07086,13698,13681,27379
2022,Chiapas,07,Suchiate,07087,21208,22121,43329
2022,Chiapas,07,Sunuapa,07088,1357,1318,2675
2022,Chiapas,07,Tapachula,07089,189401,206450,395851
2022,Chiapas,07,Tapalapa,07090,2161,2273,4434
2022,Chiapas,07,Tapilula,07091,7133,7495,14628
2022,Chiapas,07,Tecpatán,07092,23069,23432,46501
2022,Chiapas,07,Tenejapa,07093,23797,25076,48873
2022,Chiapas,07,Teopisca,07094,23657,25014,48671
2022,Chiapas,07,Tila,07096,44083,43923,88006
2022,Chiapas,07,Tonalá,07097,49509,50854,100363
2022,Chiapas,07,Totolapa,07098,4079,4036,8115
2022,Chiapas,07,Tumbalá,07100,18739,19613,38352
2022,Chiapas,07,Tuxtla Chico,07102,23001,24400,47401
2022,Chiapas,07,Tuxtla Gutiérrez,07101,323868,356731,680599
2022,Chiapas,07,Tuzantán,07103,17784,18325,36109
2022,Chiapas,07,Tzimol,07104,8481,8889,17370
2022,Chiapas,07,Unión Juárez,07105,8396,8878,17274
2022,Chiapas,07,Venustiano Carranza,07106,36184,36518,72702
2022,Chiapas,07,Villa Comaltitlán,07071,15921,16327,32248
2022,Chiapas,07,Villa Corzo,07107,43108,44713,87821
2022,Chiapas,07,Villaflores,07108,58093,60659,118752
2022,Chiapas,07,Yajalón,07109,20965,21913,42878
2022,Chiapas,07,Zinacantán,07111,21579,24535,46114
2022,Chihuahua,08,Ahumada,08001,6653,6518,13171
2022,Chihuahua,08,Aldama,08002,13362,13508,26870
2022,Chihuahua,08,Allende,08003,4910,4800,9710
2022,Chihuahua,08,Aquiles Serdán,08004,10220,9640,19860
2022,Chihuahua,08,Ascensión,08005,13568,13248,26816
2022,Chihuahua,08,Bachíniva,08006,3543,3403,6946
2022,Chihuahua,08,Balleza,08007,9140,8876,18016
2022,Chihuahua,08,Batopilas,08008,6441,6475,12916
2022,Chihuahua,08,Bocoyna,08009,14707,15354,30061
2022,Chihuahua,08,Buenaventura,08010,12879,12638,25517
2022,Chihuahua,08,Camargo,08011,27746,28805,56551
2022,Chihuahua,08,Carichí,08012,5233,5163,10396
2022,Chihuahua,08,Casas Grandes,08013,6399,6121,12520
2022,Chihuahua,08,Chihuahua,08019,473162,498531,971693
2022,Chihuahua,08,Chínipas,08020,4554,4126,8680
2022,Chihuahua,08,Coronado,08014,1268,1170,2438
2022,Chihuahua,08,Coyame del Sotol,08015,1033,849,1882
2022,Chihuahua,08,Cuauhtémoc,08017,90436,96167,186603
2022,Chihuahua,08,Cusihuiriachi,08018,2691,2501,5192
2022,Chihuahua,08,Delicias,08021,80251,84131,164382
2022,Chihuahua,08,Dr. Belisario Domínguez,08022,1452,1417,2869
2022,Chihuahua,08,El Tule,08064,952,916,1868
2022,Chihuahua,08,Galeana,08023,3634,3626,7260
2022,Chihuahua,08,Gran Morelos,08026,1453,1394,2847
2022,Chihuahua,08,Guachochi,08027,24641,25839,50480
2022,Chihuahua,08,Guadalupe,08028,2397,2465,4862
2022,Chihuahua,08,Guadalupe y Calvo,08029,29969,29371,59340
2022,Chihuahua,08,Guazapares,08030,4478,4269,8747
2022,Chihuahua,08,Guerrero,08031,21832,21535,43367
2022,Chihuahua,08,Gómez Farías,08025,4955,4941,9896
2022,Chihuahua,08,Hidalgo del Parral,08032,58054,61759,119813
2022,Chihuahua,08,Huejotitán,08033,551,551,1102
2022,Chihuahua,08,Ignacio Zaragoza,08034,3875,3812,7687
2022,Chihuahua,08,Janos,08035,6320,5777,12097
2022,Chihuahua,08,Jiménez,08036,23121,23479,46600
2022,Chihuahua,08,Julimes,08038,2553,2461,5014
2022,Chihuahua,08,Juárez,08037,740200,741449,1481649
2022,Chihuahua,08,La Cruz,08016,2223,2110,4333
2022,Chihuahua,08,López,08039,2307,2147,4454
2022,Chihuahua,08,Madera,08040,15748,15568,31316
2022,Chihuahua,08,Maguarichi,08041,885,837,1722
2022,Chihuahua,08,Manuel Benavides,08042,872,738,1610
2022,Chihuahua,08,Matachí,08043,1712,1688,3400
2022,Chihuahua,08,Matamoros,08044,2540,2442,4982
2022,Chihuahua,08,Meoqui,08045,24366,24853,49219
2022,Chihuahua,08,Morelos,08046,4198,4115,8313
2022,Chihuahua,08,Moris,08047,2896,2712,5608
2022,Chihuahua,08,Namiquipa,08048,13570,12924,26494
2022,Chihuahua,08,Nonoava,08049,1481,1404,2885
2022,Chihuahua,08,Nuevo Casas Grandes,08050,33663,35157,68820
2022,Chihuahua,08,Ocampo,08051,4237,3912,8149
2022,Chihuahua,08,Ojinaga,08052,15537,15351,30888
2022,Chihuahua,08,Praxedis G. Guerrero,08053,2518,2486,5004
2022,Chihuahua,08,Riva Palacio,08054,4274,4117,8391
2022,Chihuahua,08,Rosales,08055,9485,9314,18799
2022,Chihuahua,08,Rosario,08056,1145,1090,2235
2022,Chihuahua,08,San Francisco de Borja,08057,1306,1231,2537
2022,Chihuahua,08,San Francisco de Conchos,08058,1497,1391,2888
2022,Chihuahua,08,San Francisco del Oro,08059,2870,2850,5720
2022,Chihuahua,08,Santa Bárbara,08060,5916,5999,11915
2022,Chihuahua,08,Santa Isabel,08024,2171,2221,4392
2022,Chihuahua,08,Satevó,08061,1769,1662,3431
2022,Chihuahua,08,Saucillo,08062,17538,17329,34867
2022,Chihuahua,08,Temósachic,08063,3692,3522,7214
2022,Chihuahua,08,Urique,08065,11500,11150,22650
2022,Chihuahua,08,Uruachi,08066,3361,3207,6568
2022,Chihuahua,08,Valle de Zaragoza,08067,2994,2865,5859
2022,Ciudad de México,09,Azcapotzalco,09002,190887,215500,406387
2022,Ciudad de México,09,Benito Juárez,09014,202416,236972,439388
2022,Ciudad de México,09,Coyoacán,09003,290587,328726,619313
2022,Ciudad de México,09,Cuajimalpa de Morelos,09004,95949,103769,199718
2022,Ciudad de México,09,Cuauhtémoc,09015,261094,288933,550027
2022,Ciudad de México,09,Gustavo A. Madero,09005,561620,608917,1170537
2022,Ciudad de México,09,Iztacalco,09006,185984,206833,392817
2022,Ciudad de México,09,Iztapalapa,09007,872181,926122,1798303
2022,Ciudad de México,09,La Magdalena Contreras,09008,117455,126780,244235
2022,Ciudad de México,09,Miguel Hidalgo,09016,176320,204876,381196
2022,Ciudad de México,09,Milpa Alta,09009,68064,71177,139241
2022,Ciudad de México,09,Tlalpan,09012,326064,355322,681386
2022,Ciudad de México,09,Tláhuac,09011,175218,188589,363807
2022,Ciudad de México,09,Venustiano Carranza,09017,203150,228621,431771
2022,Ciudad de México,09,Xochimilco,09013,203030,211477,414507
2022,Ciudad de México,09,Álvaro Obregón,09010,359576,394565,754141
2022,Coahuila,05,Abasolo,05001,585,580,1165
2022,Coahuila,05,Acuña,05002,83434,82675,166109
2022,Coahuila,05,Allende,05003,12465,12759,25224
2022,Coahuila,05,Arteaga,05004,13387,12771,26158
2022,Coahuila,05,Candela,05005,1052,946,1998
2022,Coahuila,05,Castaños,05006,15735,15677,31412
2022,Coahuila,05,Cuatro Ciénegas,05007,7569,7403,14972
2022,Coahuila,05,Escobedo,05008,1761,1683,3444
2022,Coahuila,05,Francisco I. Madero,05009,33170,33210,66380
2022,Coahuila,05,Frontera,05010,45357,44832,90189
2022,Coahuila,05,General Cepeda,05011,7231,6639,13870
2022,Coahuila,05,Guerrero,05012,1055,940,1995
2022,Coahuila,05,Hidalgo,05013,984,937,1921
2022,Coahuila,05,Jiménez,05014,5680,5503,11183
2022,Coahuila,05,Juárez,05015,922,843,1765
2022,Coahuila,05,Lamadrid,05016,1053,992,2045
2022,Coahuila,05,Matamoros,05017,61222,61007,122229
2022,Coahuila,05,Monclova,05018,128195,129618,257813
2022,Coahuila,05,Morelos,05019,4917,4776,9693
2022,Coahuila,05,Múzquiz,05020,39266,38344,77610
2022,Coahuila,05,Nadadores,05021,3687,3635,7322
2022,Coahuila,05,Nava,05022,17384,16486,33870
2022,Coahuila,05,Ocampo,05023,6061,5618,11679
2022,Coahuila,05,Parras,05024,25307,24180,49487
2022,Coahuila,05,Piedras Negras,05025,91025,90084,181109
2022,Coahuila,05,Progreso,05026,1935,1799,3734
2022,Coahuila,05,Ramos Arizpe,05027,54822,52604,107426
2022,Coahuila,05,Sabinas,05028,35796,35563,71359
2022,Coahuila,05,Sacramento,05029,1362,1322,2684
2022,Coahuila,05,Saltillo,05030,445433,447626,893059
2022,Coahuila,05,San Buenaventura,05031,13310,13281,26591
2022,Coahuila,05,San Juan de Sabinas,05032,23828,24691,48519
2022,Coahuila,05,San Pedro,05033,60394,60463,120857
2022,Coahuila,05,Sierra Mojada,05034,4207,3886,8093
2022,Coahuila,05,Torreón,05035,373841,390506,764347
2022,Coahuila,05,Viesca,05036,12461,11989,24450
2022,Coahuila,05,Villa Unión,05037,3587,3400,6987
2022,Coahuila,05,Zaragoza,05038,7270,7202,14472
2022,Colima,06,Armería,06001,16782,16500,33282
2022,Colima,06,Colima,06002,84871,89378,174249
2022,Colima,06,Comala,06003,12365,12162,24527
2022,Colima,06,Coquimatlán,06004,11511,11243,22754
2022,Colima,06,Cuauhtémoc,06005,17016,16812,33828
2022,Colima,06,Ixtlahuacán,06006,3164,3100,6264
2022,Colima,06,Manzanillo,06007,106226,103805,210031
2022,Colima,06,Minatitlán,06008,5189,4762,9951
2022,Colima,06,Tecomán,06009,69987,68545,138532
2022,Colima,06,Villa de Álvarez,06010,76028,79669,155697
2022,Durango,10,Canatlán,10001,17463,17880,35343
2022,Durango,10,Canelas,10002,2558,2324,4882
2022,Durango,10,Coneto de Comonfort,10003,2330,2371,4701
2022,Durango,10,Cuencamé,10004,19195,18873,38068
2022,Durango,10,Durango,10005,343024,365881,708905
2022,Durango,10,El Oro,10018,6238,6293,12531
2022,Durango,10,General Simón Bolívar,10006,5419,5538,10957
2022,Durango,10,Guadalupe Victoria,10008,19018,19347,38365
2022,Durango,10,Guanaceví,10009,5474,5126,10600
2022,Durango,10,Gómez Palacio,10007,185809,189453,375262
2022,Durango,10,Hidalgo,10010,2131,2072,4203
2022,Durango,10,Indé,10011,2767,2748,5515
2022,Durango,10,Lerdo,10012,83472,84251,167723
2022,Durango,10,Mapimí,10013,14418,14396,28814
2022,Durango,10,Mezquital,10014,20305,20928,41233
2022,Durango,10,Nazas,10015,7048,7081,14129
2022,Durango,10,Nombre de Dios,10016,10600,10670,21270
2022,Durango,10,Nuevo Ideal,10039,14609,14742,29351
2022,Durango,10,Ocampo,10017,5387,5164,10551
2022,Durango,10,Otáez,10019,2884,2661,5545
2022,Durango,10,Peñón Blanco,10021,5890,5820,11710
2022,Durango,10,Poanas,10022,13491,13846,27337
2022,Durango,10,Pueblo Nuevo,10023,26569,26773,53342
2022,Durango,10,Pánuco de Coronado,10020,6451,6633,13084
2022,Durango,10,Rodeo,10024,7387,7341,14728
2022,Durango,10,San Bernardo,10025,1856,1651,3507
2022,Durango,10,San Dimas,10026,10416,9774,20190
2022,Durango,10,San Juan de Guadalupe,10027,2939,3031,5970
2022,Durango,10,San Juan del Río,10028,6703,6872,13575
2022,Durango,10,San Luis del Cordero,10029,1166,1130,2296
2022,Durango,10,San Pedro del Gallo,10030,863,799,1662
2022,Durango,10,Santa Clara,10031,3809,3815,7624
2022,Durango,10,Santiago Papasquiaro,10032,25982,25958,51940
2022,Durango,10,Súchil,10033,3251,3543,6794
2022,Durango,10,Tamazula,10034,14257,13065,27322
2022,Durango,10,Tepehuanes,10035,5817,5834,11651
2022,Durango,10,Tlahualilo,10036,12929,12648,25577
2022,Durango,10,Topia,10037,5187,4851,10038
2022,Durango,10,Vicente Guerrero,10038,11431,12130,23561
2022,Estado de México,15,Acambay de Ruíz Castañeda,15001,34356,36458,70814
2022,Estado de México,15,Acolman,15002,96908,96452,193360
2022,Estado de México,15,Aculco,15003,26325,26957,53282
2022,Estado de México,15,Almoloya de Alquisiras,15004,7567,8226,15793
2022,Estado de México,15,Almoloya de Juárez,15005,95709,97578,193287
2022,Estado de México,15,Almoloya del Río,15006,6016,6431,12447
2022,Estado de México,15,Amanalco,15007,12893,13409,26302
2022,Estado de México,15,Amatepec,15008,14001,14836,28837
2022,Estado de México,15,Amecameca,15009,26787,28624,55411
2022,Estado de México,15,Apaxco,15010,15899,16288,32187
2022,Estado de México,15,Atenco,15011,35692,36400,72092
2022,Estado de México,15,Atizapán,15012,6221,6572,12793
2022,Estado de México,15,Atizapán de Zaragoza,15013,274428,290617,565045
2022,Estado de México,15,Atlacomulco,15014,52648,57023,109671
2022,Estado de México,15,Atlautla,15015,16338,17060,33398
2022,Estado de México,15,Axapusco,15016,15315,15491,30806
2022,Estado de México,15,Ayapango,15017,5610,5827,11437
2022,Estado de México,15,Calimaya,15018,30316,31750,62066
2022,Estado de México,15,Capulhuac,15019,18887,19988,38875
2022,Estado de México,15,Chalco,15025,202172,210638,412810
2022,Estado de México,15,Chapa de Mota,15026,15187,15778,30965
2022,Estado de México,15,Chapultepec,15027,6627,6831,13458
2022,Estado de México,15,Chiautla,15028,16070,16615,32685
2022,Estado de México,15,Chicoloapan,15029,113512,120329,233841
2022,Estado de México,15,Chiconcuac,15030,13972,14333,28305
2022,Estado de México,15,Chimalhuacán,15031,359699,372135,731834
2022,Estado de México,15,Coacalco de Berriozábal,15020,151283,162881,314164
2022,Estado de México,15,Coatepec Harinas,15021,20509,22019,42528
2022,Estado de México,15,Cocotitlán,15022,7705,8065,15770
2022,Estado de México,15,Coyotepec,15023,22150,22583,44733
2022,Estado de México,15,Cuautitlán,15024,89042,91056,180098
2022,Estado de México,15,Cuautitlán Izcalli,15121,285763,300510,586273
2022,Estado de México,15,Donato Guerra,15032,18058,18643,36701
2022,Estado de México,15,Ecatepec de Morelos,15033,852806,874543,1727349
2022,Estado de México,15,Ecatzingo,15034,5044,5202,10246
2022,Estado de México,15,El Oro,15064,19582,20766,40348
2022,Estado de México,15,Huehuetoca,15035,75713,77727,153440
2022,Estado de México,15,Hueypoxtla,15036,24102,23663,47765
2022,Estado de México,15,Huixquilucan,15037,143311,153568,296879
2022,Estado de México,15,Isidro Fabela,15038,6349,6460,12809
2022,Estado de México,15,Ixtapaluca,15039,275912,286324,562236
2022,Estado de México,15,Ixtapan de la Sal,15040,18858,20236,39094
2022,Estado de México,15,Ixtapan del Oro,15041,3756,3661,7417
2022,Estado de México,15,Ixtlahuaca,15042,80562,86113,166675
2022,Estado de México,15,Jaltenco,15044,14255,15117,29372
2022,Estado de México,15,Jilotepec,15045,47713,49273,96986
2022,Estado de México,15,Jilotzingo,15046,10292,10847,21139
2022,Estado de México,15,Jiquipilco,15047,39271,41716,80987
2022,Estado de México,15,Jocotitlán,15048,34766,37185,71951
2022,Estado de México,15,Joquicingo,15049,7339,7669,15008
2022,Estado de México,15,Juchitepec,15050,13717,14101,27818
2022,Estado de México,15,La Paz,15070,156077,159943,316020
2022,Estado de México,15,Lerma,15051,81049,83171,164220
2022,Estado de México,15,Luvianos,15123,15021,15209,30230
2022,Estado de México,15,Malinalco,15052,14870,15290,30160
2022,Estado de México,15,Melchor Ocampo,15053,30833,32112,62945
2022,Estado de México,15,Metepec,15054,121425,128936,250361
2022,Estado de México,15,Mexicaltzingo,15055,6820,7255,14075
2022,Estado de México,15,Morelos,15056,15551,16862,32413
2022,Estado de México,15,Naucalpan de Juárez,15057,449728,475683,925411
2022,Estado de México,15,Nextlalpan,15059,22330,22774,45104
2022,Estado de México,15,Nezahualcóyotl,15058,554267,595836,1150103
2022,Estado de México,15,Nicolás Romero,15060,221748,230601,452349
2022,Estado de México,15,Nopaltepec,15061,4942,4967,9909
2022,Estado de México,15,Ocoyoacac,15062,36095,37244,73339
2022,Estado de México,15,Ocuilan,15063,18361,19085,37446
2022,Estado de México,15,Otumba,15065,19622,19325,38947
2022,Estado de México,15,Otzoloapan,15066,2124,2080,4204
2022,Estado de México,15,Otzolotepec,15067,45839,46933,92772
2022,Estado de México,15,Ozumba,15068,15303,16493,31796
2022,Estado de México,15,Papalotla,15069,2159,2268,4427
2022,Estado de México,15,Polotitlán,15071,7549,7866,15415
2022,Estado de México,15,Rayón,15072,7371,7591,14962
2022,Estado de México,15,San Antonio la Isla,15073,16292,16701,32993
2022,Estado de México,15,San Felipe del Progreso,15074,66072,73957,140029
2022,Estado de México,15,San José del Rincón,15124,49658,50465,100123
2022,Estado de México,15,San Martín de las Pirámides,15075,14738,15088,29826
2022,Estado de México,15,San Mateo Atenco,15076,40401,41760,82161
2022,Estado de México,15,San Simón de Guerrero,15077,3229,3429,6658
2022,Estado de México,15,Santo Tomás,15078,5144,5285,10429
2022,Estado de México,15,Soyaniquilpan de Juárez,15079,7280,7435,14715
2022,Estado de México,15,Sultepec,15080,13544,15069,28613
2022,Estado de México,15,Tecámac,15081,253745,265750,519495
2022,Estado de México,15,Tejupilco,15082,38696,41883,80579
2022,Estado de México,15,Temamatla,15083,6778,7209,13987
2022,Estado de México,15,Temascalapa,15084,21245,21254,42499
2022,Estado de México,15,Temascalcingo,15085,32748,35521,68269
2022,Estado de México,15,Temascaltepec,15086,17082,17758,34840
2022,Estado de México,15,Temoaya,15087,54502,57475,111977
2022,Estado de México,15,Tenancingo,15088,52377,55288,107665
2022,Estado de México,15,Tenango del Aire,15089,6781,6937,13718
2022,Estado de México,15,Tenango del Valle,15090,46127,47923,94050
2022,Estado de México,15,Teoloyucan,15091,34399,35058,69457
2022,Estado de México,15,Teotihuacán,15092,30612,31578,62190
2022,Estado de México,15,Tepetlaoxtoc,15093,16768,17082,33850
2022,Estado de México,15,Tepetlixpa,15094,10631,10911,21542
2022,Estado de México,15,Tepotzotlán,15095,52644,54413,107057
2022,Estado de México,15,Tequixquiac,15096,20152,20360,40512
2022,Estado de México,15,Texcaltitlán,15097,9944,10588,20532
2022,Estado de México,15,Texcalyacac,15098,2871,2950,5821
2022,Estado de México,15,Texcoco,15099,129577,137191,266768
2022,Estado de México,15,Tezoyuca,15100,23957,24201,48158
2022,Estado de México,15,Tianguistenco,15101,40964,43169,84133
2022,Estado de México,15,Timilpan,15102,8215,8885,17100
2022,Estado de México,15,Tlalmanalco,15103,25196,27060,52256
2022,Estado de México,15,Tlalnepantla de Baz,15104,373404,398454,771858
2022,Estado de México,15,Tlatlaya,15105,18795,19529,38324
2022,Estado de México,15,Toluca,15106,468242,500598,968840
2022,Estado de México,15,Tonanitla,15125,5461,5599,11060
2022,Estado de México,15,Tonatico,15107,6730,7143,13873
2022,Estado de México,15,Tultepec,15108,80831,83868,164699
2022,Estado de México,15,Tultitlán,15109,276708,286948,563656
2022,Estado de México,15,Valle de Bravo,15110,34979,36308,71287
2022,Estado de México,15,Valle de Chalco Solidaridad,15122,210369,217439,427808
2022,Estado de México,15,Villa Guerrero,15113,36181,37230,73411
2022,Estado de México,15,Villa Victoria,15114,56219,56870,113089
2022,Estado de México,15,Villa de Allende,15111,27394,28450,55844
2022,Estado de México,15,Villa del Carbón,15112,25933,25645,51578
2022,Estado de México,15,Xalatlaco,15043,16077,16930,33007
2022,Estado de México,15,Xonacatlán,15115,27832,27605,55437
2022,Estado de México,15,Zacazonapan,15116,2210,2190,4400
2022,Estado de México,15,Zacualpan,15117,7795,8561,16356
2022,Estado de México,15,Zinacantepec,15118,102253,104983,207236
2022,Estado de México,15,Zumpahuacán,15119,8700,9478,18178
2022,Estado de México,15,Zumpango,15120,108503,115819,224322
2022,Guanajuato,11,Abasolo,11001,47103,49969,97072
2022,Guanajuato,11,Acámbaro,11002,58171,62726,120897
2022,Guanajuato,11,Apaseo el Alto,11004,35780,37466,73246
2022,Guanajuato,11,Apaseo el Grande,11005,49068,51960,101028
2022,Guanajuato,11,Atarjea,11006,2758,2864,5622
2022,Guanajuato,11,Celaya,11007,262394,277119,539513
2022,Guanajuato,11,Comonfort,11009,41943,46496,88439
2022,Guanajuato,11,Coroneo,11010,6246,6968,13214
2022,Guanajuato,11,Cortazar,11011,50078,52854,102932
2022,Guanajuato,11,Cuerámaro,11012,14667,15768,30435
2022,Guanajuato,11,Doctor Mora,11013,12494,13425,25919
2022,Guanajuato,11,Dolores Hidalgo Cuna de la Independencia Nacional,11014,76885,85604,162489
2022,Guanajuato,11,Guanajuato,11015,98797,102804,201601
2022,Guanajuato,11,Huanímaro,11016,10907,12068,22975
2022,Guanajuato,11,Irapuato,11017,303371,318230,621601
2022,Guanajuato,11,Jaral del Progreso,11018,20663,21297,41960
2022,Guanajuato,11,Jerécuaro,11019,24125,27600,51725
2022,Guanajuato,11,León,11020,848048,860244,1708292
2022,Guanajuato,11,Manuel Doblado,11008,19710,21485,41195
2022,Guanajuato,11,Moroleón,11021,26495,28846,55341
2022,Guanajuato,11,Ocampo,11022,12158,12949,25107
2022,Guanajuato,11,Pueblo Nuevo,11024,6121,6769,12890
2022,Guanajuato,11,Purísima del Rincón,11025,44157,43973,88130
2022,Guanajuato,11,Pénjamo,11023,77472,84499,161971
2022,Guanajuato,11,Romita,11026,30873,32558,63431
2022,Guanajuato,11,Salamanca,11027,145556,152860,298416
2022,Guanajuato,11,Salvatierra,11028,51948,56850,108798
2022,Guanajuato,11,San Diego de la Unión,11029,19660,22545,42205
2022,Guanajuato,11,San Felipe,11030,58342,61790,120132
2022,Guanajuato,11,San Francisco del Rincón,11031,62248,65196,127444
2022,Guanajuato,11,San José Iturbide,11032,41371,43804,85175
2022,Guanajuato,11,San Luis de la Paz,11033,61658,67729,129387
2022,Guanajuato,11,San Miguel de Allende,11003,89626,96723,186349
2022,Guanajuato,11,Santa Catarina,11034,2704,2965,5669
2022,Guanajuato,11,Santa Cruz de Juventino Rosas,11035,43479,46551,90030
2022,Guanajuato,11,Santiago Maravatío,11036,3578,3928,7506
2022,Guanajuato,11,Silao de la Victoria,11037,101246,103652,204898
2022,Guanajuato,11,Tarandacuao,11038,6326,6933,13259
2022,Guanajuato,11,Tarimoro,11039,18040,18962,37002
2022,Guanajuato,11,Tierra Blanca,11040,9962,10613,20575
2022,Guanajuato,11,Uriangato,11041,33146,35240,68386
2022,Guanajuato,11,Valle de Santiago,11042,74298,81327,155625
2022,Guanajuato,11,Victoria,11043,10345,11484,21829
2022,Guanajuato,11,Villagrán,11044,31327,32597,63924
2022,Guanajuato,11,Xichú,11045,5963,6507,12470
2022,Guanajuato,11,Yuriria,11046,35745,39293,75038
2022,Guerrero,12,Acapulco de Juárez,12001,407455,438666,846121
2022,Guerrero,12,Acatepec,12076,18951,19836,38787
2022,Guerrero,12,Ahuacuotzingo,12002,12903,14660,27563
2022,Guerrero,12,Ajuchitlán del Progreso,12003,18810,20024,38834
2022,Guerrero,12,Alcozauca de Guerrero,12004,9485,10805,20290
2022,Guerrero,12,Alpoyeca,12005,3307,3700,7007
2022,Guerrero,12,Apaxtla,12006,5618,6086,11704
2022,Guerrero,12,Arcelia,12007,15789,16767,32556
2022,Guerrero,12,Atenango del Río,12008,4304,4677,8981
2022,Guerrero,12,Atlamajalcingo del Monte,12009,2468,2751,5219
2022,Guerrero,12,Atlixtac,12010,13678,14607,28285
2022,Guerrero,12,Atoyac de Álvarez,12011,30804,31916,62720
2022,Guerrero,12,Ayutla de los Libres,12012,34573,36097,70670
2022,Guerrero,12,Azoyú,12013,6222,6615,12837
2022,Guerrero,12,Benito Juárez,12014,7819,8229,16048
2022,Guerrero,12,Buenavista de Cuéllar,12015,6742,7081,13823
2022,Guerrero,12,Chilapa de Álvarez,12028,63804,70702,134506
2022,Guerrero,12,Chilpancingo de los Bravo,12029,137753,150130,287883
2022,Guerrero,12,Coahuayutla de José María Izazaga,12016,6419,6119,12538
2022,Guerrero,12,Cochoapa el Grande,12078,9157,10106,19263
2022,Guerrero,12,Cocula,12017,6781,7272,14053
2022,Guerrero,12,Copala,12018,7255,7511,14766
2022,Guerrero,12,Copalillo,12019,7194,7923,15117
2022,Guerrero,12,Copanatoyac,12020,9996,10950,20946
2022,Guerrero,12,Coyuca de Benítez,12021,38968,40412,79380
2022,Guerrero,12,Coyuca de Catalán,12022,20399,19792,40191
2022,Guerrero,12,Cuajinicuilapa,12023,14105,14020,28125
2022,Guerrero,12,Cualác,12024,3790,4069,7859
2022,Guerrero,12,Cuautepec,12025,8276,8349,16625
2022,Guerrero,12,Cuetzala del Progreso,12026,4369,4596,8965
2022,Guerrero,12,Cutzamala de Pinzón,12027,10027,10369,20396
2022,Guerrero,12,Eduardo Neri,12075,26226,27350,53576
2022,Guerrero,12,Florencio Villarreal,12030,10693,10942,21635
2022,Guerrero,12,General Canuto A. Neri,12031,2854,3079,5933
2022,Guerrero,12,General Heliodoro Castillo,12032,18919,18908,37827
2022,Guerrero,12,Huamuxtitlán,12033,7468,8407,15875
2022,Guerrero,12,Huitzuco de los Figueroa,12034,18705,20237,38942
2022,Guerrero,12,Iguala de la Independencia,12035,77056,82636,159692
2022,Guerrero,12,Igualapa,12036,5721,5922,11643
2022,Guerrero,12,Iliatenco,12081,5403,5952,11355
2022,Guerrero,12,Ixcateopan de Cuauhtémoc,12037,3080,3395,6475
2022,Guerrero,12,José Joaquín de Herrera,12079,8929,9090,18019
2022,Guerrero,12,Juan R. Escudero,12039,12581,13281,25862
2022,Guerrero,12,Juchitán,12080,4035,3953,7988
2022,Guerrero,12,La Unión de Isidoro Montes de Oca,12068,13805,13206,27011
2022,Guerrero,12,Leonardo Bravo,12040,13361,13642,27003
2022,Guerrero,12,Malinaltepec,12041,13130,14802,27932
2022,Guerrero,12,Marquelia,12077,7141,7223,14364
2022,Guerrero,12,Metlatónoc,12043,8702,10037,18739
2022,Guerrero,12,Mochitlán,12044,6553,6826,13379
2022,Guerrero,12,Mártir de Cuilapan,12042,9319,10229,19548
2022,Guerrero,12,Olinalá,12045,12752,13779,26531
2022,Guerrero,12,Ometepec,12046,34390,36152,70542
2022,Guerrero,12,Pedro Ascencio Alquisiras,12047,3259,3790,7049
2022,Guerrero,12,Petatlán,12048,22438,22869,45307
2022,Guerrero,12,Pilcaya,12049,6512,6908,13420
2022,Guerrero,12,Pungarabato,12050,18781,19969,38750
2022,Guerrero,12,Quechultenango,12051,18129,18997,37126
2022,Guerrero,12,San Luis Acatlán,12052,22254,22894,45148
2022,Guerrero,12,San Marcos,12053,25148,25964,51112
2022,Guerrero,12,San Miguel Totolapan,12054,13842,14371,28213
2022,Guerrero,12,Taxco de Alarcón,12055,54239,58993,113232
2022,Guerrero,12,Tecoanapa,12056,23525,24210,47735
2022,Guerrero,12,Teloloapan,12058,28139,31557,59696
2022,Guerrero,12,Tepecoacuilco de Trujano,12059,16003,17307,33310
2022,Guerrero,12,Tetipac,12060,7305,7729,15034
2022,Guerrero,12,Tixtla de Guerrero,12061,21560,23336,44896
2022,Guerrero,12,Tlacoachistlahuaca,12062,11535,13003,24538
2022,Guerrero,12,Tlacoapa,12063,5008,5526,10534
2022,Guerrero,12,Tlalchapa,12064,6451,6436,12887
2022,Guerrero,12,Tlalixtaquilla de Maldonado,12065,3695,4000,7695
2022,Guerrero,12,Tlapa de Comonfort,12066,44983,49928,94911
2022,Guerrero,12,Tlapehuala,12067,10979,11761,22740
2022,Guerrero,12,Técpan de Galeana,12057,33535,34022,67557
2022,Guerrero,12,Xalpatláhuac,12069,5629,6601,12230
2022,Guerrero,12,Xochihuehuetlán,12070,3482,3942,7424
2022,Guerrero,12,Xochistlahuaca,12071,14752,15652,30404
2022,Guerrero,12,Zapotitlán Tablas,12072,6219,6858,13077
2022,Guerrero,12,Zihuatanejo de Azueta,12038,65026,66722,131748
2022,Guerrero,12,Zirándaro,12073,9223,8808,18031
2022,Guerrero,12,Zitlala,12074,11361,12727,24088
2022,Hidalgo,13,Acatlán,13001,10836,11633,22469
2022,Hidalgo,13,Acaxochitlán,13002,22636,24497,47133
2022,Hidalgo,13,Actopan,13003,29702,32886,62588
2022,Hidalgo,13,Agua Blanca de Iturbide,13004,4668,5187,9855
2022,Hidalgo,13,Ajacuba,13005,9946,10376,20322
2022,Hidalgo,13,Alfajayucan,13006,10997,11666,22663
2022,Hidalgo,13,Almoloya,13007,6651,6734,13385
2022,Hidalgo,13,Apan,13008,23482,25471,48953
2022,Hidalgo,13,Atitalaquia,13010,16316,16661,32977
2022,Hidalgo,13,Atlapexco,13011,10613,11446,22059
2022,Hidalgo,13,Atotonilco de Tula,13013,20531,21697,42228
2022,Hidalgo,13,Atotonilco el Grande,13012,14208,15847,30055
2022,Hidalgo,13,Calnali,13014,9173,9890,19063
2022,Hidalgo,13,Cardonal,13015,9713,10570,20283
2022,Hidalgo,13,Chapantongo,13017,7310,7719,15029
2022,Hidalgo,13,Chapulhuacán,13018,13052,12905,25957
2022,Hidalgo,13,Chilcuautla,13019,9851,10208,20059
2022,Hidalgo,13,Cuautepec de Hinojosa,13016,30408,33333,63741
2022,Hidalgo,13,El Arenal,13009,9895,10769,20664
2022,Hidalgo,13,Eloxochitlán,13020,1426,1626,3052
2022,Hidalgo,13,Emiliano Zapata,13021,7673,8498,16171
2022,Hidalgo,13,Epazoyucan,13022,8003,8465,16468
2022,Hidalgo,13,Francisco I. Madero,13023,19040,20746,39786
2022,Hidalgo,13,Huasca de Ocampo,13024,9296,10159,19455
2022,Hidalgo,13,Huautla,13025,11253,12248,23501
2022,Hidalgo,13,Huazalingo,13026,7479,7862,15341
2022,Hidalgo,13,Huehuetla,13027,13454,14361,27815
2022,Hidalgo,13,Huejutla de Reyes,13028,69817,72250,142067
2022,Hidalgo,13,Huichapan,13029,24359,26459,50818
2022,Hidalgo,13,Ixmiquilpan,13030,48125,53855,101980
2022,Hidalgo,13,Jacala de Ledezma,13031,7009,7802,14811
2022,Hidalgo,13,Jaltocán,13032,6453,6631,13084
2022,Hidalgo,13,Juárez Hidalgo,13033,1663,1821,3484
2022,Hidalgo,13,La Misión,13040,5456,5626,11082
2022,Hidalgo,13,Lolotla,13034,5058,5317,10375
2022,Hidalgo,13,Metepec,13035,5966,6773,12739
2022,Hidalgo,13,Metztitlán,13037,10696,11862,22558
2022,Hidalgo,13,Mineral de la Reforma,13051,92494,101354,193848
2022,Hidalgo,13,Mineral del Chico,13038,4830,5120,9950
2022,Hidalgo,13,Mineral del Monte,13039,7690,8414,16104
2022,Hidalgo,13,Mixquiahuala de Juárez,13041,24593,26519,51112
2022,Hidalgo,13,Molango de Escamilla,13042,6256,6521,12777
2022,Hidalgo,13,Nicolás Flores,13043,3548,3997,7545
2022,Hidalgo,13,Nopala de Villagrán,13044,9087,9414,18501
2022,Hidalgo,13,Omitlán de Juárez,13045,5173,5648,10821
2022,Hidalgo,13,Pachuca de Soto,13048,135292,148269,283561
2022,Hidalgo,13,Pacula,13047,2526,2911,5437
2022,Hidalgo,13,Pisaflores,13049,9516,9518,19034
2022,Hidalgo,13,Progreso de Obregón,13050,12288,13650,25938
2022,Hidalgo,13,San Agustín Metzquititlán,13036,5053,5497,10550
2022,Hidalgo,13,San Agustín Tlaxiaca,13052,19698,20594,40292
2022,Hidalgo,13,San Bartolo Tutotepec,13053,10073,10320,20393
2022,Hidalgo,13,San Felipe Orizatlán,13046,20719,21523,42242
2022,Hidalgo,13,San Salvador,13054,18771,20085,38856
2022,Hidalgo,13,Santiago Tulantepec de Lugo Guerrero,13056,19602,21402,41004
2022,Hidalgo,13,Santiago de Anaya,13055,9190,9628,18818
2022,Hidalgo,13,Singuilucan,13057,8780,9004,17784
2022,Hidalgo,13,Tasquillo,13058,8189,9650,17839
2022,Hidalgo,13,Tecozautla,13059,19879,21527,41406
2022,Hidalgo,13,Tenango de Doria,13060,9496,10513,20009
2022,Hidalgo,13,Tepeapulco,13061,29026,30891,59917
2022,Hidalgo,13,Tepehuacán de Guerrero,13062,16946,16425,33371
2022,Hidalgo,13,Tepeji del Río de Ocampo,13063,47149,48449,95598
2022,Hidalgo,13,Tepetitlán,13064,5893,6200,12093
2022,Hidalgo,13,Tetepango,13065,6370,6410,12780
2022,Hidalgo,13,Tezontepec de Aldama,13067,28849,29502,58351
2022,Hidalgo,13,Tianguistengo,13068,8003,8360,16363
2022,Hidalgo,13,Tizayuca,13069,70471,72272,142743
2022,Hidalgo,13,Tlahuelilpan,13070,10454,10781,21235
2022,Hidalgo,13,Tlahuiltepa,13071,5545,5603,11148
2022,Hidalgo,13,Tlanalapa,13072,5514,5875,11389
2022,Hidalgo,13,Tlanchinol,13073,21317,21677,42994
2022,Hidalgo,13,Tlaxcoapan,13074,15456,15846,31302
2022,Hidalgo,13,Tolcayuca,13075,8838,9343,18181
2022,Hidalgo,13,Tula de Allende,13076,58983,62357,121340
2022,Hidalgo,13,Tulancingo de Bravo,13077,82223,91137,173360
2022,Hidalgo,13,Villa de Tezontepec,13066,6721,6996,13717
2022,Hidalgo,13,Xochiatipan,13078,10491,11093,21584
2022,Hidalgo,13,Xochicoatlán,13079,4174,4311,8485
2022,Hidalgo,13,Yahualica,13080,13018,13568,26586
2022,Hidalgo,13,Zacualtipán de Ángeles,13081,18437,20130,38567
2022,Hidalgo,13,Zapotlán de Juárez,13082,9993,10786,20779
2022,Hidalgo,13,Zempoala,13083,25491,26944,52435
2022,Hidalgo,13,Zimapán,13084,20063,23309,43372
2022,Jalisco,14,Acatic,14001,11489,11930,23419
2022,Jalisco,14,Acatlán de Juárez,14002,12493,11812,24305
2022,Jalisco,14,Ahualulco de Mercado,14003,12404,12798,25202
2022,Jalisco,14,Amacueca,14004,2898,3033,5931
2022,Jalisco,14,Amatitán,14005,8320,8406,16726
2022,Jalisco,14,Ameca,14006,32499,33795,66294
2022,Jalisco,14,Arandas,14008,39027,41873,80900
2022,Jalisco,14,Atemajac de Brizuela,14010,3597,3640,7237
2022,Jalisco,14,Atengo,14011,3141,2907,6048
2022,Jalisco,14,Atenguillo,14012,2124,2194,4318
2022,Jalisco,14,Atotonilco el Alto,14013,32474,33507,65981
2022,Jalisco,14,Atoyac,14014,4245,4590,8835
2022,Jalisco,14,Autlán de Navarro,14015,32937,33972,66909
2022,Jalisco,14,Ayotlán,14016,20180,21043,41223
2022,Jalisco,14,Ayutla,14017,6803,6786,13589
2022,Jalisco,14,Bolaños,14019,4218,4226,8444
2022,Jalisco,14,Cabo Corrientes,14020,5883,5429,11312
2022,Jalisco,14,Casimiro Castillo,14021,11851,11855,23706
2022,Jalisco,14,Cañadas de Obregón,14117,2225,2312,4537
2022,Jalisco,14,Chapala,14030,27338,28621,55959
2022,Jalisco,14,Chimaltitán,14031,1774,1818,3592
2022,Jalisco,14,Chiquilistlán,14032,3322,3268,6590
2022,Jalisco,14,Cihuatlán,14022,22839,22271,45110
2022,Jalisco,14,Cocula,14024,14178,14860,29038
2022,Jalisco,14,Colotlán,14025,9471,10134,19605
2022,Jalisco,14,Concepción de Buenos Aires,14026,3421,3281,6702
2022,Jalisco,14,Cuautitlán de García Barragán,14027,9837,9567,19404
2022,Jalisco,14,Cuautla,14028,1139,1218,2357
2022,Jalisco,14,Cuquío,14029,9453,10305,19758
2022,Jalisco,14,Degollado,14033,11282,11964,23246
2022,Jalisco,14,Ejutla,14034,1083,1009,2092
2022,Jalisco,14,El Arenal,14009,10692,10814,21506
2022,Jalisco,14,El Grullo,14037,13052,13768,26820
2022,Jalisco,14,El Limón,14054,3012,3012,6024
2022,Jalisco,14,El Salto,14070,102613,103486,206099
2022,Jalisco,14,Encarnación de Díaz,14035,28116,30164,58280
2022,Jalisco,14,Etzatlán,14036,10548,11038,21586
2022,Jalisco,14,Guachinango,14038,2353,2268,4621
2022,Jalisco,14,Guadalajara,14039,737797,780119,1517916
2022,Jalisco,14,Gómez Farías,14079,7565,8055,15620
2022,Jalisco,14,Hostotipaquillo,14040,6016,5194,11210
2022,Jalisco,14,Huejuquilla el Alto,14042,4645,5001,9646
2022,Jalisco,14,Huejúcar,14041,3024,3318,6342
2022,Jalisco,14,Ixtlahuacán de los Membrillos,14044,30906,31487,62393
2022,Jalisco,14,Ixtlahuacán del Río,14045,10044,10657,20701
2022,Jalisco,14,Jalostotitlán,14046,18189,18594,36783
2022,Jalisco,14,Jamay,14047,13531,13515,27046
2022,Jalisco,14,Jesús María,14048,9491,11243,20734
2022,Jalisco,14,Jilotlán de los Dolores,14049,5237,5015,10252
2022,Jalisco,14,Jocotepec,14050,25086,25391,50477
2022,Jalisco,14,Juanacatlán,14051,9893,9867,19760
2022,Jalisco,14,Juchitlán,14052,2983,3153,6136
2022,Jalisco,14,La Barca,14018,34451,36585,71036
2022,Jalisco,14,La Huerta,14043,13546,13043,26589
2022,Jalisco,14,La Manzanilla de la Paz,14057,1978,2125,4103
2022,Jalisco,14,Lagos de Moreno,14053,87619,91289,178908
2022,Jalisco,14,Magdalena,14055,12295,12277,24572
2022,Jalisco,14,Mascota,14058,7853,8112,15965
2022,Jalisco,14,Mazamitla,14059,7342,7950,15292
2022,Jalisco,14,Mexticacán,14060,2519,2942,5461
2022,Jalisco,14,Mezquitic,14061,10293,10906,21199
2022,Jalisco,14,Mixtlán,14062,1932,1904,3836
2022,Jalisco,14,Ocotlán,14063,53041,54772,107813
2022,Jalisco,14,Ojuelos de Jalisco,14064,16887,17724,34611
2022,Jalisco,14,Pihuamo,14065,6140,6043,12183
2022,Jalisco,14,Poncitlán,14066,27708,28417,56125
2022,Jalisco,14,Puerto Vallarta,14067,154652,150988,305640
2022,Jalisco,14,Quitupan,14069,4219,4697,8916
2022,Jalisco,14,San Cristóbal de la Barranca,14071,1584,1589,3173
2022,Jalisco,14,San Diego de Alejandría,14072,3792,4061,7853
2022,Jalisco,14,San Gabriel,14113,8741,9071,17812
2022,Jalisco,14,San Ignacio Cerro Gordo,14125,9979,10581,20560
2022,Jalisco,14,San Juan de los Lagos,14073,37588,38032,75620
2022,Jalisco,14,San Juanito de Escobedo,14007,5110,5038,10148
2022,Jalisco,14,San Julián,14074,8261,9086,17347
2022,Jalisco,14,San Marcos,14075,2085,2033,4118
2022,Jalisco,14,San Martín Hidalgo,14077,14709,15410,30119
2022,Jalisco,14,San Martín de Bolaños,14076,1632,1629,3261
2022,Jalisco,14,San Miguel el Alto,14078,17467,18313,35780
2022,Jalisco,14,San Pedro Tlaquepaque,14098,358949,362228,721177
2022,Jalisco,14,San Sebastián del Oeste,14080,3178,2859,6037
2022,Jalisco,14,Santa María de los Ángeles,14081,1633,1803,3436
2022,Jalisco,14,Santa María del Oro,14056,1114,1101,2215
2022,Jalisco,14,Sayula,14082,19283,20731,40014
2022,Jalisco,14,Tala,14083,43764,44322,88086
2022,Jalisco,14,Talpa de Allende,14084,8220,8096,16316
2022,Jalisco,14,Tamazula de Gordiano,14085,20487,21397,41884
2022,Jalisco,14,Tapalpa,14086,10296,10711,21007
2022,Jalisco,14,Tecalitlán,14087,8797,9184,17981
2022,Jalisco,14,Techaluta de Montenegro,14089,2018,2079,4097
2022,Jalisco,14,Tecolotlán,14088,9443,9431,18874
2022,Jalisco,14,Tenamaxtlán,14090,3807,3790,7597
2022,Jalisco,14,Teocaltiche,14091,21484,23526,45010
2022,Jalisco,14,Teocuitatlán de Corona,14092,5588,5769,11357
2022,Jalisco,14,Tepatitlán de Morelos,14093,75365,77978,153343
2022,Jalisco,14,Tequila,14094,22550,22822,45372
2022,Jalisco,14,Teuchitlán,14095,5200,5383,10583
2022,Jalisco,14,Tizapán el Alto,14096,11205,11746,22951
2022,Jalisco,14,Tlajomulco de Zúñiga,14097,333562,338796,672358
2022,Jalisco,14,Tolimán,14099,5542,5610,11152
2022,Jalisco,14,Tomatlán,14100,19730,18755,38485
2022,Jalisco,14,Tonalá,14101,294471,294403,588874
2022,Jalisco,14,Tonaya,14102,3207,3346,6553
2022,Jalisco,14,Tonila,14103,4290,4312,8602
2022,Jalisco,14,Totatiche,14104,2392,2411,4803
2022,Jalisco,14,Tototlán,14105,12453,12733,25186
2022,Jalisco,14,Tuxcacuesco,14106,2424,2314,4738
2022,Jalisco,14,Tuxcueca,14107,3283,3501,6784
2022,Jalisco,14,Tuxpan,14108,18384,19521,37905
2022,Jalisco,14,Unión de San Antonio,14109,9493,10131,19624
2022,Jalisco,14,Unión de Tula,14110,7099,7567,14666
2022,Jalisco,14,Valle de Guadalupe,14111,3813,3829,7642
2022,Jalisco,14,Valle de Juárez,14112,2920,3075,5995
2022,Jalisco,14,Villa Corona,14114,9658,9887,19545
2022,Jalisco,14,Villa Guerrero,14115,2959,3037,5996
2022,Jalisco,14,Villa Hidalgo,14116,10763,11485,22248
2022,Jalisco,14,Villa Purificación,14068,6128,5686,11814
2022,Jalisco,14,Yahualica de González Gallo,14118,11594,12633,24227
2022,Jalisco,14,Zacoalco de Torres,14119,15397,15606,31003
2022,Jalisco,14,Zapopan,14120,717393,741077,1458470
2022,Jalisco,14,Zapotiltic,14121,15602,16219,31821
2022,Jalisco,14,Zapotitlán de Vadillo,14122,3830,3790,7620
2022,Jalisco,14,Zapotlanejo,14124,36418,37311,73729
2022,Jalisco,14,Zapotlán del Rey,14123,9826,9869,19695
2022,Jalisco,14,Zapotlán el Grande,14023,56583,59388,115971
2022,Michoacán,16,Acuitzio,16001,5870,6309,12179
2022,Michoacán,16,Aguililla,16002,7677,7503,15180
2022,Michoacán,16,Angamacutiro,16004,7676,8463,16139
2022,Michoacán,16,Angangueo,16005,5791,6127,11918
2022,Michoacán,16,Apatzingán,16006,67070,67998,135068
2022,Michoacán,16,Aporo,16007,1683,1796,3479
2022,Michoacán,16,Aquila,16008,13473,13051,26524
2022,Michoacán,16,Ario,16009,19117,20118,39235
2022,Michoacán,16,Arteaga,16010,11430,11540,22970
2022,Michoacán,16,Briseñas,16011,5935,6227,12162
2022,Michoacán,16,Buenavista,16012,25768,24540,50308
2022,Michoacán,16,Carácuaro,16013,4863,4830,9693
2022,Michoacán,16,Charapan,16021,6186,6987,13173
2022,Michoacán,16,Charo,16022,12159,11369,23528
2022,Michoacán,16,Chavinda,16023,5349,5596,10945
2022,Michoacán,16,Cherán,16024,9782,10520,20302
2022,Michoacán,16,Chilchota,16025,20147,21708,41855
2022,Michoacán,16,Chinicuila,16026,2600,2383,4983
2022,Michoacán,16,Chucándiro,16027,2072,2447,4519
2022,Michoacán,16,Churintzio,16028,2560,2867,5427
2022,Michoacán,16,Churumuco,16029,8063,8033,16096
2022,Michoacán,16,Coahuayana,16014,7999,7389,15388
2022,Michoacán,16,Coalcomán de Vázquez Pallares,16015,9123,9317,18440
2022,Michoacán,16,Coeneo,16016,10238,11851,22089
2022,Michoacán,16,Cojumatlán de Régules,16074,5442,5645,11087
2022,Michoacán,16,Contepec,16017,17635,18606,36241
2022,Michoacán,16,Copándaro,16018,4540,5054,9594
2022,Michoacán,16,Cotija,16019,9396,10357,19753
2022,Michoacán,16,Cuitzeo,16020,15130,16666,31796
2022,Michoacán,16,Ecuandureo,16030,6092,7189,13281
2022,Michoacán,16,Epitacio Huerta,16031,8665,9046,17711
2022,Michoacán,16,Erongarícuaro,16032,7881,8463,16344
2022,Michoacán,16,Gabriel Zamora,16033,12085,12142,24227
2022,Michoacán,16,Hidalgo,16034,63662,66841,130503
2022,Michoacán,16,Huandacareo,16036,5939,6754,12693
2022,Michoacán,16,Huaniqueo,16037,3954,4619,8573
2022,Michoacán,16,Huetamo,16038,20949,21881,42830
2022,Michoacán,16,Huiramba,16039,4623,4776,9399
2022,Michoacán,16,Indaparapeo,16040,8641,9117,17758
2022,Michoacán,16,Irimbo,16041,7711,8428,16139
2022,Michoacán,16,Ixtlán,16042,6735,6891,13626
2022,Michoacán,16,Jacona,16043,35735,37730,73465
2022,Michoacán,16,Jiménez,16044,6490,7035,13525
2022,Michoacán,16,Jiquilpan,16045,16692,18321,35013
2022,Michoacán,16,José Sixto Verduzco,16113,13302,14625,27927
2022,Michoacán,16,Jungapeo,16047,11220,11370,22590
2022,Michoacán,16,Juárez,16046,7583,7952,15535
2022,Michoacán,16,La Huacana,16035,17927,18067,35994
2022,Michoacán,16,La Piedad,16069,53688,58358,112046
2022,Michoacán,16,Lagunillas,16048,2932,3012,5944
2022,Michoacán,16,Los Reyes,16075,36492,38094,74586
2022,Michoacán,16,Lázaro Cárdenas,16052,97168,96342,193510
2022,Michoacán,16,Madero,16049,9596,9378,18974
2022,Michoacán,16,Maravatío,16050,45360,48924,94284
2022,Michoacán,16,Marcos Castellanos,16051,7140,7635,14775
2022,Michoacán,16,Morelia,16053,402913,433852,836765
2022,Michoacán,16,Morelos,16054,3575,4297,7872
2022,Michoacán,16,Múgica,16055,23918,24430,48348
2022,Michoacán,16,Nahuatzen,16056,14710,15576,30286
2022,Michoacán,16,Nocupétaro,16057,4268,4323,8591
2022,Michoacán,16,Nuevo Parangaricutiro,16058,10407,10756,21163
2022,Michoacán,16,Nuevo Urecho,16059,4275,4285,8560
2022,Michoacán,16,Numarán,16060,4955,5447,10402
2022,Michoacán,16,Ocampo,16061,12820,12830,25650
2022,Michoacán,16,Pajacuarán,16062,9929,10584,20513
2022,Michoacán,16,Panindícuaro,16063,7888,8844,16732
2022,Michoacán,16,Paracho,16065,19086,20858,39944
2022,Michoacán,16,Parácuaro,16064,14351,14000,28351
2022,Michoacán,16,Penjamillo,16067,8426,9570,17996
2022,Michoacán,16,Peribán,16068,15061,14845,29906
2022,Michoacán,16,Puruándiro,16071,33581,37334,70915
2022,Michoacán,16,Purépero,16070,7939,8275,16214
2022,Michoacán,16,Pátzcuaro,16066,47755,51680,99435
2022,Michoacán,16,Queréndaro,16072,7074,7419,14493
2022,Michoacán,16,Quiroga,16073,14128,15448,29576
2022,Michoacán,16,Sahuayo,16076,40484,42241,82725
2022,Michoacán,16,Salvador Escalante,16079,25528,26937,52465
2022,Michoacán,16,San Lucas,16077,9498,9628,19126
2022,Michoacán,16,Santa Ana Maya,16078,6215,7066,13281
2022,Michoacán,16,Senguio,16080,9806,10442,20248
2022,Michoacán,16,Susupuato,16081,4611,4635,9246
2022,Michoacán,16,Tacámbaro,16082,40448,42204,82652
2022,Michoacán,16,Tancítaro,16083,16792,16325,33117
2022,Michoacán,16,Tangamandapio,16084,15109,16220,31329
2022,Michoacán,16,Tangancícuaro,16085,17374,18418,35792
2022,Michoacán,16,Tanhuato,16086,8039,8424,16463
2022,Michoacán,16,Taretan,16087,7774,7943,15717
2022,Michoacán,16,Tarímbaro,16088,59383,64073,123456
2022,Michoacán,16,Tepalcatepec,16089,12748,12453,25201
2022,Michoacán,16,Tingambato,16090,7835,8274,16109
2022,Michoacán,16,Tingüindín,16091,7511,8090,15601
2022,Michoacán,16,Tiquicheo de Nicolás Romero,16092,7005,7102,14107
2022,Michoacán,16,Tlalpujahua,16093,14559,16145,30704
2022,Michoacán,16,Tlazazalca,16094,3279,3472,6751
2022,Michoacán,16,Tocumbo,16095,6364,6460,12824
2022,Michoacán,16,Tumbiscatío,16096,3496,3370,6866
2022,Michoacán,16,Turicato,16097,15945,16713,32658
2022,Michoacán,16,Tuxpan,16098,13851,14861,28712
2022,Michoacán,16,Tuzantla,16099,7964,8033,15997
2022,Michoacán,16,Tzintzuntzan,16100,7308,8063,15371
2022,Michoacán,16,Tzitzio,16101,4565,4428,8993
2022,Michoacán,16,Uruapan,16102,174616,185262,359878
2022,Michoacán,16,Venustiano Carranza,16103,13028,13495,26523
2022,Michoacán,16,Villamar,16104,8475,9149,17624
2022,Michoacán,16,Vista Hermosa,16105,10838,11225,22063
2022,Michoacán,16,Yurécuaro,16106,16405,17229,33634
2022,Michoacán,16,Zacapu,16107,38866,41777,80643
2022,Michoacán,16,Zamora,16108,102571,108294,210865
2022,Michoacán,16,Zinapécuaro,16110,24020,25954,49974
2022,Michoacán,16,Zináparo,16109,1573,1824,3397
2022,Michoacán,16,Ziracuaretiro,16111,9210,9379,18589
2022,Michoacán,16,Zitácuaro,16112,83339,90779,174118
2022,Michoacán,16,Álvaro Obregón,16003,11271,11998,23269
2022,Morelos,17,Amacuzac,17001,9385,9818,19203
2022,Morelos,17,Atlatlahucan,17002,12221,12663,24884
2022,Morelos,17,Axochiapan,17003,19302,19720,39022
2022,Morelos,17,Ayala,17004,45003,47931,92934
2022,Morelos,17,Coatlán del Río,17005,5299,5423,10722
2022,Morelos,17,Cuautla,17006,102853,110081,212934
2022,Morelos,17,Cuernavaca,17007,191128,214959,406087
2022,Morelos,17,Emiliano Zapata,17008,54045,55673,109718
2022,Morelos,17,Huitzilac,17009,10378,10427,20805
2022,Morelos,17,Jantetelco,17010,9209,9584,18793
2022,Morelos,17,Jiutepec,17011,112156,119086,231242
2022,Morelos,17,Jojutla,17012,30217,32300,62517
2022,Morelos,17,Jonacatepec,17013,8224,8844,17068
2022,Morelos,17,Mazatepec,17014,5337,5558,10895
2022,Morelos,17,Miacatlán,17015,14049,14741,28790
2022,Morelos,17,Ocuituco,17016,9943,10173,20116
2022,Morelos,17,Puente de Ixtla,17017,35494,36844,72338
2022,Morelos,17,Temixco,17018,61769,64299,126068
2022,Morelos,17,Temoac,17033,8454,8912,17366
2022,Morelos,17,Tepalcingo,17019,14435,15022,29457
2022,Morelos,17,Tepoztlán,17020,26028,26890,52918
2022,Morelos,17,Tetecala,17021,4245,4260,8505
2022,Morelos,17,Tetela del Volcán,17022,10945,11535,22480
2022,Morelos,17,Tlalnepantla,17023,4000,3882,7882
2022,Morelos,17,Tlaltizapán de Zapata,17024,27672,28975,56647
2022,Morelos,17,Tlaquiltenango,17025,18248,18678,36926
2022,Morelos,17,Tlayacapan,17026,9684,9862,19546
2022,Morelos,17,Totolapan,17027,6447,6619,13066
2022,Morelos,17,Xochitepec,17028,38662,37747,76409
2022,Morelos,17,Yautepec,17029,54568,57444,112012
2022,Morelos,17,Yecapixtla,17030,28588,29172,57760
2022,Morelos,17,Zacatepec,17031,19198,20698,39896
2022,Morelos,17,Zacualpan,17032,5104,5313,10417
2022,Nayarit,18,Acaponeta,18001,20689,20557,41246
2022,Nayarit,18,Ahuacatlán,18002,8879,8768,17647
2022,Nayarit,18,Amatlán de Cañas,18003,6666,6410,13076
2022,Nayarit,18,Bahía de Banderas,18020,92670,89052,181722
2022,Nayarit,18,Compostela,18004,42191,41773,83964
2022,Nayarit,18,Del Nayar,18009,23314,23194,46508
2022,Nayarit,18,Huajicori,18005,7054,6797,13851
2022,Nayarit,18,Ixtlán del Río,18006,15771,16753,32524
2022,Nayarit,18,Jala,18007,10151,10299,20450
2022,Nayarit,18,La Yesca,18019,7816,7357,15173
2022,Nayarit,18,Rosamorada,18010,19367,18478,37845
2022,Nayarit,18,Ruíz,18011,13986,13605,27591
2022,Nayarit,18,San Blas,18012,25994,23244,49238
2022,Nayarit,18,San Pedro Lagunillas,18013,4277,4142,8419
2022,Nayarit,18,Santa María del Oro,18014,13284,12742,26026
2022,Nayarit,18,Santiago Ixcuintla,18015,55395,53380,108775
2022,Nayarit,18,Tecuala,18016,22377,21619,43996
2022,Nayarit,18,Tepic,18017,223489,233919,457408
2022,Nayarit,18,Tuxpan,18018,17026,17121,34147
2022,Nayarit,18,Xalisco,18008,31285,32513,63798
2022,Nuevo León,19,Abasolo,19001,1464,1467,2931
2022,Nuevo León,19,Agualeguas,19002,1333,1268,2601
2022,Nuevo León,19,Allende,19004,19798,19510,39308
2022,Nuevo León,19,Anáhuac,19005,10114,10204,20318
2022,Nuevo León,19,Apodaca,19006,345497,339680,685177
2022,Nuevo León,19,Aramberri,19007,9235,9055,18290
2022,Nuevo León,19,Bustamante,19008,2259,2246,4505
2022,Nuevo León,19,Cadereyta Jiménez,19009,55187,52692,107879
2022,Nuevo León,19,Cerralvo,19011,4338,4064,8402
2022,Nuevo León,19,China,19013,6269,5965,12234
2022,Nuevo León,19,Ciénega de Flores,19012,27019,25976,52995
2022,Nuevo León,19,Doctor Arroyo,19014,19547,19181,38728
2022,Nuevo León,19,Doctor Coss,19015,973,937,1910
2022,Nuevo León,19,Doctor González,19016,1711,1630,3341
2022,Nuevo León,19,El Carmen,19010,25211,24658,49869
2022,Nuevo León,19,Galeana,19017,23279,22768,46047
2022,Nuevo León,19,García,19018,159472,157430,316902
2022,Nuevo León,19,General Bravo,19020,3223,3069,6292
2022,Nuevo León,19,General Escobedo,19021,239904,238808,478712
2022,Nuevo León,19,General Terán,19022,8323,8382,16705
2022,Nuevo León,19,General Treviño,19023,589,620,1209
2022,Nuevo León,19,General Zaragoza,19024,3490,3260,6750
2022,Nuevo León,19,General Zuazua,19025,48816,47918,96734
2022,Nuevo León,19,Guadalupe,19026,365316,356133,721449
2022,Nuevo León,19,Hidalgo,19047,8058,7978,16036
2022,Nuevo León,19,Higueras,19028,909,839,1748
2022,Nuevo León,19,Hualahuises,19029,3934,3999,7933
2022,Nuevo León,19,Iturbide,19030,2119,1955,4074
2022,Nuevo León,19,Juárez,19031,209993,204941,414934
2022,Nuevo León,19,Lampazos de Naranjo,19032,3009,2927,5936
2022,Nuevo León,19,Linares,19033,45378,45454,90832
2022,Nuevo León,19,Los Aldamas,19003,796,776,1572
2022,Nuevo León,19,Los Herreras,19027,1011,1038,2049
2022,Nuevo León,19,Los Ramones,19042,2667,2607,5274
2022,Nuevo León,19,Marín,19034,3251,3051,6302
2022,Nuevo León,19,Melchor Ocampo,19035,562,545,1107
2022,Nuevo León,19,Mier y Noriega,19036,3906,3826,7732
2022,Nuevo León,19,Mina,19037,3055,2922,5977
2022,Nuevo León,19,Montemorelos,19038,34777,34636,69413
2022,Nuevo León,19,Monterrey,19039,563140,586465,1149605
2022,Nuevo León,19,Parás,19040,555,548,1103
2022,Nuevo León,19,Pesquería,19041,59755,59120,118875
2022,Nuevo León,19,Rayones,19043,1591,1488,3079
2022,Nuevo León,19,Sabinas Hidalgo,19044,19667,20313,39980
2022,Nuevo León,19,Salinas Victoria,19045,32899,31495,64394
2022,Nuevo León,19,San Nicolás de los Garza,19046,235355,243695,479050
2022,Nuevo León,19,San Pedro Garza García,19019,66368,74102,140470
2022,Nuevo León,19,Santa Catarina,19048,165402,163445,328847
2022,Nuevo León,19,Santiago,19049,24158,23925,48083
2022,Nuevo León,19,Vallecillo,19050,1077,911,1988
2022,Nuevo León,19,Villaldama,19051,2346,2331,4677
2022,Oaxaca,20,Abejones,20001,430,582,1012
2022,Oaxaca,20,Acatlán de Pérez Figueroa,20002,23473,24540,48013
2022,Oaxaca,20,Asunción Cacalotepec,20003,1052,1122,2174
2022,Oaxaca,20,Asunción Cuyotepeji,20004,482,555,1037
2022,Oaxaca,20,Asunción Ixtaltepec,20005,7949,8045,15994
2022,Oaxaca,20,Asunción Nochixtlán,20006,9419,10546,19965
2022,Oaxaca,20,Asunción Ocotlán,20007,1091,1362,2453
2022,Oaxaca,20,Asunción Tlacolulita,20008,394,419,813
2022,Oaxaca,20,Ayoquezco de Aldama,20398,2089,2356,4445
2022,Oaxaca,20,Ayotzintepec,20009,3740,3797,7537
2022,Oaxaca,20,Calihualá,20011,586,617,1203
2022,Oaxaca,20,Candelaria Loxicha,20012,5313,5639,10952
2022,Oaxaca,20,Capulálpam de Méndez,20247,740,906,1646
2022,Oaxaca,20,Chahuites,20025,6055,6136,12191
2022,Oaxaca,20,Chalcatongo de Hidalgo,20026,4484,5107,9591
2022,Oaxaca,20,Chiquihuitlán de Benito Juárez,20027,1115,1322,2437
2022,Oaxaca,20,Ciudad Ixtepec,20014,14811,16090,30901
2022,Oaxaca,20,Ciénega de Zimatlán,20013,1514,1646,3160
2022,Oaxaca,20,Coatecas Altas,20015,2182,2498,4680
2022,Oaxaca,20,Coicoyán de las Flores,20016,4955,5608,10563
2022,Oaxaca,20,Concepción Buenavista,20018,404,428,832
2022,Oaxaca,20,Concepción Pápalo,20019,1547,1551,3098
2022,Oaxaca,20,Constancia del Rosario,20020,1899,2206,4105
2022,Oaxaca,20,Cosolapa,20021,7874,8514,16388
2022,Oaxaca,20,Cosoltepec,20022,360,424,784
2022,Oaxaca,20,Cuilápam de Guerrero,20023,11316,11975,23291
2022,Oaxaca,20,Cuyamecalco Villa de Zaragoza,20024,1927,1890,3817
2022,Oaxaca,20,El Barrio de la Soledad,20010,7219,7799,15018
2022,Oaxaca,20,El Espinal,20030,4515,4713,9228
2022,Oaxaca,20,Eloxochitlán de Flores Magón,20029,2116,2372,4488
2022,Oaxaca,20,Fresnillo de Trujano,20032,519,559,1078
2022,Oaxaca,20,Guadalupe Etla,20033,1359,1507,2866
2022,Oaxaca,20,Guadalupe de Ramírez,20034,660,676,1336
2022,Oaxaca,20,Guelatao de Juárez,20035,279,290,569
2022,Oaxaca,20,Guevea de Humboldt,20036,2679,2809,5488
2022,Oaxaca,20,Heroica Ciudad de Ejutla de Crespo,20028,10551,11775,22326
2022,Oaxaca,20,Heroica Ciudad de Huajuapan de León,20039,39175,43539,82714
2022,Oaxaca,20,Heroica Ciudad de Juchitán de Zaragoza,20043,50943,53496,104439
2022,Oaxaca,20,Heroica Ciudad de Tlaxiaco,20397,20285,22957,43242
2022,Oaxaca,20,Huautepec,20040,3011,3461,6472
2022,Oaxaca,20,Huautla de Jiménez,20041,15123,17397,32520
2022,Oaxaca,20,Ixpantepec Nieves,20065,525,657,1182
2022,Oaxaca,20,Ixtlán de Juárez,20042,4233,4369,8602
2022,Oaxaca,20,La Compañía,20017,1621,1792,3413
2022,Oaxaca,20,La Pe,20069,1347,1439,2786
2022,Oaxaca,20,La Reforma,20076,1586,1743,3329
2022,Oaxaca,20,La Trinidad Vista Hermosa,20556,118,145,263
2022,Oaxaca,20,Loma Bonita,20044,21513,23548,45061
2022,Oaxaca,20,Magdalena Apasco,20045,4515,5025,9540
2022,Oaxaca,20,Magdalena Jaltepec,20046,1530,1801,3331
2022,Oaxaca,20,Magdalena Mixtepec,20048,690,717,1407
2022,Oaxaca,20,Magdalena Ocotlán,20049,587,633,1220
2022,Oaxaca,20,Magdalena Peñasco,20050,1692,1967,3659
2022,Oaxaca,20,Magdalena Teitipac,20051,2324,2494,4818
2022,Oaxaca,20,Magdalena Tequisistlán,20052,3127,3290,6417
2022,Oaxaca,20,Magdalena Tlacotepec,20053,631,689,1320
2022,Oaxaca,20,Magdalena Yodocono de Porfirio Díaz,20562,792,838,1630
2022,Oaxaca,20,Magdalena Zahuatlán,20054,201,227,428
2022,Oaxaca,20,Mariscala de Juárez,20055,1792,1947,3739
2022,Oaxaca,20,Matías Romero Avendaño,20057,19719,21168,40887
2022,Oaxaca,20,Mazatlán Villa de Flores,20058,6707,6843,13550
2022,Oaxaca,20,Mesones Hidalgo,20037,2104,2490,4594
2022,Oaxaca,20,Miahuatlán de Porfirio Díaz,20059,22157,24289,46446
2022,Oaxaca,20,Mixistlán de la Reforma,20060,1287,1435,2722
2022,Oaxaca,20,Monjas,20061,1328,1569,2897
2022,Oaxaca,20,Mártires de Tacubaya,20056,728,790,1518
2022,Oaxaca,20,Natividad,20062,306,349,655
2022,Oaxaca,20,Nazareno Etla,20063,2040,2248,4288
2022,Oaxaca,20,Nejapa de Madero,20064,3826,3978,7804
2022,Oaxaca,20,Nuevo Zoquiápam,20504,813,885,1698
2022,Oaxaca,20,Oaxaca de Juárez,20067,121062,138100,259162
2022,Oaxaca,20,Ocotlán de Morelos,20068,11104,12073,23177
2022,Oaxaca,20,Pinotepa de Don Luis,20070,3584,3674,7258
2022,Oaxaca,20,Pluma Hidalgo,20071,1467,1535,3002
2022,Oaxaca,20,Putla Villa de Guerrero,20073,16461,18546,35007
2022,Oaxaca,20,Reforma de Pineda,20075,1418,1516,2934
2022,Oaxaca,20,Reyes Etla,20077,2023,2151,4174
2022,Oaxaca,20,Rojas de Cuauhtémoc,20078,552,623,1175
2022,Oaxaca,20,Salina Cruz,20079,44981,48648,93629
2022,Oaxaca,20,San Agustín Amatengo,20080,704,797,1501
2022,Oaxaca,20,San Agustín Atenango,20081,839,962,1801
2022,Oaxaca,20,San Agustín Chayuco,20082,1929,2144,4073
2022,Oaxaca,20,San Agustín Etla,20084,2069,2282,4351
2022,Oaxaca,20,San Agustín Loxicha,20085,12772,13273,26045
2022,Oaxaca,20,San Agustín Tlacotepec,20086,425,568,993
2022,Oaxaca,20,San Agustín Yatareni,20087,2198,2491,4689
2022,Oaxaca,20,San Agustín de las Juntas,20083,5096,5296,10392
2022,Oaxaca,20,San Andrés Cabecera Nueva,20088,1426,1460,2886
2022,Oaxaca,20,San Andrés Dinicuiti,20089,1070,1136,2206
2022,Oaxaca,20,San Andrés Huaxpaltepec,20090,3126,3302,6428
2022,Oaxaca,20,San Andrés Huayápam,20091,2733,2991,5724
2022,Oaxaca,20,San Andrés Ixtlahuaca,20092,795,897,1692
2022,Oaxaca,20,San Andrés Lagunas,20093,236,274,510
2022,Oaxaca,20,San Andrés Nuxiño,20094,862,942,1804
2022,Oaxaca,20,San Andrés Paxtlán,20095,2265,2277,4542
2022,Oaxaca,20,San Andrés Sinaxtla,20096,369,424,793
2022,Oaxaca,20,San Andrés Solaga,20097,872,927,1799
2022,Oaxaca,20,San Andrés Teotilálpam,20098,2209,2401,4610
2022,Oaxaca,20,San Andrés Tepetlapa,20099,246,283,529
2022,Oaxaca,20,San Andrés Yaá,20100,213,258,471
2022,Oaxaca,20,San Andrés Zabache,20101,325,411,736
2022,Oaxaca,20,San Andrés Zautla,20102,2382,2529,4911
2022,Oaxaca,20,San Antonino Castillo Velasco,20103,3067,3362,6429
2022,Oaxaca,20,San Antonino Monte Verde,20105,3468,4054,7522
2022,Oaxaca,20,San Antonino el Alto,20104,1395,1438,2833
2022,Oaxaca,20,San Antonio Acutla,20106,120,145,265
2022,Oaxaca,20,San Antonio Huitepec,20108,2128,2476,4604
2022,Oaxaca,20,San Antonio Nanahuatípam,20109,638,647,1285
2022,Oaxaca,20,San Antonio Sinicahua,20110,766,886,1652
2022,Oaxaca,20,San Antonio Tepetlapa,20111,2161,2334,4495
2022,Oaxaca,20,San Antonio de la Cal,20107,12327,13723,26050
2022,Oaxaca,20,San Baltazar Chichicápam,20112,1225,1404,2629
2022,Oaxaca,20,San Baltazar Loxicha,20113,1511,1577,3088
2022,Oaxaca,20,San Baltazar Yatzachi el Bajo,20114,319,361,680
2022,Oaxaca,20,San Bartolo Coyotepec,20115,4922,5464,10386
2022,Oaxaca,20,San Bartolo Soyaltepec,20121,303,374,677
2022,Oaxaca,20,San Bartolo Yautepec,20122,338,345,683
2022,Oaxaca,20,San Bartolomé Ayautla,20116,2283,2432,4715
2022,Oaxaca,20,San Bartolomé Loxicha,20117,1184,1226,2410
2022,Oaxaca,20,San Bartolomé Quialana,20118,1053,1495,2548
2022,Oaxaca,20,San Bartolomé Yucuañe,20119,161,231,392
2022,Oaxaca,20,San Bartolomé Zoogocho,20120,127,180,307
2022,Oaxaca,20,San Bernardo Mixtepec,20123,1354,1463,2817
2022,Oaxaca,20,San Blas Atempa,20124,9557,9447,19004
2022,Oaxaca,20,San Carlos Yautepec,20125,6424,6314,12738
2022,Oaxaca,20,San Cristóbal Amatlán,20126,2577,2920,5497
2022,Oaxaca,20,San Cristóbal Amoltepec,20127,520,622,1142
2022,Oaxaca,20,San Cristóbal Lachirioag,20128,636,688,1324
2022,Oaxaca,20,San Cristóbal Suchixtlahuaca,20129,188,197,385
2022,Oaxaca,20,San Dionisio Ocotepec,20131,5248,5971,11219
2022,Oaxaca,20,San Dionisio Ocotlán,20132,597,615,1212
2022,Oaxaca,20,San Dionisio del Mar,20130,2755,2639,5394
2022,Oaxaca,20,San Esteban Atatlahuca,20133,1918,2012,3930
2022,Oaxaca,20,San Felipe Jalapa de Díaz,20134,14118,15083,29201
2022,Oaxaca,20,San Felipe Tejalápam,20135,3971,4349,8320
2022,Oaxaca,20,San Felipe Usila,20136,5785,6275,12060
2022,Oaxaca,20,San Francisco Cahuacuá,20137,1753,1778,3531
2022,Oaxaca,20,San Francisco Cajonos,20138,215,240,455
2022,Oaxaca,20,San Francisco Chapulapa,20139,1035,1119,2154
2022,Oaxaca,20,San Francisco Chindúa,20140,412,439,851
2022,Oaxaca,20,San Francisco Huehuetlán,20142,492,622,1114
2022,Oaxaca,20,San Francisco Ixhuatán,20143,4631,4707,9338
2022,Oaxaca,20,San Francisco Jaltepetongo,20144,508,527,1035
2022,Oaxaca,20,San Francisco Lachigoló,20145,2302,2389,4691
2022,Oaxaca,20,San Francisco Logueche,20146,1435,1642,3077
2022,Oaxaca,20,San Francisco Nuxaño,20147,202,190,392
2022,Oaxaca,20,San Francisco Ozolotepec,20148,956,1018,1974
2022,Oaxaca,20,San Francisco Sola,20149,854,948,1802
2022,Oaxaca,20,San Francisco Telixtlahuaca,20150,6605,7080,13685
2022,Oaxaca,20,San Francisco Teopan,20151,180,163,343
2022,Oaxaca,20,San Francisco Tlapancingo,20152,1056,1330,2386
2022,Oaxaca,20,San Francisco del Mar,20141,4139,4044,8183
2022,Oaxaca,20,San Gabriel Mixtepec,20153,2496,2655,5151
2022,Oaxaca,20,San Ildefonso Amatlán,20154,1223,1399,2622
2022,Oaxaca,20,San Ildefonso Sola,20155,514,504,1018
2022,Oaxaca,20,San Ildefonso Villa Alta,20156,1736,1837,3573
2022,Oaxaca,20,San Jacinto Amilpas,20157,8888,9798,18686
2022,Oaxaca,20,San Jacinto Tlacotepec,20158,1094,1156,2250
2022,Oaxaca,20,San Jerónimo Coatlán,20159,2675,2831,5506
2022,Oaxaca,20,San Jerónimo Silacayoapilla,20160,686,718,1404
2022,Oaxaca,20,San Jerónimo Sosola,20161,1284,1443,2727
2022,Oaxaca,20,San Jerónimo Taviche,20162,967,1050,2017
2022,Oaxaca,20,San Jerónimo Tecóatl,20163,792,890,1682
2022,Oaxaca,20,San Jerónimo Tlacochahuaya,20550,2744,3082,5826
2022,Oaxaca,20,San Jorge Nuchita,20164,1348,1593,2941
2022,Oaxaca,20,San José Ayuquila,20165,749,868,1617
2022,Oaxaca,20,San José Chiltepec,20166,6199,6560,12759
2022,Oaxaca,20,San José Estancia Grande,20168,549,554,1103
2022,Oaxaca,20,San José Independencia,20169,1842,1980,3822
2022,Oaxaca,20,San José Lachiguiri,20170,1618,2008,3626
2022,Oaxaca,20,San José Tenango,20171,9125,9888,19013
2022,Oaxaca,20,San José del Peñasco,20167,1093,1136,2229
2022,Oaxaca,20,San José del Progreso,20072,3461,3664,7125
2022,Oaxaca,20,San Juan Achiutla,20172,210,217,427
2022,Oaxaca,20,San Juan Atepec,20173,737,826,1563
2022,Oaxaca,20,San Juan Bautista Atatlahuca,20175,804,859,1663
2022,Oaxaca,20,San Juan Bautista Coixtlahuaca,20176,1310,1456,2766
2022,Oaxaca,20,San Juan Bautista Cuicatlán,20177,5080,5384,10464
2022,Oaxaca,20,San Juan Bautista Guelache,20178,3823,4271,8094
2022,Oaxaca,20,San Juan Bautista Jayacatlán,20179,799,784,1583
2022,Oaxaca,20,San Juan Bautista Lo de Soto,20180,1339,1368,2707
2022,Oaxaca,20,San Juan Bautista Suchitepec,20181,211,254,465
2022,Oaxaca,20,San Juan Bautista Tlachichilco,20183,668,774,1442
2022,Oaxaca,20,San Juan Bautista Tlacoatzintepec,20182,1060,1181,2241
2022,Oaxaca,20,San Juan Bautista Tuxtepec,20184,82661,89545,172206
2022,Oaxaca,20,San Juan Bautista Valle Nacional,20559,11247,12264,23511
2022,Oaxaca,20,San Juan Cacahuatepec,20185,4578,4782,9360
2022,Oaxaca,20,San Juan Chicomezúchil,20191,162,191,353
2022,Oaxaca,20,San Juan Chilateca,20192,744,866,1610
2022,Oaxaca,20,San Juan Cieneguilla,20186,290,320,610
2022,Oaxaca,20,San Juan Coatzóspam,20187,1089,1068,2157
2022,Oaxaca,20,San Juan Colorado,20188,5058,5375,10433
2022,Oaxaca,20,San Juan Comaltepec,20189,1455,1523,2978
2022,Oaxaca,20,San Juan Cotzocón,20190,12051,12690,24741
2022,Oaxaca,20,San Juan Diuxi,20195,549,561,1110
2022,Oaxaca,20,San Juan Evangelista Analco,20196,215,230,445
2022,Oaxaca,20,San Juan Guelavía,20197,1676,1780,3456
2022,Oaxaca,20,San Juan Guichicovi,20198,14647,16527,31174
2022,Oaxaca,20,San Juan Ihualtepec,20199,296,351,647
2022,Oaxaca,20,San Juan Juquila Mixes,20200,1895,2116,4011
2022,Oaxaca,20,San Juan Juquila Vijanos,20201,974,1064,2038
2022,Oaxaca,20,San Juan Lachao,20202,2423,2592,5015
2022,Oaxaca,20,San Juan Lachigalla,20203,1658,1786,3444
2022,Oaxaca,20,San Juan Lajarcia,20204,309,376,685
2022,Oaxaca,20,San Juan Lalana,20205,8595,9019,17614
2022,Oaxaca,20,San Juan Mazatlán,20207,9631,9770,19401
2022,Oaxaca,20,San Juan Mixtepec Distrito 08,20208,3339,3818,7157
2022,Oaxaca,20,San Juan Mixtepec Distrito 26,20209,282,411,693
2022,Oaxaca,20,San Juan Ozolotepec,20211,1390,1369,2759
2022,Oaxaca,20,San Juan Petlapa,20212,1482,1580,3062
2022,Oaxaca,20,San Juan Quiahije,20213,1928,2193,4121
2022,Oaxaca,20,San Juan Quiotepec,20214,1045,1081,2126
2022,Oaxaca,20,San Juan Sayultepec,20215,392,464,856
2022,Oaxaca,20,San Juan Tabaá,20216,668,734,1402
2022,Oaxaca,20,San Juan Tamazola,20217,1499,1575,3074
2022,Oaxaca,20,San Juan Teita,20218,314,329,643
2022,Oaxaca,20,San Juan Teitipac,20219,1305,1429,2734
2022,Oaxaca,20,San Juan Tepeuxila,20220,1410,1330,2740
2022,Oaxaca,20,San Juan Teposcolula,20221,630,665,1295
2022,Oaxaca,20,San Juan Yaeé,20222,738,832,1570
2022,Oaxaca,20,San Juan Yatzona,20223,210,273,483
2022,Oaxaca,20,San Juan Yucuita,20224,281,334,615
2022,Oaxaca,20,San Juan de los Cués,20206,1242,1269,2511
2022,Oaxaca,20,San Juan del Estado,20193,1354,1461,2815
2022,Oaxaca,20,San Juan del Río,20194,610,727,1337
2022,Oaxaca,20,San Juan Ñumí,20210,2862,3286,6148
2022,Oaxaca,20,San Lorenzo,20225,3082,3321,6403
2022,Oaxaca,20,San Lorenzo Albarradas,20226,1479,1433,2912
2022,Oaxaca,20,San Lorenzo Cacaotepec,20227,8137,8838,16975
2022,Oaxaca,20,San Lorenzo Cuaunecuiltitla,20228,446,403,849
2022,Oaxaca,20,San Lorenzo Texmelúcan,20229,3990,4651,8641
2022,Oaxaca,20,San Lorenzo Victoria,20230,506,523,1029
2022,Oaxaca,20,San Lucas Camotlán,20231,1516,1627,3143
2022,Oaxaca,20,San Lucas Ojitlán,20232,10207,10853,21060
2022,Oaxaca,20,San Lucas Quiaviní,20233,746,1062,1808
2022,Oaxaca,20,San Lucas Zoquiápam,20234,3769,3989,7758
2022,Oaxaca,20,San Luis Amatlán,20235,1753,2064,3817
2022,Oaxaca,20,San Marcial Ozolotepec,20236,742,821,1563
2022,Oaxaca,20,San Marcos Arteaga,20237,629,731,1360
2022,Oaxaca,20,San Martín Huamelúlpam,20239,504,598,1102
2022,Oaxaca,20,San Martín Itunyoso,20240,1008,1280,2288
2022,Oaxaca,20,San Martín Lachilá,20241,500,630,1130
2022,Oaxaca,20,San Martín Peras,20242,6051,6525,12576
2022,Oaxaca,20,San Martín Tilcajete,20243,847,1053,1900
2022,Oaxaca,20,San Martín Toxpalan,20244,1946,2060,4006
2022,Oaxaca,20,San Martín Zacatepec,20245,661,679,1340
2022,Oaxaca,20,San Martín de los Cansecos,20238,443,455,898
2022,Oaxaca,20,San Mateo Cajonos,20246,298,358,656
2022,Oaxaca,20,San Mateo Etlatongo,20250,581,613,1194
2022,Oaxaca,20,San Mateo Nejápam,20251,566,622,1188
2022,Oaxaca,20,San Mateo Peñasco,20252,1044,1200,2244
2022,Oaxaca,20,San Mateo Piñas,20253,957,968,1925
2022,Oaxaca,20,San Mateo Río Hondo,20254,1603,1677,3280
2022,Oaxaca,20,San Mateo Sindihui,20255,1003,1120,2123
2022,Oaxaca,20,San Mateo Tlapiltepec,20256,103,127,230
2022,Oaxaca,20,San Mateo Yoloxochitlán,20249,1803,1993,3796
2022,Oaxaca,20,San Mateo Yucutindoo,20566,1568,1604,3172
2022,Oaxaca,20,San Mateo del Mar,20248,8131,7870,16001
2022,Oaxaca,20,San Melchor Betaza,20257,502,576,1078
2022,Oaxaca,20,San Miguel Achiutla,20258,373,416,789
2022,Oaxaca,20,San Miguel Ahuehuetitlán,20259,1186,1316,2502
2022,Oaxaca,20,San Miguel Aloápam,20260,1062,1211,2273
2022,Oaxaca,20,San Miguel Amatitlán,20261,3735,4183,7918
2022,Oaxaca,20,San Miguel Amatlán,20262,496,526,1022
2022,Oaxaca,20,San Miguel Chicahua,20264,1007,1238,2245
2022,Oaxaca,20,San Miguel Chimalapa,20265,3696,3484,7180
2022,Oaxaca,20,San Miguel Coatlán,20263,1571,1857,3428
2022,Oaxaca,20,San Miguel Ejutla,20268,481,565,1046
2022,Oaxaca,20,San Miguel Huautla,20270,530,619,1149
2022,Oaxaca,20,San Miguel Mixtepec,20271,1650,1697,3347
2022,Oaxaca,20,San Miguel Panixtlahuaca,20272,3021,3708,6729
2022,Oaxaca,20,San Miguel Peras,20273,1676,1811,3487
2022,Oaxaca,20,San Miguel Piedras,20274,653,689,1342
2022,Oaxaca,20,San Miguel Quetzaltepec,20275,4375,4312,8687
2022,Oaxaca,20,San Miguel Santa Flor,20276,367,364,731
2022,Oaxaca,20,San Miguel Soyaltepec,20278,19777,21028,40805
2022,Oaxaca,20,San Miguel Suchixtepec,20279,1346,1496,2842
2022,Oaxaca,20,San Miguel Tecomatlán,20281,171,148,319
2022,Oaxaca,20,San Miguel Tenango,20282,385,370,755
2022,Oaxaca,20,San Miguel Tequixtepec,20283,511,553,1064
2022,Oaxaca,20,San Miguel Tilquiápam,20284,1412,1803,3215
2022,Oaxaca,20,San Miguel Tlacamama,20285,1889,1946,3835
2022,Oaxaca,20,San Miguel Tlacotepec,20286,1513,1738,3251
2022,Oaxaca,20,San Miguel Tulancingo,20287,126,194,320
2022,Oaxaca,20,San Miguel Yotao,20288,296,329,625
2022,Oaxaca,20,San Miguel del Puerto,20266,4277,4372,8649
2022,Oaxaca,20,San Miguel del Río,20267,143,136,279
2022,Oaxaca,20,San Miguel el Grande,20269,2110,2374,4484
2022,Oaxaca,20,San Nicolás,20289,546,663,1209
2022,Oaxaca,20,San Nicolás Hidalgo,20290,488,568,1056
2022,Oaxaca,20,San Pablo Coatlán,20291,2151,2249,4400
2022,Oaxaca,20,San Pablo Cuatro Venados,20292,682,778,1460
2022,Oaxaca,20,San Pablo Etla,20293,9308,10322,19630
2022,Oaxaca,20,San Pablo Huitzo,20294,3569,4010,7579
2022,Oaxaca,20,San Pablo Huixtepec,20295,4723,5185,9908
2022,Oaxaca,20,San Pablo Macuiltianguis,20296,454,481,935
2022,Oaxaca,20,San Pablo Tijaltepec,20297,1124,1359,2483
2022,Oaxaca,20,San Pablo Villa de Mitla,20298,6406,6971,13377
2022,Oaxaca,20,San Pablo Yaganiza,20299,525,592,1117
2022,Oaxaca,20,San Pedro Amuzgos,20300,3311,3795,7106
2022,Oaxaca,20,San Pedro Apóstol,20301,739,868,1607
2022,Oaxaca,20,San Pedro Atoyac,20302,2201,2465,4666
2022,Oaxaca,20,San Pedro Cajonos,20303,522,632,1154
2022,Oaxaca,20,San Pedro Comitancillo,20305,2145,2350,4495
2022,Oaxaca,20,San Pedro Coxcaltepec Cántaros,20304,367,405,772
2022,Oaxaca,20,San Pedro Huamelula,20307,5150,5177,10327
2022,Oaxaca,20,San Pedro Huilotepec,20308,1643,1671,3314
2022,Oaxaca,20,San Pedro Ixcatlán,20309,5803,6077,11880
2022,Oaxaca,20,San Pedro Ixtlahuaca,20310,4663,4941,9604
2022,Oaxaca,20,San Pedro Jaltepetongo,20311,275,310,585
2022,Oaxaca,20,San Pedro Jicayán,20312,6161,6765,12926
2022,Oaxaca,20,San Pedro Jocotipac,20313,365,441,806
2022,Oaxaca,20,San Pedro Juchatengo,20314,797,878,1675
2022,Oaxaca,20,San Pedro Mixtepec Distrito 22,20318,25442,26674,52116
2022,Oaxaca,20,San Pedro Mixtepec Distrito 26,20319,536,582,1118
2022,Oaxaca,20,San Pedro Molinos,20320,334,370,704
2022,Oaxaca,20,San Pedro Mártir,20315,759,964,1723
2022,Oaxaca,20,San Pedro Mártir Quiechapa,20316,341,388,729
2022,Oaxaca,20,San Pedro Mártir Yucuxaco,20317,597,704,1301
2022,Oaxaca,20,San Pedro Nopala,20321,358,392,750
2022,Oaxaca,20,San Pedro Ocopetatillo,20322,393,457,850
2022,Oaxaca,20,San Pedro Ocotepec,20323,1070,1146,2216
2022,Oaxaca,20,San Pedro Pochutla,20324,24544,25388,49932
2022,Oaxaca,20,San Pedro Quiatoni,20325,5573,5889,11462
2022,Oaxaca,20,San Pedro Sochiápam,20326,2606,2671,5277
2022,Oaxaca,20,San Pedro Tapanatepec,20327,7635,7811,15446
2022,Oaxaca,20,San Pedro Taviche,20328,621,640,1261
2022,Oaxaca,20,San Pedro Teozacoalco,20329,618,663,1281
2022,Oaxaca,20,San Pedro Teutila,20330,2183,2257,4440
2022,Oaxaca,20,San Pedro Tidaá,20331,438,510,948
2022,Oaxaca,20,San Pedro Topiltepec,20332,180,199,379
2022,Oaxaca,20,San Pedro Totolápam,20333,1312,1450,2762
2022,Oaxaca,20,San Pedro Yaneri,20335,463,496,959
2022,Oaxaca,20,San Pedro Yucunama,20341,102,136,238
2022,Oaxaca,20,San Pedro Yólox,20336,858,928,1786
2022,Oaxaca,20,San Pedro el Alto,20306,1809,1918,3727
2022,Oaxaca,20,San Pedro y San Pablo Ayutla,20337,2489,2969,5458
2022,Oaxaca,20,San Pedro y San Pablo Teposcolula,20339,2071,2288,4359
2022,Oaxaca,20,San Pedro y San Pablo Tequixtepec,20340,813,993,1806
2022,Oaxaca,20,San Raymundo Jalpan,20342,1744,2089,3833
2022,Oaxaca,20,San Sebastián Abasolo,20343,967,1052,2019
2022,Oaxaca,20,San Sebastián Coatlán,20344,1370,1454,2824
2022,Oaxaca,20,San Sebastián Ixcapa,20345,2116,2171,4287
2022,Oaxaca,20,San Sebastián Nicananduta,20346,654,862,1516
2022,Oaxaca,20,San Sebastián Río Hondo,20347,1892,1927,3819
2022,Oaxaca,20,San Sebastián Tecomaxtlahuaca,20348,4101,4521,8622
2022,Oaxaca,20,San Sebastián Teitipac,20349,935,1113,2048
2022,Oaxaca,20,San Sebastián Tutla,20350,8920,10297,19217
2022,Oaxaca,20,San Simón Almolongas,20351,1360,1567,2927
2022,Oaxaca,20,San Simón Zahuatlán,20352,2186,2241,4427
2022,Oaxaca,20,San Vicente Coatlán,20534,1853,2223,4076
2022,Oaxaca,20,San Vicente Lachixío,20535,1351,1544,2895
2022,Oaxaca,20,San Vicente Nuñú,20536,206,240,446
2022,Oaxaca,20,Santa Ana,20353,1105,1195,2300
2022,Oaxaca,20,Santa Ana Ateixtlahuaca,20354,269,263,532
2022,Oaxaca,20,Santa Ana Cuauhtémoc,20355,357,385,742
2022,Oaxaca,20,Santa Ana Tavela,20357,406,435,841
2022,Oaxaca,20,Santa Ana Tlapacoyan,20358,1019,1100,2119
2022,Oaxaca,20,Santa Ana Yareni,20359,430,498,928
2022,Oaxaca,20,Santa Ana Zegache,20360,1865,2104,3969
2022,Oaxaca,20,Santa Ana del Valle,20356,1056,1116,2172
2022,Oaxaca,20,Santa Catalina Quierí,20361,423,527,950
2022,Oaxaca,20,Santa Catarina Cuixtla,20362,682,854,1536
2022,Oaxaca,20,Santa Catarina Ixtepeji,20363,1313,1423,2736
2022,Oaxaca,20,Santa Catarina Juquila,20364,7968,8453,16421
2022,Oaxaca,20,Santa Catarina Lachatao,20365,546,594,1140
2022,Oaxaca,20,Santa Catarina Loxicha,20366,1953,2014,3967
2022,Oaxaca,20,Santa Catarina Mechoacán,20367,2321,2369,4690
2022,Oaxaca,20,Santa Catarina Minas,20368,1006,1040,2046
2022,Oaxaca,20,Santa Catarina Quiané,20369,992,1048,2040
2022,Oaxaca,20,Santa Catarina Quioquitani,20074,270,298,568
2022,Oaxaca,20,Santa Catarina Tayata,20370,315,373,688
2022,Oaxaca,20,Santa Catarina Ticuá,20371,498,618,1116
2022,Oaxaca,20,Santa Catarina Yosonotú,20372,790,960,1750
2022,Oaxaca,20,Santa Catarina Zapoquila,20373,176,207,383
2022,Oaxaca,20,Santa Cruz Acatepec,20374,790,860,1650
2022,Oaxaca,20,Santa Cruz Amilpas,20375,6504,7505,14009
2022,Oaxaca,20,Santa Cruz Itundujia,20377,5795,6283,12078
2022,Oaxaca,20,Santa Cruz Mixtepec,20378,1762,1939,3701
2022,Oaxaca,20,Santa Cruz Nundaco,20379,1421,1671,3092
2022,Oaxaca,20,Santa Cruz Papalutla,20380,1100,1163,2263
2022,Oaxaca,20,Santa Cruz Tacache de Mina,20381,1344,1480,2824
2022,Oaxaca,20,Santa Cruz Tacahua,20382,543,612,1155
2022,Oaxaca,20,Santa Cruz Tayata,20383,311,320,631
2022,Oaxaca,20,Santa Cruz Xitla,20384,2386,2652,5038
2022,Oaxaca,20,Santa Cruz Xoxocotlán,20385,47638,53447,101085
2022,Oaxaca,20,Santa Cruz Zenzontepec,20386,9329,9791,19120
2022,Oaxaca,20,Santa Cruz de Bravo,20376,185,196,381
2022,Oaxaca,20,Santa Gertrudis,20387,1434,1533,2967
2022,Oaxaca,20,Santa Inés Yatzeche,20389,406,544,950
2022,Oaxaca,20,Santa Inés de Zaragoza,20569,787,897,1684
2022,Oaxaca,20,Santa Inés del Monte,20388,1221,1274,2495
2022,Oaxaca,20,Santa Lucía Miahuatlán,20391,1742,1836,3578
2022,Oaxaca,20,Santa Lucía Monteverde,20392,3212,3511,6723
2022,Oaxaca,20,Santa Lucía Ocotlán,20393,1835,2179,4014
2022,Oaxaca,20,Santa Lucía del Camino,20390,25093,27260,52353
2022,Oaxaca,20,Santa Magdalena Jicotlán,20047,45,54,99
2022,Oaxaca,20,Santa María Alotepec,20394,1447,1479,2926
2022,Oaxaca,20,Santa María Apazco,20395,798,1010,1808
2022,Oaxaca,20,Santa María Atzompa,20399,18391,19757,38148
2022,Oaxaca,20,Santa María Camotlán,20400,796,920,1716
2022,Oaxaca,20,Santa María Chachoápam,20404,362,410,772
2022,Oaxaca,20,Santa María Chilchotla,20406,10325,10732,21057
2022,Oaxaca,20,Santa María Chimalapa,20407,4792,4643,9435
2022,Oaxaca,20,Santa María Colotepec,20401,12652,12839,25491
2022,Oaxaca,20,Santa María Cortijo,20402,535,573,1108
2022,Oaxaca,20,Santa María Coyotepec,20403,1572,1743,3315
2022,Oaxaca,20,Santa María Ecatepec,20410,1742,1781,3523
2022,Oaxaca,20,Santa María Guelacé,20411,385,476,861
2022,Oaxaca,20,Santa María Guienagati,20412,1638,1642,3280
2022,Oaxaca,20,Santa María Huatulco,20413,23253,24190,47443
2022,Oaxaca,20,Santa María Huazolotitlán,20414,5895,6082,11977
2022,Oaxaca,20,Santa María Ipalapa,20415,2466,2740,5206
2022,Oaxaca,20,Santa María Ixcatlán,20416,242,269,511
2022,Oaxaca,20,Santa María Jacatepec,20417,4553,5094,9647
2022,Oaxaca,20,Santa María Jalapa del Marqués,20418,6720,7102,13822
2022,Oaxaca,20,Santa María Jaltianguis,20419,246,295,541
2022,Oaxaca,20,Santa María Lachixío,20420,949,1105,2054
2022,Oaxaca,20,Santa María Mixtequilla,20421,2373,2513,4886
2022,Oaxaca,20,Santa María Nativitas,20422,282,339,621
2022,Oaxaca,20,Santa María Nduayaco,20423,255,256,511
2022,Oaxaca,20,Santa María Ozolotepec,20424,1917,2043,3960
2022,Oaxaca,20,Santa María Petapa,20427,8353,8948,17301
2022,Oaxaca,20,Santa María Peñoles,20426,4322,4544,8866
2022,Oaxaca,20,Santa María Pápalo,20425,1106,1100,2206
2022,Oaxaca,20,Santa María Quiegolani,20428,1024,1007,2031
2022,Oaxaca,20,Santa María Sola,20429,731,799,1530
2022,Oaxaca,20,Santa María Tataltepec,20430,194,206,400
2022,Oaxaca,20,Santa María Tecomavaca,20431,842,903,1745
2022,Oaxaca,20,Santa María Temaxcalapa,20432,470,493,963
2022,Oaxaca,20,Santa María Temaxcaltepec,20433,1260,1427,2687
2022,Oaxaca,20,Santa María Teopoxco,20434,2058,2342,4400
2022,Oaxaca,20,Santa María Tepantlali,20435,1949,2020,3969
2022,Oaxaca,20,Santa María Texcatitlán,20436,491,539,1030
2022,Oaxaca,20,Santa María Tlahuitoltepec,20437,4675,4990,9665
2022,Oaxaca,20,Santa María Tlalixtac,20438,856,915,1771
2022,Oaxaca,20,Santa María Tonameca,20439,13211,13447,26658
2022,Oaxaca,20,Santa María Totolapilla,20440,406,448,854
2022,Oaxaca,20,Santa María Xadani,20441,4672,4587,9259
2022,Oaxaca,20,Santa María Yalina,20442,130,156,286
2022,Oaxaca,20,Santa María Yavesía,20443,235,291,526
2022,Oaxaca,20,Santa María Yolotepec,20444,204,222,426
2022,Oaxaca,20,Santa María Yosoyúa,20445,869,849,1718
2022,Oaxaca,20,Santa María Yucuhiti,20446,3109,3395,6504
2022,Oaxaca,20,Santa María Zacatepec,20447,7864,8855,16719
2022,Oaxaca,20,Santa María Zaniza,20448,1118,1186,2304
2022,Oaxaca,20,Santa María Zoquitlán,20449,1553,1590,3143
2022,Oaxaca,20,Santa María del Rosario,20408,271,252,523
2022,Oaxaca,20,Santa María del Tule,20409,4437,5081,9518
2022,Oaxaca,20,Santa María la Asunción,20396,1504,1905,3409
2022,Oaxaca,20,Santiago Amoltepec,20450,6391,6810,13201
2022,Oaxaca,20,Santiago Apoala,20451,430,507,937
2022,Oaxaca,20,Santiago Apóstol,20452,1837,2285,4122
2022,Oaxaca,20,Santiago Astata,20453,2073,2094,4167
2022,Oaxaca,20,Santiago Atitlán,20454,1590,1537,3127
2022,Oaxaca,20,Santiago Ayuquililla,20455,1350,1481,2831
2022,Oaxaca,20,Santiago Cacaloxtepec,20456,807,881,1688
2022,Oaxaca,20,Santiago Camotlán,20457,1640,1654,3294
2022,Oaxaca,20,Santiago Chazumba,20459,2082,2603,4685
2022,Oaxaca,20,Santiago Choápam,20460,2592,2767,5359
2022,Oaxaca,20,Santiago Comaltepec,20458,467,513,980
2022,Oaxaca,20,Santiago Huajolotitlán,20462,1989,2368,4357
2022,Oaxaca,20,Santiago Huauclilla,20463,257,284,541
2022,Oaxaca,20,Santiago Ihuitlán Plumas,20464,163,202,365
2022,Oaxaca,20,Santiago Ixcuintepec,20465,837,860,1697
2022,Oaxaca,20,Santiago Ixtayutla,20466,6526,6895,13421
2022,Oaxaca,20,Santiago Jamiltepec,20467,9549,10350,19899
2022,Oaxaca,20,Santiago Jocotepec,20468,7192,7383,14575
2022,Oaxaca,20,Santiago Juxtlahuaca,20469,17925,19829,37754
2022,Oaxaca,20,Santiago Lachiguiri,20470,2403,2454,4857
2022,Oaxaca,20,Santiago Lalopa,20471,255,268,523
2022,Oaxaca,20,Santiago Laollaga,20472,1788,1803,3591
2022,Oaxaca,20,Santiago Laxopa,20473,649,723,1372
2022,Oaxaca,20,Santiago Llano Grande,20474,1705,1724,3429
2022,Oaxaca,20,Santiago Matatlán,20475,4851,5494,10345
2022,Oaxaca,20,Santiago Miltepec,20476,216,219,435
2022,Oaxaca,20,Santiago Minas,20477,704,724,1428
2022,Oaxaca,20,Santiago Nacaltepec,20478,861,964,1825
2022,Oaxaca,20,Santiago Nejapilla,20479,114,100,214
2022,Oaxaca,20,Santiago Niltepec,20066,2793,2837,5630
2022,Oaxaca,20,Santiago Nundiche,20480,453,500,953
2022,Oaxaca,20,Santiago Nuyoó,20481,842,936,1778
2022,Oaxaca,20,Santiago Pinotepa Nacional,20482,27293,28589,55882
2022,Oaxaca,20,Santiago Suchilquitongo,20483,5352,5763,11115
2022,Oaxaca,20,Santiago Tamazola,20484,2176,2490,4666
2022,Oaxaca,20,Santiago Tapextla,20485,1627,1577,3204
2022,Oaxaca,20,Santiago Tenango,20487,1074,1070,2144
2022,Oaxaca,20,Santiago Tepetlapa,20488,58,69,127
2022,Oaxaca,20,Santiago Tetepec,20489,2527,2575,5102
2022,Oaxaca,20,Santiago Texcalcingo,20490,1564,1678,3242
2022,Oaxaca,20,Santiago Textitlán,20491,2298,2306,4604
2022,Oaxaca,20,Santiago Tilantongo,20492,1382,1625,3007
2022,Oaxaca,20,Santiago Tillo,20493,267,304,571
2022,Oaxaca,20,Santiago Tlazoyaltepec,20494,2257,2690,4947
2022,Oaxaca,20,Santiago Xanica,20495,1570,1559,3129
2022,Oaxaca,20,Santiago Xiacuí,20496,1041,1143,2184
2022,Oaxaca,20,Santiago Yaitepec,20497,2068,2443,4511
2022,Oaxaca,20,Santiago Yaveo,20498,3617,3595,7212
2022,Oaxaca,20,Santiago Yolomécatl,20499,1029,1209,2238
2022,Oaxaca,20,Santiago Yosondúa,20500,4153,4662,8815
2022,Oaxaca,20,Santiago Yucuyachi,20501,461,499,960
2022,Oaxaca,20,Santiago Zacatepec,20502,2717,2800,5517
2022,Oaxaca,20,Santiago Zoochila,20503,189,213,402
2022,Oaxaca,20,Santiago del Río,20461,273,298,571
2022,Oaxaca,20,Santo Domingo Albarradas,20506,372,433,805
2022,Oaxaca,20,Santo Domingo Armenta,20507,1775,1789,3564
2022,Oaxaca,20,Santo Domingo Chihuitán,20508,784,808,1592
2022,Oaxaca,20,Santo Domingo Ingenio,20505,4202,4204,8406
2022,Oaxaca,20,Santo Domingo Ixcatlán,20510,295,352,647
2022,Oaxaca,20,Santo Domingo Nuxaá,20511,1613,1724,3337
2022,Oaxaca,20,Santo Domingo Ozolotepec,20512,397,437,834
2022,Oaxaca,20,Santo Domingo Petapa,20513,4863,4790,9653
2022,Oaxaca,20,Santo Domingo Roayaga,20514,510,559,1069
2022,Oaxaca,20,Santo Domingo Tehuantepec,20515,33520,35316,68836
2022,Oaxaca,20,Santo Domingo Teojomulco,20516,2557,2692,5249
2022,Oaxaca,20,Santo Domingo Tepuxtepec,20517,2809,3190,5999
2022,Oaxaca,20,Santo Domingo Tlatayápam,20518,65,77,142
2022,Oaxaca,20,Santo Domingo Tomaltepec,20519,1535,1583,3118
2022,Oaxaca,20,Santo Domingo Tonaltepec,20521,110,138,248
2022,Oaxaca,20,Santo Domingo Tonalá,20520,3441,3809,7250
2022,Oaxaca,20,Santo Domingo Xagacía,20522,569,652,1221
2022,Oaxaca,20,Santo Domingo Yanhuitlán,20523,771,863,1634
2022,Oaxaca,20,Santo Domingo Yodohino,20524,149,160,309
2022,Oaxaca,20,Santo Domingo Zanatepec,20525,6366,6439,12805
2022,Oaxaca,20,Santo Domingo de Morelos,20509,5487,6136,11623
2022,Oaxaca,20,Santo Tomás Jalieza,20530,1792,1975,3767
2022,Oaxaca,20,Santo Tomás Mazaltepec,20531,1338,1468,2806
2022,Oaxaca,20,Santo Tomás Ocotepec,20532,1838,2109,3947
2022,Oaxaca,20,Santo Tomás Tamazulapan,20533,1145,1218,2363
2022,Oaxaca,20,Santos Reyes Nopala,20526,8965,9552,18517
2022,Oaxaca,20,Santos Reyes Pápalo,20527,1320,1430,2750
2022,Oaxaca,20,Santos Reyes Tepejillo,20528,428,586,1014
2022,Oaxaca,20,Santos Reyes Yucuná,20529,664,675,1339
2022,Oaxaca,20,Silacayoápam,20537,3279,3710,6989
2022,Oaxaca,20,Sitio de Xitlapehua,20538,340,381,721
2022,Oaxaca,20,Soledad Etla,20539,2954,3098,6052
2022,Oaxaca,20,Tamazulápam del Espíritu Santo,20031,3514,4244,7758
2022,Oaxaca,20,Tanetze de Zaragoza,20541,822,891,1713
2022,Oaxaca,20,Taniche,20542,383,465,848
2022,Oaxaca,20,Tataltepec de Valdés,20543,2950,3089,6039
2022,Oaxaca,20,Teococuilco de Marcos Pérez,20544,434,525,959
2022,Oaxaca,20,Teotitlán de Flores Magón,20545,4968,5513,10481
2022,Oaxaca,20,Teotitlán del Valle,20546,2903,3225,6128
2022,Oaxaca,20,Teotongo,20547,458,545,1003
2022,Oaxaca,20,Tepelmeme Villa de Morelos,20548,781,938,1719
2022,Oaxaca,20,Tlacolula de Matamoros,20551,11595,13024,24619
2022,Oaxaca,20,Tlacotepec Plumas,20552,225,246,471
2022,Oaxaca,20,Tlalixtac de Cabrera,20553,5269,5828,11097
2022,Oaxaca,20,Totontepec Villa de Morelos,20554,2695,2918,5613
2022,Oaxaca,20,Trinidad Zaachila,20555,1480,1646,3126
2022,Oaxaca,20,Unión Hidalgo,20557,7937,8395,16332
2022,Oaxaca,20,Valerio Trujano,20558,662,812,1474
2022,Oaxaca,20,Villa Díaz Ordaz,20560,3244,3856,7100
2022,Oaxaca,20,Villa Hidalgo,20038,964,1063,2027
2022,Oaxaca,20,Villa Sola de Vega,20277,6305,6435,12740
2022,Oaxaca,20,Villa Talea de Castro,20280,1137,1247,2384
2022,Oaxaca,20,Villa Tejúpam de la Unión,20486,1250,1338,2588
2022,Oaxaca,20,Villa Tezoatlán de Segura y Luna,20549,5269,6186,11455
2022,Oaxaca,20,Villa de Chilapa de Díaz,20405,997,1267,2264
2022,Oaxaca,20,Villa de Etla,20338,5559,6102,11661
2022,Oaxaca,20,Villa de Tamazulápam del Progreso,20540,3844,4288,8132
2022,Oaxaca,20,Villa de Tututepec de Melchor Ocampo,20334,23303,24298,47601
2022,Oaxaca,20,Villa de Zaachila,20565,23010,25098,48108
2022,Oaxaca,20,Yaxe,20561,1429,1545,2974
2022,Oaxaca,20,Yogana,20563,595,705,1300
2022,Oaxaca,20,Yutanduchi de Guerrero,20564,571,636,1207
2022,Oaxaca,20,Zapotitlán Lagunas,20567,1552,1738,3290
2022,Oaxaca,20,Zapotitlán Palmas,20568,671,833,1504
2022,Oaxaca,20,Zimatlán de Álvarez,20570,9879,11221,21100
2022,Oaxaca,20,Ánimas Trujano,20174,2031,2248,4279
2022,Puebla,21,Acajete,21001,34124,36288,70412
2022,Puebla,21,Acateno,21002,4961,4909,9870
2022,Puebla,21,Acatlán,21003,17716,20564,38280
2022,Puebla,21,Acatzingo,21004,31321,32485,63806
2022,Puebla,21,Acteopan,21005,1489,1679,3168
2022,Puebla,21,Ahuacatlán,21006,8114,8963,17077
2022,Puebla,21,Ahuatlán,21007,1661,1791,3452
2022,Puebla,21,Ahuazotepec,21008,6074,6251,12325
2022,Puebla,21,Ahuehuetitla,21009,885,1014,1899
2022,Puebla,21,Ajalpan,21010,34734,36618,71352
2022,Puebla,21,Albino Zertuche,21011,893,1044,1937
2022,Puebla,21,Aljojuca,21012,3353,3689,7042
2022,Puebla,21,Altepexi,21013,11256,11800,23056
2022,Puebla,21,Amixtlán,21014,2524,2789,5313
2022,Puebla,21,Amozoc,21015,63377,65981,129358
2022,Puebla,21,Aquixtla,21016,4689,4702,9391
2022,Puebla,21,Atempan,21017,14468,16145,30613
2022,Puebla,21,Atexcal,21018,1958,2109,4067
2022,Puebla,21,Atlequizayan,21080,1331,1497,2828
2022,Puebla,21,Atlixco,21019,69254,77237,146491
2022,Puebla,21,Atoyatempan,21020,3654,3879,7533
2022,Puebla,21,Atzala,21021,670,742,1412
2022,Puebla,21,Atzitzihuacán,21022,6137,7038,13175
2022,Puebla,21,Atzitzintla,21023,4887,5002,9889
2022,Puebla,21,Axutla,21024,464,538,1002
2022,Puebla,21,Ayotoxco de Guerrero,21025,4541,4697,9238
2022,Puebla,21,Calpan,21026,7414,8188,15602
2022,Puebla,21,Caltepec,21027,1946,2228,4174
2022,Puebla,21,Camocuautla,21028,1408,1435,2843
2022,Puebla,21,Caxhuacan,21029,1891,2079,3970
2022,Puebla,21,Cañada Morelos,21099,10025,10679,20704
2022,Puebla,21,Chalchicomula de Sesma,21045,24553,26624,51177
2022,Puebla,21,Chapulco,21046,4068,4354,8422
2022,Puebla,21,Chiautla,21047,10401,11049,21450
2022,Puebla,21,Chiautzingo,21048,10432,11461,21893
2022,Puebla,21,Chichiquila,21050,13490,14321,27811
2022,Puebla,21,Chiconcuautla,21049,8797,9157,17954
2022,Puebla,21,Chietla,21051,17885,19160,37045
2022,Puebla,21,Chigmecatitlán,21052,586,690,1276
2022,Puebla,21,Chignahuapan,21053,33264,34418,67682
2022,Puebla,21,Chignautla,21054,17953,19029,36982
2022,Puebla,21,Chila,21055,2316,2609,4925
2022,Puebla,21,Chila de la Sal,21056,746,795,1541
2022,Puebla,21,Chilchotla,21058,10628,10617,21245
2022,Puebla,21,Chinantla,21059,1143,1283,2426
2022,Puebla,21,Coatepec,21030,383,427,810
2022,Puebla,21,Coatzingo,21031,1495,1653,3148
2022,Puebla,21,Cohetzala,21032,725,714,1439
2022,Puebla,21,Cohuecan,21033,2509,2736,5245
2022,Puebla,21,Coronango,21034,21716,22506,44222
2022,Puebla,21,Coxcatlán,21035,10528,11596,22124
2022,Puebla,21,Coyomeapan,21036,7160,7836,14996
2022,Puebla,21,Coyotepec,21037,1148,1346,2494
2022,Puebla,21,Cuapiaxtla de Madero,21038,5455,5496,10951
2022,Puebla,21,Cuautempan,21039,4834,5187,10021
2022,Puebla,21,Cuautinchán,21040,5548,5595,11143
2022,Puebla,21,Cuautlancingo,21041,64108,67612,131720
2022,Puebla,21,Cuayuca de Andrade,21042,1616,1727,3343
2022,Puebla,21,Cuetzalan del Progreso,21043,25278,26545,51823
2022,Puebla,21,Cuyoaco,21044,8118,8803,16921
2022,Puebla,21,Domingo Arenas,21060,3846,4272,8118
2022,Puebla,21,Eloxochitlán,21061,6635,7013,13648
2022,Puebla,21,Epatlán,21062,2527,2657,5184
2022,Puebla,21,Esperanza,21063,7770,8287,16057
2022,Puebla,21,Francisco Z. Mena,21064,9243,9080,18323
2022,Puebla,21,General Felipe Ángeles,21065,10726,11591,22317
2022,Puebla,21,Guadalupe,21066,2859,3301,6160
2022,Puebla,21,Guadalupe Victoria,21067,8931,9406,18337
2022,Puebla,21,Hermenegildo Galeana,21068,4097,4163,8260
2022,Puebla,21,Honey,21057,4082,4446,8528
2022,Puebla,21,Huaquechula,21069,12449,14113,26562
2022,Puebla,21,Huatlatlauca,21070,3176,3792,6968
2022,Puebla,21,Huauchinango,21071,53899,59554,113453
2022,Puebla,21,Huehuetla,21072,9925,10197,20122
2022,Puebla,21,Huehuetlán el Chico,21073,4432,4659,9091
2022,Puebla,21,Huehuetlán el Grande,21150,3779,4011,7790
2022,Puebla,21,Huejotzingo,21074,39193,41027,80220
2022,Puebla,21,Hueyapan,21075,6662,7083,13745
2022,Puebla,21,Hueytamalco,21076,13853,14210,28063
2022,Puebla,21,Hueytlalpan,21077,2860,3006,5866
2022,Puebla,21,Huitzilan de Serdán,21078,8200,8009,16209
2022,Puebla,21,Huitziltepec,21079,2841,3063,5904
2022,Puebla,21,Ixcamilpa de Guerrero,21081,1819,2021,3840
2022,Puebla,21,Ixcaquixtla,21082,4589,5028,9617
2022,Puebla,21,Ixtacamaxtitlán,21083,12831,13167,25998
2022,Puebla,21,Ixtepec,21084,3687,3904,7591
2022,Puebla,21,Izúcar de Matamoros,21085,39738,44155,83893
2022,Puebla,21,Jalpan,21086,6219,6717,12936
2022,Puebla,21,Jolalpan,21087,6733,7274,14007
2022,Puebla,21,Jonotla,21088,2394,2491,4885
2022,Puebla,21,Jopala,21089,6827,7140,13967
2022,Puebla,21,Juan C. Bonilla,21090,11082,12076,23158
2022,Puebla,21,Juan Galindo,21091,5419,6174,11593
2022,Puebla,21,Juan N. Méndez,21092,2801,2858,5659
2022,Puebla,21,La Magdalena Tlatlauquitepec,21095,305,301,606
2022,Puebla,21,Lafragua,21093,4147,4266,8413
2022,Puebla,21,Libres,21094,17867,18809,36676
2022,Puebla,21,Los Reyes de Juárez,21118,14578,15035,29613
2022,Puebla,21,Mazapiltepec de Juárez,21096,1521,1544,3065
2022,Puebla,21,Mixtla,21097,1202,1337,2539
2022,Puebla,21,Molcaxac,21098,3111,3505,6616
2022,Puebla,21,Naupan,21100,5077,5542,10619
2022,Puebla,21,Nauzontla,21101,1744,1956,3700
2022,Puebla,21,Nealtican,21102,6424,6975,13399
2022,Puebla,21,Nicolás Bravo,21103,3284,3493,6777
2022,Puebla,21,Nopalucan,21104,16674,17086,33760
2022,Puebla,21,Ocotepec,21105,2465,2670,5135
2022,Puebla,21,Ocoyucan,21106,14351,16188,30539
2022,Puebla,21,Olintla,21107,6099,6400,12499
2022,Puebla,21,Oriental,21108,9614,10157,19771
2022,Puebla,21,Pahuatlán,21109,11290,12491,23781
2022,Puebla,21,Palmar de Bravo,21110,24630,25115,49745
2022,Puebla,21,Pantepec,21111,9592,10175,19767
2022,Puebla,21,Petlalcingo,21112,4867,5552,10419
2022,Puebla,21,Piaxtla,21113,2264,2447,4711
2022,Puebla,21,Puebla,21114,827023,897808,1724831
2022,Puebla,21,Quecholac,21115,26985,27949,54934
2022,Puebla,21,Quimixtlán,21116,11682,11980,23662
2022,Puebla,21,Rafael Lara Grajales,21117,7166,7693,14859
2022,Puebla,21,San Andrés Cholula,21119,79198,80871,160069
2022,Puebla,21,San Antonio Cañada,21120,2814,3150,5964
2022,Puebla,21,San Diego la Mesa Tochimiltzingo,21121,635,647,1282
2022,Puebla,21,San Felipe Teotlalcingo,21122,5453,5810,11263
2022,Puebla,21,San Felipe Tepatlán,21123,2051,2128,4179
2022,Puebla,21,San Gabriel Chilac,21124,8068,8927,16995
2022,Puebla,21,San Gregorio Atzompa,21125,4781,5060,9841
2022,Puebla,21,San Jerónimo Tecuanipan,21126,3218,3543,6761
2022,Puebla,21,San Jerónimo Xayacatlán,21127,1718,1972,3690
2022,Puebla,21,San José Chiapa,21128,4693,4795,9488
2022,Puebla,21,San José Miahuatlán,21129,6883,7501,14384
2022,Puebla,21,San Juan Atenco,21130,1659,1922,3581
2022,Puebla,21,San Juan Atzompa,21131,488,463,951
2022,Puebla,21,San Martín Texmelucan,21132,79898,85447,165345
2022,Puebla,21,San Martín Totoltepec,21133,320,346,666
2022,Puebla,21,San Matías Tlalancaleca,21134,10842,11212,22054
2022,Puebla,21,San Miguel Ixitlán,21135,254,285,539
2022,Puebla,21,San Miguel Xoxtla,21136,6601,6958,13559
2022,Puebla,21,San Nicolás Buenos Aires,21137,5225,5456,10681
2022,Puebla,21,San Nicolás de los Ranchos,21138,6222,6489,12711
2022,Puebla,21,San Pablo Anicano,21139,1832,1998,3830
2022,Puebla,21,San Pedro Cholula,21140,68348,73961,142309
2022,Puebla,21,San Pedro Yeloixtlahuaca,21141,1712,1850,3562
2022,Puebla,21,San Salvador Huixcolotla,21144,8012,8138,16150
2022,Puebla,21,San Salvador el Seco,21142,16038,16852,32890
2022,Puebla,21,San Salvador el Verde,21143,16824,17389,34213
2022,Puebla,21,San Sebastián Tlacotepec,21145,7403,7492,14895
2022,Puebla,21,Santa Catarina Tlaltempan,21146,433,431,864
2022,Puebla,21,Santa Inés Ahuatempan,21147,3268,3573,6841
2022,Puebla,21,Santa Isabel Cholula,21148,4557,4940,9497
2022,Puebla,21,Santiago Miahuatlán,21149,13591,14288,27879
2022,Puebla,21,Santo Tomás Hueyotlipan,21151,4460,4797,9257
2022,Puebla,21,Soltepec,21152,6497,6814,13311
2022,Puebla,21,Tecali de Herrera,21153,11699,12300,23999
2022,Puebla,21,Tecamachalco,21154,40465,42858,83323
2022,Puebla,21,Tecomatlán,21155,2992,3116,6108
2022,Puebla,21,Tehuacán,21156,163989,182116,346105
2022,Puebla,21,Tehuitzingo,21157,5710,6349,12059
2022,Puebla,21,Tenampulco,21158,3770,3914,7684
2022,Puebla,21,Teopantlán,21159,1768,2203,3971
2022,Puebla,21,Teotlalco,21160,1651,1732,3383
2022,Puebla,21,Tepanco de López,21161,10553,11664,22217
2022,Puebla,21,Tepango de Rodríguez,21162,2076,2317,4393
2022,Puebla,21,Tepatlaxco de Hidalgo,21163,9159,9629,18788
2022,Puebla,21,Tepeaca,21164,41805,45316,87121
2022,Puebla,21,Tepemaxalco,21165,561,597,1158
2022,Puebla,21,Tepeojuma,21166,4253,4937,9190
2022,Puebla,21,Tepetzintla,21167,5940,6353,12293
2022,Puebla,21,Tepexco,21168,3549,3732,7281
2022,Puebla,21,Tepexi de Rodríguez,21169,11430,11376,22806
2022,Puebla,21,Tepeyahualco,21170,9060,9214,18274
2022,Puebla,21,Tepeyahualco de Cuauhtémoc,21171,1846,2019,3865
2022,Puebla,21,Tetela de Ocampo,21172,14661,15719,30380
2022,Puebla,21,Teteles de Ávila Castillo,21173,2918,3426,6344
2022,Puebla,21,Teziutlán,21174,50467,56104,106571
2022,Puebla,21,Tianguismanalco,21175,6620,7129,13749
2022,Puebla,21,Tilapa,21176,4446,4767,9213
2022,Puebla,21,Tlachichuca,21179,15431,16030,31461
2022,Puebla,21,Tlacotepec de Benito Juárez,21177,26853,29207,56060
2022,Puebla,21,Tlacuilotepec,21178,8783,9088,17871
2022,Puebla,21,Tlahuapan,21180,21469,21717,43186
2022,Puebla,21,Tlaltenango,21181,3792,3853,7645
2022,Puebla,21,Tlanepantla,21182,2580,2779,5359
2022,Puebla,21,Tlaola,21183,10481,11103,21584
2022,Puebla,21,Tlapacoya,21184,3397,3550,6947
2022,Puebla,21,Tlapanalá,21185,4323,4744,9067
2022,Puebla,21,Tlatlauquitepec,21186,27749,30486,58235
2022,Puebla,21,Tlaxco,21187,2852,2883,5735
2022,Puebla,21,Tochimilco,21188,9174,10205,19379
2022,Puebla,21,Tochtepec,21189,10984,11834,22818
2022,Puebla,21,Totoltepec de Guerrero,21190,594,721,1315
2022,Puebla,21,Tulcingo,21191,4709,5377,10086
2022,Puebla,21,Tuzamapan de Galeana,21192,3370,3528,6898
2022,Puebla,21,Tzicatlacoyan,21193,3755,3831,7586
2022,Puebla,21,Venustiano Carranza,21194,15322,16430,31752
2022,Puebla,21,Vicente Guerrero,21195,12602,13666,26268
2022,Puebla,21,Xayacatlán de Bravo,21196,775,924,1699
2022,Puebla,21,Xicotepec,21197,42197,45269,87466
2022,Puebla,21,Xicotlán,21198,615,677,1292
2022,Puebla,21,Xiutetelco,21199,20901,22451,43352
2022,Puebla,21,Xochiapulco,21200,1724,1903,3627
2022,Puebla,21,Xochiltepec,21201,1614,1938,3552
2022,Puebla,21,Xochitlán Todos Santos,21203,3302,3654,6956
2022,Puebla,21,Xochitlán de Vicente Suárez,21202,6560,7025,13585
2022,Puebla,21,Yaonáhuac,21204,4108,4505,8613
2022,Puebla,21,Yehualtepec,21205,13104,13793,26897
2022,Puebla,21,Zacapala,21206,2246,2514,4760
2022,Puebla,21,Zacapoaxtla,21207,28413,31234,59647
2022,Puebla,21,Zacatlán,21208,42511,46872,89383
2022,Puebla,21,Zapotitlán,21209,4161,4964,9125
2022,Puebla,21,Zapotitlán de Méndez,21210,2990,3036,6026
2022,Puebla,21,Zaragoza,21211,8092,9463,17555
2022,Puebla,21,Zautla,21212,9587,10855,20442
2022,Puebla,21,Zihuateutla,21213,6940,7335,14275
2022,Puebla,21,Zinacatepec,21214,8805,9628,18433
2022,Puebla,21,Zongozotla,21215,2635,2694,5329
2022,Puebla,21,Zoquiapan,21216,1212,1381,2593
2022,Puebla,21,Zoquitlán,21217,9606,10177,19783
2022,Querétaro,22,Amealco de Bonfil,22001,34066,36073,70139
2022,Querétaro,22,Arroyo Seco,22003,7349,7920,15269
2022,Querétaro,22,Cadereyta de Montes,22004,38022,41265,79287
2022,Querétaro,22,Colón,22005,35924,35177,71101
2022,Querétaro,22,Corregidora,22006,106167,112413,218580
2022,Querétaro,22,El Marqués,22011,94518,92890,187408
2022,Querétaro,22,Ezequiel Montes,22007,22928,24399,47327
2022,Querétaro,22,Huimilpan,22008,20899,22632,43531
2022,Querétaro,22,Jalpan de Serra,22009,14579,15966,30545
2022,Querétaro,22,Landa de Matamoros,22010,9919,10814,20733
2022,Querétaro,22,Pedro Escobedo,22012,39126,39655,78781
2022,Querétaro,22,Peñamiller,22013,11204,11498,22702
2022,Querétaro,22,Pinal de Amoles,22002,13929,14833,28762
2022,Querétaro,22,Querétaro,22014,500609,507314,1007923
2022,Querétaro,22,San Joaquín,22015,4971,5658,10629
2022,Querétaro,22,San Juan del Río,22016,153252,158849,312101
2022,Querétaro,22,Tequisquiapan,22017,40008,41500,81508
2022,Querétaro,22,Tolimán,22018,15913,16519,32432
2022,Quintana Roo,23,Bacalar,23010,23778,23597,47375
2022,Quintana Roo,23,Benito Juárez,23005,443116,437804,880920
2022,Quintana Roo,23,Cozumel,23001,52979,52964,105943
2022,Quintana Roo,23,Felipe Carrillo Puerto,23002,48946,48513,97459
2022,Quintana Roo,23,Isla Mujeres,23003,12776,11777,24553
2022,Quintana Roo,23,José María Morelos,23006,22930,21691,44621
2022,Quintana Roo,23,Lázaro Cárdenas,23007,16802,16058,32860
2022,Quintana Roo,23,Othón P. Blanco,23004,135036,140481,275517
2022,Quintana Roo,23,Solidaridad,23008,131464,119725,251189
2022,Quintana Roo,23,Tulum,23009,20252,18224,38476
2022,San Luis Potosí,24,Ahualulco,24001,9013,10128,19141
2022,San Luis Potosí,24,Alaquines,24002,4329,4466,8795
2022,San Luis Potosí,24,Aquismón,24003,25919,25395,51314
2022,San Luis Potosí,24,Armadillo de los Infante,24004,2133,2212,4345
2022,San Luis Potosí,24,Axtla de Terrazas,24053,19492,19983,39475
2022,San Luis Potosí,24,Catorce,24006,5270,5090,10360
2022,San Luis Potosí,24,Cedral,24007,9947,10420,20367
2022,San Luis Potosí,24,Cerritos,24008,11175,11879,23054
2022,San Luis Potosí,24,Cerro de San Pedro,24009,2454,2393,4847
2022,San Luis Potosí,24,Charcas,24015,10849,11261,22110
2022,San Luis Potosí,24,Ciudad Fernández,24011,23379,24675,48054
2022,San Luis Potosí,24,Ciudad Valles,24013,92058,98463,190521
2022,San Luis Potosí,24,Ciudad del Maíz,24010,18277,18469,36746
2022,San Luis Potosí,24,Coxcatlán,24014,8156,8053,16209
2022,San Luis Potosí,24,Cárdenas,24005,9559,10393,19952
2022,San Luis Potosí,24,Ebano,24016,22742,23628,46370
2022,San Luis Potosí,24,El Naranjo,24058,11817,11674,23491
2022,San Luis Potosí,24,Guadalcázar,24017,14168,13903,28071
2022,San Luis Potosí,24,Huehuetlán,24018,8320,8576,16896
2022,San Luis Potosí,24,Lagunillas,24019,2860,2986,5846
2022,San Luis Potosí,24,Matehuala,24020,51475,54474,105949
2022,San Luis Potosí,24,Matlapa,24057,16094,16250,32344
2022,San Luis Potosí,24,Mexquitic de Carmona,24021,28795,31387,60182
2022,San Luis Potosí,24,Moctezuma,24022,9835,10688,20523
2022,San Luis Potosí,24,Rayón,24023,8059,8494,16553
2022,San Luis Potosí,24,Rioverde,24024,48573,51643,100216
2022,San Luis Potosí,24,Salinas,24025,16190,17457,33647
2022,San Luis Potosí,24,San Antonio,24026,4995,4805,9800
2022,San Luis Potosí,24,San Ciro de Acosta,24027,5279,5657,10936
2022,San Luis Potosí,24,San Luis Potosí,24028,425910,455233,881143
2022,San Luis Potosí,24,San Martín Chalchicuautla,24029,11030,11199,22229
2022,San Luis Potosí,24,San Nicolás Tolentino,24030,2573,2863,5436
2022,San Luis Potosí,24,San Vicente Tancuayalab,24034,7805,7838,15643
2022,San Luis Potosí,24,Santa Catarina,24031,6018,6370,12388
2022,San Luis Potosí,24,Santa María del Río,24032,20078,22056,42134
2022,San Luis Potosí,24,Santo Domingo,24033,6314,6384,12698
2022,San Luis Potosí,24,Soledad de Graciano Sánchez,24035,164268,172458,336726
2022,San Luis Potosí,24,Tamasopo,24036,16156,15862,32018
2022,San Luis Potosí,24,Tamazunchale,24037,50240,51187,101427
2022,San Luis Potosí,24,Tampacán,24038,8195,8072,16267
2022,San Luis Potosí,24,Tampamolón Corona,24039,8039,8222,16261
2022,San Luis Potosí,24,Tamuín,24040,20353,20863,41216
2022,San Luis Potosí,24,Tancanhuitz,24012,10742,11070,21812
2022,San Luis Potosí,24,Tanlajás,24041,10465,10270,20735
2022,San Luis Potosí,24,Tanquián de Escobedo,24042,7861,8226,16087
2022,San Luis Potosí,24,Tierra Nueva,24043,4521,5143,9664
2022,San Luis Potosí,24,Vanegas,24044,4088,4022,8110
2022,San Luis Potosí,24,Venado,24045,7545,7834,15379
2022,San Luis Potosí,24,Villa Hidalgo,24051,7783,7936,15719
2022,San Luis Potosí,24,Villa Juárez,24052,5303,5451,10754
2022,San Luis Potosí,24,Villa de Arista,24056,8044,8138,16182
2022,San Luis Potosí,24,Villa de Arriaga,24046,9370,9530,18900
2022,San Luis Potosí,24,Villa de Guadalupe,24047,5175,5175,10350
2022,San Luis Potosí,24,Villa de Ramos,24049,19106,20195,39301
2022,San Luis Potosí,24,Villa de Reyes,24050,25963,26196,52159
2022,San Luis Potosí,24,Villa de la Paz,24048,2850,2817,5667
2022,San Luis Potosí,24,Xilitla,24054,26826,27821,54647
2022,San Luis Potosí,24,Zaragoza,24055,13551,13935,27486
2022,Sinaloa,25,Ahome,25001,240184,248618,488802
2022,Sinaloa,25,Angostura,25002,25869,25715,51584
2022,Sinaloa,25,Badiraguato,25003,16667,15452,32119
2022,Sinaloa,25,Choix,25007,17867,16924,34791
2022,Sinaloa,25,Concordia,25004,15046,14626,29672
2022,Sinaloa,25,Cosalá,25005,8842,8415,17257
2022,Sinaloa,25,Culiacán,25006,479574,497082,976656
2022,Sinaloa,25,El Fuerte,25010,55619,54388,110007
2022,Sinaloa,25,Elota,25008,30867,28689,59556
2022,Sinaloa,25,Escuinapa,25009,32382,31426,63808
2022,Sinaloa,25,Guasave,25011,159231,161640,320871
2022,Sinaloa,25,Mazatlán,25012,269243,275677,544920
2022,Sinaloa,25,Mocorito,25013,25178,23757,48935
2022,Sinaloa,25,Navolato,25018,82762,79559,162321
2022,Sinaloa,25,Rosario,25014,29521,28519,58040
2022,Sinaloa,25,Salvador Alvarado,25015,43002,45046,88048
2022,Sinaloa,25,San Ignacio,25016,11516,10721,22237
2022,Sinaloa,25,Sinaloa,25017,48755,47459,96214
2022,Sonora,26,Aconchi,26001,1631,1477,3108
2022,Sonora,26,Agua Prieta,26002,45298,44686,89984
2022,Sonora,26,Alamos,26003,14740,13778,28518
2022,Sonora,26,Altar,26004,5252,5276,10528
2022,Sonora,26,Arivechi,26005,669,643,1312
2022,Sonora,26,Arizpe,26006,1543,1467,3010
2022,Sonora,26,Atil,26007,332,314,646
2022,Sonora,26,Bacadéhuachi,26008,655,587,1242
2022,Sonora,26,Bacanora,26009,469,423,892
2022,Sonora,26,Bacerac,26010,813,765,1578
2022,Sonora,26,Bacoachi,26011,891,889,1780
2022,Sonora,26,Banámichi,26013,935,914,1849
2022,Sonora,26,Bavispe,26015,888,799,1687
2022,Sonora,26,Baviácora,26014,1925,1827,3752
2022,Sonora,26,Benito Juárez,26071,12171,12151,24322
2022,Sonora,26,Benjamín Hill,26016,2768,2899,5667
2022,Sonora,26,Bácum,26012,12785,12617,25402
2022,Sonora,26,Caborca,26017,47493,46797,94290
2022,Sonora,26,Cajeme,26018,234449,245445,479894
2022,Sonora,26,Cananea,26019,19192,19638,38830
2022,Sonora,26,Carbó,26020,2803,2574,5377
2022,Sonora,26,Cucurpe,26022,610,491,1101
2022,Sonora,26,Cumpas,26023,3476,3450,6926
2022,Sonora,26,Divisaderos,26024,426,413,839
2022,Sonora,26,Empalme,26025,30799,31116,61915
2022,Sonora,26,Etchojoa,26026,34765,33596,68361
2022,Sonora,26,Fronteras,26027,4841,4680,9521
2022,Sonora,26,General Plutarco Elías Calles,26070,9604,9412,19016
2022,Sonora,26,Granados,26028,609,592,1201
2022,Sonora,26,Guaymas,26029,87103,88396,175499
2022,Sonora,26,Hermosillo,26030,478771,491290,970061
2022,Sonora,26,Huachinera,26031,747,704,1451
2022,Sonora,26,Huatabampo,26033,44365,44263,88628
2022,Sonora,26,Huásabas,26032,540,477,1017
2022,Sonora,26,Huépac,26034,569,547,1116
2022,Sonora,26,Imuris,26035,7105,7039,14144
2022,Sonora,26,La Colorada,26021,1210,975,2185
2022,Sonora,26,Magdalena,26036,17243,17496,34739
2022,Sonora,26,Mazatán,26037,716,623,1339
2022,Sonora,26,Moctezuma,26038,2732,2805,5537
2022,Sonora,26,Naco,26039,3442,3418,6860
2022,Sonora,26,Nacozari de García,26041,7232,7210,14442
2022,Sonora,26,Navojoa,26042,88553,92389,180942
2022,Sonora,26,Nogales,26043,129162,129709,258871
2022,Sonora,26,Nácori Chico,26040,1166,1069,2235
2022,Sonora,26,Onavas,26044,274,233,507
2022,Sonora,26,Opodepe,26045,1601,1417,3018
2022,Sonora,26,Oquitoa,26046,207,234,441
2022,Sonora,26,Pitiquito,26047,5306,4992,10298
2022,Sonora,26,Puerto Peñasco,26048,37994,36695,74689
2022,Sonora,26,Quiriego,26049,1686,1469,3155
2022,Sonora,26,Rayón,26050,888,810,1698
2022,Sonora,26,Rosario,26051,2921,2680,5601
2022,Sonora,26,Sahuaripa,26052,3209,3021,6230
2022,Sonora,26,San Felipe de Jesús,26053,236,230,466
2022,Sonora,26,San Ignacio Río Muerto,26072,8221,7780,16001
2022,Sonora,26,San Javier,26054,407,309,716
2022,Sonora,26,San Luis Río Colorado,26055,106438,105284,211722
2022,Sonora,26,San Miguel de Horcasitas,26056,5559,4736,10295
2022,Sonora,26,San Pedro de la Cueva,26057,905,787,1692
2022,Sonora,26,Santa Ana,26058,8987,9243,18230
2022,Sonora,26,Santa Cruz,26059,1014,1049,2063
2022,Sonora,26,Soyopa,26061,830,697,1527
2022,Sonora,26,Suaqui Grande,26062,678,570,1248
2022,Sonora,26,Sáric,26060,871,837,1708
2022,Sonora,26,Tepache,26063,839,765,1604
2022,Sonora,26,Trincheras,26064,988,810,1798
2022,Sonora,26,Tubutama,26065,675,640,1315
2022,Sonora,26,Ures,26066,5008,4790,9798
2022,Sonora,26,Villa Hidalgo,26067,898,830,1728
2022,Sonora,26,Villa Pesqueira,26068,694,581,1275
2022,Sonora,26,Yécora,26069,3245,3212,6457
2022,Tabasco,27,Balancán,27001,32763,32886,65649
2022,Tabasco,27,Centla,27003,60110,60187,120297
2022,Tabasco,27,Centro,27004,369715,386316,756031
2022,Tabasco,27,Comalcalco,27005,109385,112664,222049
2022,Tabasco,27,Cunduacán,27006,74582,76945,151527
2022,Tabasco,27,Cárdenas,27002,137919,143161,281080
2022,Tabasco,27,Emiliano Zapata,27007,16067,17570,33637
2022,Tabasco,27,Huimanguillo,27008,100846,103456,204302
2022,Tabasco,27,Jalapa,27009,21108,21025,42133
2022,Tabasco,27,Jalpa de Méndez,27010,47962,48292,96254
2022,Tabasco,27,Jonuta,27011,16733,16625,33358
2022,Tabasco,27,Macuspana,27012,88516,91983,180499
2022,Tabasco,27,Nacajuca,27013,75407,78421,153828
2022,Tabasco,27,Paraíso,27014,51936,52316,104252
2022,Tabasco,27,Tacotalpa,27015,26608,26453,53061
2022,Tabasco,27,Teapa,27016,31261,32457,63718
2022,Tabasco,27,Tenosique,27017,31500,33315,64815
2022,Tamaulipas,28,Abasolo,28001,6479,6499,12978
2022,Tamaulipas,28,Aldama,28002,15746,15506,31252
2022,Tamaulipas,28,Altamira,28003,130262,131745,262007
2022,Tamaulipas,28,Antiguo Morelos,28004,5313,5315,10628
2022,Tamaulipas,28,Burgos,28005,2496,2311,4807
2022,Tamaulipas,28,Bustamante,28006,4480,4123,8603
2022,Tamaulipas,28,Camargo,28007,8294,8087,16381
2022,Tamaulipas,28,Casas,28008,2339,2116,4455
2022,Tamaulipas,28,Ciudad Madero,28009,108322,118876,227198
2022,Tamaulipas,28,Cruillas,28010,1006,979,1985
2022,Tamaulipas,28,El Mante,28021,61998,65722,127720
2022,Tamaulipas,28,González,28012,23399,23677,47076
2022,Tamaulipas,28,Guerrero,28014,2526,2359,4885
2022,Tamaulipas,28,Gustavo Díaz Ordaz,28015,8559,8366,16925
2022,Tamaulipas,28,Gómez Farías,28011,5051,4813,9864
2022,Tamaulipas,28,Güémez,28013,8716,8073,16789
2022,Tamaulipas,28,Hidalgo,28016,12739,12127,24866
2022,Tamaulipas,28,Jaumave,28017,8459,8176,16635
2022,Tamaulipas,28,Jiménez,28018,4294,4296,8590
2022,Tamaulipas,28,Llera,28019,9230,8928,18158
2022,Tamaulipas,28,Mainero,28020,1388,1350,2738
2022,Tamaulipas,28,Matamoros,28022,272060,280650,552710
2022,Tamaulipas,28,Mier,28024,2121,2208,4329
2022,Tamaulipas,28,Miguel Alemán,28025,14641,14794,29435
2022,Tamaulipas,28,Miquihuana,28026,2032,1855,3887
2022,Tamaulipas,28,Méndez,28023,2128,1936,4064
2022,Tamaulipas,28,Nuevo Laredo,28027,212983,213109,426092
2022,Tamaulipas,28,Nuevo Morelos,28028,1991,1817,3808
2022,Tamaulipas,28,Ocampo,28029,7570,7255,14825
2022,Tamaulipas,28,Padilla,28030,7587,7483,15070
2022,Tamaulipas,28,Palmillas,28031,954,918,1872
2022,Tamaulipas,28,Reynosa,28032,349176,349867,699043
2022,Tamaulipas,28,Río Bravo,28033,67907,67658,135565
2022,Tamaulipas,28,San Carlos,28034,5021,4531,9552
2022,Tamaulipas,28,San Fernando,28035,29942,29714,59656
2022,Tamaulipas,28,San Nicolás,28036,594,521,1115
2022,Tamaulipas,28,Soto la Marina,28037,13695,13082,26777
2022,Tamaulipas,28,Tampico,28038,162663,176990,339653
2022,Tamaulipas,28,Tula,28039,15677,15809,31486
2022,Tamaulipas,28,Valle Hermoso,28040,33791,34898,68689
2022,Tamaulipas,28,Victoria,28041,182596,190977,373573
2022,Tamaulipas,28,Villagrán,28042,3429,3220,6649
2022,Tamaulipas,28,Xicoténcatl,28043,12801,12817,25618
2022,Tlaxcala,29,Acuamanala de Miguel Hidalgo,29022,3605,3589,7194
2022,Tlaxcala,29,Altzayanca,29004,9527,9474,19001
2022,Tlaxcala,29,Amaxac de Guerrero,29001,6092,6263,12355
2022,Tlaxcala,29,Apetatitlán de Antonio Carvajal,29002,8040,8577,16617
2022,Tlaxcala,29,Apizaco,29005,41164,45156,86320
2022,Tlaxcala,29,Atlangatepec,29003,3509,3653,7162
2022,Tlaxcala,29,Benito Juárez,29045,3236,3319,6555
2022,Tlaxcala,29,Calpulalpan,29006,25827,27119,52946
2022,Tlaxcala,29,Chiautempan,29010,38342,41020,79362
2022,Tlaxcala,29,Contla de Juan Cuamatzi,29018,20774,21300,42074
2022,Tlaxcala,29,Cuapiaxtla,29008,8361,8334,16695
2022,Tlaxcala,29,Cuaxomulco,29009,2902,2934,5836
2022,Tlaxcala,29,El Carmen Tequexquitla,29007,9211,9433,18644
2022,Tlaxcala,29,Emiliano Zapata,29046,2408,2514,4922
2022,Tlaxcala,29,Españita,29012,4741,4834,9575
2022,Tlaxcala,29,Huamantla,29013,50229,52080,102309
2022,Tlaxcala,29,Hueyotlipan,29014,7842,8010,15852
2022,Tlaxcala,29,Ixtacuixtla de Mariano Matamoros,29015,20895,22022,42917
2022,Tlaxcala,29,Ixtenco,29016,3820,4114,7934
2022,Tlaxcala,29,La Magdalena Tlaltelulco,29048,9811,10550,20361
2022,Tlaxcala,29,Lázaro Cárdenas,29047,1660,1685,3345
2022,Tlaxcala,29,Mazatecochco de José María Morelos,29017,5875,5963,11838
2022,Tlaxcala,29,Muñoz de Domingo Arenas,29011,2499,2473,4972
2022,Tlaxcala,29,Nanacamilpa de Mariano Arista,29021,9679,10112,19791
2022,Tlaxcala,29,Natívitas,29023,13515,14419,27934
2022,Tlaxcala,29,Panotla,29024,14271,15311,29582
2022,Tlaxcala,29,Papalotla de Xicohténcatl,29041,16120,17181,33301
2022,Tlaxcala,29,San Damián Texóloc,29049,3084,3091,6175
2022,Tlaxcala,29,San Francisco Tetlanohcan,29050,5727,5944,11671
2022,Tlaxcala,29,San Jerónimo Zacualpan,29051,2005,2208,4213
2022,Tlaxcala,29,San José Teacalco,29052,3203,3351,6554
2022,Tlaxcala,29,San Juan Huactzinco,29053,3932,4282,8214
2022,Tlaxcala,29,San Lorenzo Axocomanitla,29054,2976,3187,6163
2022,Tlaxcala,29,San Lucas Tecopilco,29055,1654,1745,3399
2022,Tlaxcala,29,San Pablo del Monte,29025,41996,42071,84067
2022,Tlaxcala,29,Sanctórum de Lázaro Cárdenas,29020,5444,5553,10997
2022,Tlaxcala,29,Santa Ana Nopalucan,29056,4204,4332,8536
2022,Tlaxcala,29,Santa Apolonia Teacalco,29057,2393,2656,5049
2022,Tlaxcala,29,Santa Catarina Ayometla,29058,4689,5042,9731
2022,Tlaxcala,29,Santa Cruz Quilehtla,29059,3933,3924,7857
2022,Tlaxcala,29,Santa Cruz Tlaxcala,29026,11166,11511,22677
2022,Tlaxcala,29,Santa Isabel Xiloxoxtla,29060,2683,2810,5493
2022,Tlaxcala,29,Tenancingo,29027,7036,7252,14288
2022,Tlaxcala,29,Teolocholco,29028,12946,13696,26642
2022,Tlaxcala,29,Tepetitla de Lardizábal,29019,11229,12063,23292
2022,Tlaxcala,29,Tepeyanco,29029,7242,7888,15130
2022,Tlaxcala,29,Terrenate,29030,8454,8352,16806
2022,Tlaxcala,29,Tetla de la Solidaridad,29031,17611,18050,35661
2022,Tlaxcala,29,Tetlatlahuca,29032,7691,8139,15830
2022,Tlaxcala,29,Tlaxcala,29033,50186,55123,105309
2022,Tlaxcala,29,Tlaxco,29034,22866,23686,46552
2022,Tlaxcala,29,Tocatlán,29035,3179,3239,6418
2022,Tlaxcala,29,Totolac,29036,11845,12869,24714
2022,Tlaxcala,29,Tzompantepec,29038,9288,9934,19222
2022,Tlaxcala,29,Xaloztoc,29039,13214,13122,26336
2022,Tlaxcala,29,Xaltocan,29040,5804,6213,12017
2022,Tlaxcala,29,Xicohtzinco,29042,7215,7928,15143
2022,Tlaxcala,29,Yauhquemehcan,29043,20810,22113,42923
2022,Tlaxcala,29,Zacatelco,29044,23295,25317,48612
2022,Tlaxcala,29,Ziltlaltépec de Trinidad Sánchez Santos,29037,4631,5028,9659
2022,Veracruz,30,Acajete,30001,4700,4503,9203
2022,Veracruz,30,Acatlán,30002,1662,1714,3376
2022,Veracruz,30,Acayucan,30003,44192,47639,91831
2022,Veracruz,30,Actopan,30004,22839,23659,46498
2022,Veracruz,30,Acula,30005,2887,2879,5766
2022,Veracruz,30,Acultzingo,30006,11891,12300,24191
2022,Veracruz,30,Agua Dulce,30204,24898,26354,51252
2022,Veracruz,30,Alpatláhuac,30008,5320,5335,10655
2022,Veracruz,30,Alto Lucero de Gutiérrez Barrios,30009,15620,15534,31154
2022,Veracruz,30,Altotonga,30010,33301,35719,69020
2022,Veracruz,30,Alvarado,30011,28321,29023,57344
2022,Veracruz,30,Amatitlán,30012,4201,4394,8595
2022,Veracruz,30,Amatlán de los Reyes,30014,23478,25189,48667
2022,Veracruz,30,Angel R. Cabada,30015,17612,18651,36263
2022,Veracruz,30,Apazapan,30017,2159,2190,4349
2022,Veracruz,30,Aquila,30018,959,1021,1980
2022,Veracruz,30,Astacinga,30019,3155,3591,6746
2022,Veracruz,30,Atlahuilco,30020,5580,5846,11426
2022,Veracruz,30,Atoyac,30021,12287,12998,25285
2022,Veracruz,30,Atzacan,30022,11145,11497,22642
2022,Veracruz,30,Atzalan,30023,26586,26806,53392
2022,Veracruz,30,Ayahualulco,30025,14055,14220,28275
2022,Veracruz,30,Banderilla,30026,11843,13183,25026
2022,Veracruz,30,Benito Juárez,30027,9059,9531,18590
2022,Veracruz,30,Boca del Río,30028,72589,81845,154434
2022,Veracruz,30,Calcahualco,30029,6764,6759,13523
2022,Veracruz,30,Camarón de Tejeda,30007,3458,3443,6901
2022,Veracruz,30,Camerino Z. Mendoza,30030,21290,23944,45234
2022,Veracruz,30,Carlos A. Carrillo,30208,12634,13748,26382
2022,Veracruz,30,Carrillo Puerto,30031,8826,9133,17959
2022,Veracruz,30,Castillo de Teayo,30157,10563,10377,20940
2022,Veracruz,30,Catemaco,30032,25340,27110,52450
2022,Veracruz,30,Cazones de Herrera,30033,12192,12958,25150
2022,Veracruz,30,Cerro Azul,30034,13693,15266,28959
2022,Veracruz,30,Chacaltianguis,30054,6445,6837,13282
2022,Veracruz,30,Chalma,30055,7021,7276,14297
2022,Veracruz,30,Chiconamel,30056,3400,3658,7058
2022,Veracruz,30,Chiconquiaco,30057,7406,7510,14916
2022,Veracruz,30,Chicontepec,30058,28793,30299,59092
2022,Veracruz,30,Chinameca,30059,8435,8840,17275
2022,Veracruz,30,Chinampa de Gorostiza,30060,8756,8995,17751
2022,Veracruz,30,Chocamán,30062,11180,11211,22391
2022,Veracruz,30,Chontla,30063,7604,7706,15310
2022,Veracruz,30,Chumatlán,30064,2003,2124,4127
2022,Veracruz,30,Citlaltépetl,30035,6146,6461,12607
2022,Veracruz,30,Coacoatzintla,30036,5430,5682,11112
2022,Veracruz,30,Coahuitlán,30037,4387,4548,8935
2022,Veracruz,30,Coatepec,30038,47749,51375,99124
2022,Veracruz,30,Coatzacoalcos,30039,166077,176541,342618
2022,Veracruz,30,Coatzintla,30040,29750,31314,61064
2022,Veracruz,30,Coetzala,30041,1186,1216,2402
2022,Veracruz,30,Colipa,30042,2890,3011,5901
2022,Veracruz,30,Comapa,30043,10937,10484,21421
2022,Veracruz,30,Cosamaloapan de Carpio,30045,29039,31653,60692
2022,Veracruz,30,Cosautlán de Carvajal,30046,8563,8675,17238
2022,Veracruz,30,Coscomatepec,30047,30335,31297,61632
2022,Veracruz,30,Cosoleacaque,30048,71094,76043,147137
2022,Veracruz,30,Cotaxtla,30049,11075,11094,22169
2022,Veracruz,30,Coxquihui,30050,8652,9061,17713
2022,Veracruz,30,Coyutla,30051,11383,12268,23651
2022,Veracruz,30,Cuichapa,30052,6168,6791,12959
2022,Veracruz,30,Cuitláhuac,30053,14365,15611,29976
2022,Veracruz,30,Córdoba,30044,108878,122583,231461
2022,Veracruz,30,El Higo,30205,10373,10473,20846
2022,Veracruz,30,Emiliano Zapata,30065,41751,44694,86445
2022,Veracruz,30,Espinal,30066,14067,14781,28848
2022,Veracruz,30,Filomeno Mata,30067,9897,9839,19736
2022,Veracruz,30,Fortín,30068,33932,37643,71575
2022,Veracruz,30,Gutiérrez Zamora,30069,12249,13816,26065
2022,Veracruz,30,Hidalgotitlán,30070,10151,9823,19974
2022,Veracruz,30,Huatusco,30071,31186,33334,64520
2022,Veracruz,30,Huayacocotla,30072,11050,11786,22836
2022,Veracruz,30,Hueyapan de Ocampo,30073,22294,23524,45818
2022,Veracruz,30,Huiloapan de Cuauhtémoc,30074,3730,3997,7727
2022,Veracruz,30,Ignacio de la Llave,30075,8812,9633,18445
2022,Veracruz,30,Ilamatlán,30076,6841,7485,14326
2022,Veracruz,30,Isla,30077,22355,23376,45731
2022,Veracruz,30,Ixcatepec,30078,7155,7146,14301
2022,Veracruz,30,Ixhuacán de los Reyes,30079,6116,6006,12122
2022,Veracruz,30,Ixhuatlancillo,30081,13429,14584,28013
2022,Veracruz,30,Ixhuatlán de Madero,30083,27890,29303,57193
2022,Veracruz,30,Ixhuatlán del Café,30080,12085,12143,24228
2022,Veracruz,30,Ixhuatlán del Sureste,30082,8360,8299,16659
2022,Veracruz,30,Ixmatlahuacan,30084,3019,3086,6105
2022,Veracruz,30,Ixtaczoquitlán,30085,35489,37633,73122
2022,Veracruz,30,Jalacingo,30086,22920,23963,46883
2022,Veracruz,30,Jalcomulco,30088,2738,2703,5441
2022,Veracruz,30,Jamapa,30090,5934,6203,12137
2022,Veracruz,30,Jesús Carranza,30091,15383,15470,30853
2022,Veracruz,30,Jilotepec,30093,8700,9123,17823
2022,Veracruz,30,José Azueta,30169,11855,12296,24151
2022,Veracruz,30,Juan Rodríguez Clara,30094,20570,21057,41627
2022,Veracruz,30,Juchique de Ferrer,30095,8266,8435,16701
2022,Veracruz,30,Jáltipan,30089,21203,23154,44357
2022,Veracruz,30,La Antigua,30016,13859,14879,28738
2022,Veracruz,30,La Perla,30127,14417,14973,29390
2022,Veracruz,30,Landero y Coss,30096,824,867,1691
2022,Veracruz,30,Las Choapas,30061,42315,43830,86145
2022,Veracruz,30,Las Minas,30107,1610,1546,3156
2022,Veracruz,30,Las Vigas de Ramírez,30132,10455,10511,20966
2022,Veracruz,30,Lerdo de Tejada,30097,9887,11309,21196
2022,Veracruz,30,Los Reyes,30137,3116,3157,6273
2022,Veracruz,30,Magdalena,30098,1626,1643,3269
2022,Veracruz,30,Maltrata,30099,9222,9829,19051
2022,Veracruz,30,Manlio Fabio Altamirano,30100,12377,12786,25163
2022,Veracruz,30,Mariano Escobedo,30101,18686,20099,38785
2022,Veracruz,30,Martínez de la Torre,30102,53432,58073,111505
2022,Veracruz,30,Mecatlán,30103,6421,6617,13038
2022,Veracruz,30,Mecayapan,30104,8653,9052,17705
2022,Veracruz,30,Medellín,30105,41304,44683,85987
2022,Veracruz,30,Miahuatlán,30106,2452,2525,4977
2022,Veracruz,30,Minatitlán,30108,80346,85565,165911
2022,Veracruz,30,Misantla,30109,33324,35023,68347
2022,Veracruz,30,Mixtla de Altamirano,30110,6242,6128,12370
2022,Veracruz,30,Moloacán,30111,8905,9403,18308
2022,Veracruz,30,Nanchital de Lázaro Cárdenas del Rio,30206,15331,16214,31545
2022,Veracruz,30,Naolinco,30112,11350,11870,23220
2022,Veracruz,30,Naranjal,30113,2342,2499,4841
2022,Veracruz,30,Naranjos Amatlán,30013,14441,16022,30463
2022,Veracruz,30,Nautla,30114,5742,5952,11694
2022,Veracruz,30,Nogales,30115,19244,21052,40296
2022,Veracruz,30,Oluta,30116,8431,9086,17517
2022,Veracruz,30,Omealca,30117,12295,13136,25431
2022,Veracruz,30,Orizaba,30118,62528,73479,136007
2022,Veracruz,30,Otatitlán,30119,2883,3146,6029
2022,Veracruz,30,Oteapan,30120,8522,8812,17334
2022,Veracruz,30,Ozuluama de Mascareñas,30121,12590,12053,24643
2022,Veracruz,30,Pajapan,30122,9219,9147,18366
2022,Veracruz,30,Papantla,30124,82761,84262,167023
2022,Veracruz,30,Paso de Ovejas,30126,17847,17986,35833
2022,Veracruz,30,Paso del Macho,30125,16675,17043,33718
2022,Veracruz,30,Perote,30128,38745,39052,77797
2022,Veracruz,30,Platón Sánchez,30129,9442,9858,19300
2022,Veracruz,30,Playa Vicente,30130,18996,20648,39644
2022,Veracruz,30,Poza Rica de Hidalgo,30131,104914,116201,221115
2022,Veracruz,30,Pueblo Viejo,30133,30785,30724,61509
2022,Veracruz,30,Puente Nacional,30134,11905,12267,24172
2022,Veracruz,30,Pánuco,30123,53273,53673,106946
2022,Veracruz,30,Rafael Delgado,30135,12224,12619,24843
2022,Veracruz,30,Rafael Lucio,30136,4214,4450,8664
2022,Veracruz,30,Río Blanco,30138,21123,23858,44981
2022,Veracruz,30,Saltabarranca,30139,3201,3416,6617
2022,Veracruz,30,San Andrés Tenejapan,30140,1535,1594,3129
2022,Veracruz,30,San Andrés Tuxtla,30141,83957,90683,174640
2022,Veracruz,30,San Juan Evangelista,30142,17658,18291,35949
2022,Veracruz,30,San Rafael,30211,15555,16149,31704
2022,Veracruz,30,Santiago Sochiapan,30212,7331,7816,15147
2022,Veracruz,30,Santiago Tuxtla,30143,29364,31613,60977
2022,Veracruz,30,Sayula de Alemán,30144,17037,17599,34636
2022,Veracruz,30,Sochiapa,30146,1934,1933,3867
2022,Veracruz,30,Soconusco,30145,8464,8902,17366
2022,Veracruz,30,Soledad Atzompa,30147,12205,12308,24513
2022,Veracruz,30,Soledad de Doblado,30148,14526,14829,29355
2022,Veracruz,30,Soteapan,30149,17889,18480,36369
2022,Veracruz,30,Tamalín,30150,6177,6144,12321
2022,Veracruz,30,Tamiahua,30151,12355,12296,24651
2022,Veracruz,30,Tampico Alto,30152,6849,6406,13255
2022,Veracruz,30,Tancoco,30153,2969,3150,6119
2022,Veracruz,30,Tantima,30154,6998,6768,13766
2022,Veracruz,30,Tantoyuca,30155,54201,55524,109725
2022,Veracruz,30,Tatahuicapan de Juárez,30209,8071,8400,16471
2022,Veracruz,30,Tatatila,30156,3261,2987,6248
2022,Veracruz,30,Tecolutla,30158,12525,12918,25443
2022,Veracruz,30,Tehuipango,30159,13386,14194,27580
2022,Veracruz,30,Tempoal,30161,18554,19178,37732
2022,Veracruz,30,Tenampa,30162,3511,3651,7162
2022,Veracruz,30,Tenochtitlán,30163,2634,2821,5455
2022,Veracruz,30,Teocelo,30164,8596,9108,17704
2022,Veracruz,30,Tepatlaxco,30165,4592,4361,8953
2022,Veracruz,30,Tepetlán,30166,5202,5046,10248
2022,Veracruz,30,Tepetzintla,30167,7677,7884,15561
2022,Veracruz,30,Tequila,30168,7933,8190,16123
2022,Veracruz,30,Texcatepec,30170,5664,5951,11615
2022,Veracruz,30,Texhuacán,30171,2678,2991,5669
2022,Veracruz,30,Texistepec,30172,11034,10987,22021
2022,Veracruz,30,Tezonapa,30173,29771,30446,60217
2022,Veracruz,30,Tierra Blanca,30174,54261,58368,112629
2022,Veracruz,30,Tihuatlán,30175,50146,52136,102282
2022,Veracruz,30,Tlachichilco,30180,6022,6234,12256
2022,Veracruz,30,Tlacojalpan,30176,2571,2675,5246
2022,Veracruz,30,Tlacolulan,30177,6079,5873,11952
2022,Veracruz,30,Tlacotalpan,30178,6810,7405,14215
2022,Veracruz,30,Tlacotepec de Mejía,30179,2078,2117,4195
2022,Veracruz,30,Tlalixcoyan,30181,19912,20563,40475
2022,Veracruz,30,Tlalnelhuayocan,30182,9873,10195,20068
2022,Veracruz,30,Tlaltetela,30024,8408,8174,16582
2022,Veracruz,30,Tlapacoyan,30183,31957,33794,65751
2022,Veracruz,30,Tlaquilpa,30184,3780,4322,8102
2022,Veracruz,30,Tlilapan,30185,2755,2889,5644
2022,Veracruz,30,Tomatlán,30186,3645,3753,7398
2022,Veracruz,30,Tonayán,30187,2922,3108,6030
2022,Veracruz,30,Totutla,30188,9218,9290,18508
2022,Veracruz,30,Tres Valles,30207,23902,25196,49098
2022,Veracruz,30,Tuxpan,30189,84078,88308,172386
2022,Veracruz,30,Tuxtilla,30190,1178,1210,2388
2022,Veracruz,30,Ursulo Galván,30191,16012,16926,32938
2022,Veracruz,30,Uxpanapa,30210,15575,15156,30731
2022,Veracruz,30,Vega de Alatorre,30192,10411,11132,21543
2022,Veracruz,30,Veracruz,30193,304790,330141,634931
2022,Veracruz,30,Villa Aldama,30194,6216,6351,12567
2022,Veracruz,30,Xalapa,30087,244420,274364,518784
2022,Veracruz,30,Xico,30092,20208,20715,40923
2022,Veracruz,30,Xoxocotla,30195,2933,2804,5737
2022,Veracruz,30,Yanga,30196,9039,10193,19232
2022,Veracruz,30,Yecuatla,30197,6233,6449,12682
2022,Veracruz,30,Zacualpan,30198,3673,3947,7620
2022,Veracruz,30,Zaragoza,30199,5861,6109,11970
2022,Veracruz,30,Zentla,30200,7175,7042,14217
2022,Veracruz,30,Zongolica,30201,22836,23317,46153
2022,Veracruz,30,Zontecomatlán de López y Fuentes,30202,7594,7785,15379
2022,Veracruz,30,Zozocolco de Hidalgo,30203,7810,8144,15954
2022,Veracruz,30,Álamo Temapache,30160,55237,55909,111146
2022,Yucatán,31,Abalá,31001,3662,3504,7166
2022,Yucatán,31,Acanceh,31002,8879,8867,17746
2022,Yucatán,31,Akil,31003,5919,6156,12075
2022,Yucatán,31,Baca,31004,3244,3322,6566
2022,Yucatán,31,Bokobá,31005,1225,1176,2401
2022,Yucatán,31,Buctzotz,31006,4883,4858,9741
2022,Yucatán,31,Cacalchén,31007,4074,3866,7940
2022,Yucatán,31,Calotmul,31008,2208,2200,4408
2022,Yucatán,31,Cansahcab,31009,2524,2563,5087
2022,Yucatán,31,Cantamayec,31010,1425,1309,2734
2022,Yucatán,31,Celestún,31011,4329,4110,8439
2022,Yucatán,31,Cenotillo,31012,2078,2224,4302
2022,Yucatán,31,Chacsinkín,31016,1643,1612,3255
2022,Yucatán,31,Chankom,31017,2530,2451,4981
2022,Yucatán,31,Chapab,31018,1732,1726,3458
2022,Yucatán,31,Chemax,31019,20033,19712,39745
2022,Yucatán,31,Chichimilá,31021,4599,4528,9127
2022,Yucatán,31,Chicxulub Pueblo,31020,2524,2393,4917
2022,Yucatán,31,Chikindzonot,31022,2281,2214,4495
2022,Yucatán,31,Chocholá,31023,2631,2541,5172
2022,Yucatán,31,Chumayel,31024,1746,1815,3561
2022,Yucatán,31,Conkal,31013,6134,6120,12254
2022,Yucatán,31,Cuncunul,31014,894,865,1759
2022,Yucatán,31,Cuzamá,31015,2864,2783,5647
2022,Yucatán,31,Dzemul,31026,2049,2034,4083
2022,Yucatán,31,Dzidzantún,31027,4567,4467,9034
2022,Yucatán,31,Dzilam González,31029,3414,3240,6654
2022,Yucatán,31,Dzilam de Bravo,31028,1521,1439,2960
2022,Yucatán,31,Dzitás,31030,2111,2014,4125
2022,Yucatán,31,Dzoncauich,31031,1425,1454,2879
2022,Yucatán,31,Dzán,31025,2839,2971,5810
2022,Yucatán,31,Espita,31032,8956,8681,17637
2022,Yucatán,31,Halachó,31033,11155,10907,22062
2022,Yucatán,31,Hocabá,31034,3373,3365,6738
2022,Yucatán,31,Hoctún,31035,3207,3272,6479
2022,Yucatán,31,Homún,31036,4281,4124,8405
2022,Yucatán,31,Huhí,31037,2906,2800,5706
2022,Yucatán,31,Hunucmá,31038,17738,17814,35552
2022,Yucatán,31,Ixil,31039,2286,2198,4484
2022,Yucatán,31,Izamal,31040,14610,14874,29484
2022,Yucatán,31,Kanasín,31041,56144,56917,113061
2022,Yucatán,31,Kantunil,31042,2877,3016,5893
2022,Yucatán,31,Kaua,31043,1724,1654,3378
2022,Yucatán,31,Kinchil,31044,3961,3871,7832
2022,Yucatán,31,Kopomá,31045,1435,1351,2786
2022,Yucatán,31,Mama,31046,1634,1809,3443
2022,Yucatán,31,Maní,31047,3001,3128,6129
2022,Yucatán,31,Maxcanú,31048,12490,12306,24796
2022,Yucatán,31,Mayapán,31049,2070,1919,3989
2022,Yucatán,31,Mocochá,31051,1820,1778,3598
2022,Yucatán,31,Motul,31052,19821,20139,39960
2022,Yucatán,31,Muna,31053,6769,7040,13809
2022,Yucatán,31,Muxupip,31054,1539,1602,3141
2022,Yucatán,31,Mérida,31050,474792,510939,985731
2022,Yucatán,31,Opichén,31055,3765,3640,7405
2022,Yucatán,31,Oxkutzcab,31056,16174,17657,33831
2022,Yucatán,31,Panabá,31057,4179,4203,8382
2022,Yucatán,31,Peto,31058,13606,13808,27414
2022,Yucatán,31,Progreso,31059,32039,32354,64393
2022,Yucatán,31,Quintana Roo,31060,525,522,1047
2022,Yucatán,31,Río Lagartos,31061,1991,1891,3882
2022,Yucatán,31,Sacalum,31062,2699,2558,5257
2022,Yucatán,31,Samahil,31063,2834,2811,5645
2022,Yucatán,31,San Felipe,31065,1083,1022,2105
2022,Yucatán,31,Sanahcat,31064,938,934,1872
2022,Yucatán,31,Santa Elena,31066,2119,2227,4346
2022,Yucatán,31,Seyé,31067,5379,5147,10526
2022,Yucatán,31,Sinanché,31068,1797,1655,3452
2022,Yucatán,31,Sotuta,31069,4928,4750,9678
2022,Yucatán,31,Sucilá,31070,2170,2100,4270
2022,Yucatán,31,Sudzal,31071,979,878,1857
2022,Yucatán,31,Suma,31072,1022,989,2011
2022,Yucatán,31,Tahdziú,31073,2837,2665,5502
2022,Yucatán,31,Tahmek,31074,2075,2007,4082
2022,Yucatán,31,Teabo,31075,3568,3612,7180
2022,Yucatán,31,Tecoh,31076,9630,9550,19180
2022,Yucatán,31,Tekal de Venegas,31077,1469,1430,2899
2022,Yucatán,31,Tekantó,31078,2059,2064,4123
2022,Yucatán,31,Tekax,31079,22767,23521,46288
2022,Yucatán,31,Tekit,31080,5662,5501,11163
2022,Yucatán,31,Tekom,31081,1743,1762,3505
2022,Yucatán,31,Telchac Pueblo,31082,2093,2069,4162
2022,Yucatán,31,Telchac Puerto,31083,1019,925,1944
2022,Yucatán,31,Temax,31084,3973,3951,7924
2022,Yucatán,31,Temozón,31085,8565,8315,16880
2022,Yucatán,31,Tepakán,31086,1243,1190,2433
2022,Yucatán,31,Tetiz,31087,2747,2771,5518
2022,Yucatán,31,Teya,31088,1056,1077,2133
2022,Yucatán,31,Ticul,31089,21589,22188,43777
2022,Yucatán,31,Timucuy,31090,4106,3931,8037
2022,Yucatán,31,Tinum,31091,6628,6389,13017
2022,Yucatán,31,Tixcacalcupul,31092,3905,3854,7759
2022,Yucatán,31,Tixkokob,31093,9792,9966,19758
2022,Yucatán,31,Tixmehuac,31094,2661,2642,5303
2022,Yucatán,31,Tixpéhual,31095,2973,3073,6046
2022,Yucatán,31,Tizimín,31096,41618,42680,84298
2022,Yucatán,31,Tunkás,31097,1948,1869,3817
2022,Yucatán,31,Tzucacab,31098,8058,7898,15956
2022,Yucatán,31,Uayma,31099,2290,2191,4481
2022,Yucatán,31,Ucú,31100,2039,2012,4051
2022,Yucatán,31,Umán,31101,29453,29408,58861
2022,Yucatán,31,Valladolid,31102,43614,44331,87945
2022,Yucatán,31,Xocchel,31103,1942,1865,3807
2022,Yucatán,31,Yaxcabá,31104,8551,8053,16604
2022,Yucatán,31,Yaxkukul,31105,1722,1743,3465
2022,Yucatán,31,Yobaín,31106,1266,1219,2485
2022,Zacatecas,32,Apozol,32001,3088,3297,6385
2022,Zacatecas,32,Apulco,32002,2437,2700,5137
2022,Zacatecas,32,Atolinga,32003,1286,1363,2649
2022,Zacatecas,32,Benito Juárez,32004,2209,2131,4340
2022,Zacatecas,32,Calera,32005,24026,23973,47999
2022,Zacatecas,32,Cañitas de Felipe Pescador,32006,4329,4439,8768
2022,Zacatecas,32,Chalchihuites,32009,5856,6172,12028
2022,Zacatecas,32,Concepción del Oro,32007,7150,7012,14162
2022,Zacatecas,32,Cuauhtémoc,32008,6514,6852,13366
2022,Zacatecas,32,El Plateado de Joaquín Amaro,32015,670,684,1354
2022,Zacatecas,32,El Salvador,32041,1277,1238,2515
2022,Zacatecas,32,Fresnillo,32010,121578,124628,246206
2022,Zacatecas,32,Genaro Codina,32012,4212,4429,8641
2022,Zacatecas,32,General Enrique Estrada,32013,3307,3377,6684
2022,Zacatecas,32,General Francisco R. Murguía,32014,11137,11854,22991
2022,Zacatecas,32,General Pánfilo Natera,32016,12026,12485,24511
2022,Zacatecas,32,Guadalupe,32017,99705,104381,204086
2022,Zacatecas,32,Huanusco,32018,2106,2190,4296
2022,Zacatecas,32,Jalpa,32019,12576,13124,25700
2022,Zacatecas,32,Jerez,32020,31110,32933,64043
2022,Zacatecas,32,Jiménez del Teul,32021,2203,2240,4443
2022,Zacatecas,32,Juan Aldama,32022,11217,11872,23089
2022,Zacatecas,32,Juchipila,32023,6430,7122,13552
2022,Zacatecas,32,Loreto,32024,28522,28927,57449
2022,Zacatecas,32,Luis Moya,32025,7058,7115,14173
2022,Zacatecas,32,Mazapil,32026,9817,8920,18737
2022,Zacatecas,32,Melchor Ocampo,32027,1695,1490,3185
2022,Zacatecas,32,Mezquital del Oro,32028,1257,1370,2627
2022,Zacatecas,32,Miguel Auza,32029,12331,12805,25136
2022,Zacatecas,32,Momax,32030,1236,1325,2561
2022,Zacatecas,32,Monte Escobedo,32031,4885,4974,9859
2022,Zacatecas,32,Morelos,32032,6635,6672,13307
2022,Zacatecas,32,Moyahua de Estrada,32033,1984,2243,4227
2022,Zacatecas,32,Nochistlán de Mejía,32034,14165,15548,29713
2022,Zacatecas,32,Noria de Ángeles,32035,8822,9090,17912
2022,Zacatecas,32,Ojocaliente,32036,22397,23372,45769
2022,Zacatecas,32,Pinos,32038,38007,39678,77685
2022,Zacatecas,32,Pánuco,32037,9548,9507,19055
2022,Zacatecas,32,Río Grande,32039,33125,35145,68270
2022,Zacatecas,32,Sain Alto,32040,11479,12085,23564
2022,Zacatecas,32,Santa María de la Paz,32058,1425,1449,2874
2022,Zacatecas,32,Sombrerete,32042,32503,33432,65935
2022,Zacatecas,32,Susticacán,32043,697,759,1456
2022,Zacatecas,32,Tabasco,32044,8056,8456,16512
2022,Zacatecas,32,Tepechitlán,32045,4458,4851,9309
2022,Zacatecas,32,Tepetongo,32046,3694,3911,7605
2022,Zacatecas,32,Teúl de González Ortega,32047,2506,2637,5143
2022,Zacatecas,32,Tlaltenango de Sánchez Román,32048,14001,14554,28555
2022,Zacatecas,32,Trancoso,32057,10183,10396,20579
2022,Zacatecas,32,Trinidad García de la Cadena,32011,1495,1547,3042
2022,Zacatecas,32,Valparaíso,32049,17376,17852,35228
2022,Zacatecas,32,Vetagrande,32050,5283,5416,10699
2022,Zacatecas,32,Villa García,32052,10133,10304,20437
2022,Zacatecas,32,Villa González Ortega,32053,6861,7261,14122
2022,Zacatecas,32,Villa Hidalgo,32054,10125,10252,20377
2022,Zacatecas,32,Villa de Cos,32051,18891,18633,37524
2022,Zacatecas,32,Villanueva,32055,15777,16412,32189
2022,Zacatecas,32,Zacatecas,32056,76461,80859,157320
2023,Aguascalientes,01,Aguascalientes,01001,489916,509287,999203
2023,Aguascalientes,01,Asientos,01002,26116,26338,52454
2023,Aguascalientes,01,Calvillo,01003,30793,32038,62831
2023,Aguascalientes,01,Cosío,01004,8558,8855,17413
2023,Aguascalientes,01,El Llano,01010,11493,11184,22677
2023,Aguascalientes,01,Jesús María,01005,68413,67632,136045
2023,Aguascalientes,01,Pabellón de Arteaga,01006,25241,26388,51629
2023,Aguascalientes,01,Rincón de Romos,01007,29748,30081,59829
2023,Aguascalientes,01,San Francisco de los Romo,01011,27070,27146,54216
2023,Aguascalientes,01,San José de Gracia,01008,4858,5140,9998
2023,Aguascalientes,01,Tepezalá,01009,11622,11958,23580
2023,Baja California,02,Ensenada,02001,280065,280918,560983
2023,Baja California,02,Mexicali,02002,568599,572196,1140795
2023,Baja California,02,Playas de Rosarito,02005,56610,56453,113063
2023,Baja California,02,Tecate,02003,61086,57710,118796
2023,Baja California,02,Tijuana,02004,928392,935581,1863973
2023,Baja California Sur,03,Comondú,03001,44608,43421,88029
2023,Baja California Sur,03,La Paz,03003,158449,160132,318581
2023,Baja California Sur,03,Loreto,03009,12086,11088,23174
2023,Baja California Sur,03,Los Cabos,03008,181305,171198,352503
2023,Baja California Sur,03,Mulegé,03002,36621,34118,70739
2023,Campeche,04,Calakmul,04010,16819,16200,33019
2023,Campeche,04,Calkiní,04001,32577,33663,66240
2023,Campeche,04,Campeche,04002,160675,172641,333316
2023,Campeche,04,Candelaria,04011,25842,25113,50955
2023,Campeche,04,Carmen,04003,144008,145060,289068
2023,Campeche,04,Champotón,04004,52784,52340,105124
2023,Campeche,04,Escárcega,04009,32752,33441,66193
2023,Campeche,04,Hecelchakán,04005,18102,18180,36282
2023,Campeche,04,Hopelchén,04006,23652,22608,46260
2023,Campeche,04,Palizada,04007,5203,5087,10290
2023,Campeche,04,Tenabo,04008,6411,6086,12497
2023,Chiapas,07,Acacoyagua,07001,10389,10322,20711
2023,Chiapas,07,Acala,07002,17841,18169,36010
2023,Chiapas,07,Acapetahua,07003,16198,16167,32365
2023,Chiapas,07,Aldama,07113,3590,3884,7474
2023,Chiapas,07,Altamirano,07004,18898,18669,37567
2023,Chiapas,07,Amatenango de la Frontera,07006,17140,18142,35282
2023,Chiapas,07,Amatenango del Valle,07007,5382,5827,11209
2023,Chiapas,07,Amatán,07005,11324,11023,22347
2023,Chiapas,07,Angel Albino Corzo,07008,15900,16041,31941
2023,Chiapas,07,Arriaga,07009,22151,23736,45887
2023,Chiapas,07,Bejucal de Ocampo,07010,4336,4300,8636
2023,Chiapas,07,Bella Vista,07011,11380,11529,22909
2023,Chiapas,07,Benemérito de las Américas,07114,11440,11203,22643
2023,Chiapas,07,Berriozábal,07012,29973,30199,60172
2023,Chiapas,07,Bochil,07013,19671,20066,39737
2023,Chiapas,07,Cacahoatán,07015,25568,26897,52465
2023,Chiapas,07,Catazajá,07016,9950,9809,19759
2023,Chiapas,07,Chalchihuitán,07022,9250,9424,18674
2023,Chiapas,07,Chamula,07023,45962,53764,99726
2023,Chiapas,07,Chanal,07024,6966,7003,13969
2023,Chiapas,07,Chapultenango,07025,4256,4242,8498
2023,Chiapas,07,Chenalhó,07026,22497,22985,45482
2023,Chiapas,07,Chiapa de Corzo,07027,57392,59554,116946
2023,Chiapas,07,Chiapilla,07028,3398,3272,6670
2023,Chiapas,07,Chicoasén,07029,2877,2894,5771
2023,Chiapas,07,Chicomuselo,07030,19851,20112,39963
2023,Chiapas,07,Chilón,07031,72465,74174,146639
2023,Chiapas,07,Cintalapa,07017,48615,49064,97679
2023,Chiapas,07,Coapilla,07018,5142,5287,10429
2023,Chiapas,07,Comitán de Domínguez,07019,84986,93264,178250
2023,Chiapas,07,Copainalá,07021,12151,12733,24884
2023,Chiapas,07,El Bosque,07014,12381,13245,25626
2023,Chiapas,07,El Porvenir,07070,8021,8081,16102
2023,Chiapas,07,Escuintla,07032,17729,18271,36000
2023,Chiapas,07,Francisco León,07033,4366,4232,8598
2023,Chiapas,07,Frontera Comalapa,07034,41096,43493,84589
2023,Chiapas,07,Frontera Hidalgo,07035,8054,8473,16527
2023,Chiapas,07,Huehuetán,07037,19302,20391,39693
2023,Chiapas,07,Huitiupán,07039,13069,12895,25964
2023,Chiapas,07,Huixtla,07040,29662,31893,61555
2023,Chiapas,07,Huixtán,07038,13154,13600,26754
2023,Chiapas,07,Ixhuatán,07042,6345,6512,12857
2023,Chiapas,07,Ixtacomitán,07043,6045,6146,12191
2023,Chiapas,07,Ixtapa,07044,15412,15596,31008
2023,Chiapas,07,Ixtapangajoya,07045,3146,3059,6205
2023,Chiapas,07,Jiquipilas,07046,22183,22993,45176
2023,Chiapas,07,Jitotol,07047,11971,11653,23624
2023,Chiapas,07,Juárez,07048,12070,12396,24466
2023,Chiapas,07,La Concordia,07020,26356,26053,52409
2023,Chiapas,07,La Grandeza,07036,4019,4120,8139
2023,Chiapas,07,La Independencia,07041,25425,26354,51779
2023,Chiapas,07,La Libertad,07050,2743,2843,5586
2023,Chiapas,07,La Trinitaria,07099,43745,45844,89589
2023,Chiapas,07,Larráinzar,07049,13232,13701,26933
2023,Chiapas,07,Las Margaritas,07052,69900,71162,141062
2023,Chiapas,07,Las Rosas,07075,15848,16201,32049
2023,Chiapas,07,Mapastepec,07051,26634,27569,54203
2023,Chiapas,07,Maravilla Tenejapa,07115,7271,7028,14299
2023,Chiapas,07,Marqués de Comillas,07116,6513,6327,12840
2023,Chiapas,07,Mazapa de Madero,07053,4370,4536,8906
2023,Chiapas,07,Mazatán,07054,16381,16921,33302
2023,Chiapas,07,Metapa,07055,3104,3352,6456
2023,Chiapas,07,Mitontic,07056,6879,6938,13817
2023,Chiapas,07,Montecristo de Guerrero,07117,4380,4266,8646
2023,Chiapas,07,Motozintla,07057,40703,42298,83001
2023,Chiapas,07,Nicolás Ruíz,07058,2504,2367,4871
2023,Chiapas,07,Ocosingo,07059,124277,125223,249500
2023,Chiapas,07,Ocotepec,07060,6978,7275,14253
2023,Chiapas,07,Ocozocoautla de Espinosa,07061,51595,52967,104562
2023,Chiapas,07,Ostuacán,07062,10450,10323,20773
2023,Chiapas,07,Osumacinta,07063,2117,2123,4240
2023,Chiapas,07,Oxchuc,07064,26946,26680,53626
2023,Chiapas,07,Palenque,07065,67289,69425,136714
2023,Chiapas,07,Pantelhó,07066,12364,12563,24927
2023,Chiapas,07,Pantepec,07067,6927,7035,13962
2023,Chiapas,07,Pichucalco,07068,17605,18025,35630
2023,Chiapas,07,Pijijiapan,07069,29865,30730,60595
2023,Chiapas,07,Pueblo Nuevo Solistahuacán,07072,17373,18879,36252
2023,Chiapas,07,Rayón,07073,5442,5541,10983
2023,Chiapas,07,Reforma,07074,25672,26132,51804
2023,Chiapas,07,Sabanilla,07076,15285,15104,30389
2023,Chiapas,07,Salto de Agua,07077,35561,35948,71509
2023,Chiapas,07,San Andrés Duraznal,07118,3001,3161,6162
2023,Chiapas,07,San Cristóbal de las Casas,07078,114558,126871,241429
2023,Chiapas,07,San Fernando,07079,22778,22353,45131
2023,Chiapas,07,San Juan Cancuc,07112,19449,20315,39764
2023,Chiapas,07,San Lucas,07110,4093,4113,8206
2023,Chiapas,07,Santiago el Pinar,07119,2077,2034,4111
2023,Chiapas,07,Siltepec,07080,20616,19980,40596
2023,Chiapas,07,Simojovel,07081,24885,25297,50182
2023,Chiapas,07,Sitalá,07082,8111,8193,16304
2023,Chiapas,07,Socoltenango,07083,10410,10493,20903
2023,Chiapas,07,Solosuchiapa,07084,4542,4502,9044
2023,Chiapas,07,Soyaló,07085,6149,6096,12245
2023,Chiapas,07,Suchiapa,07086,13899,13893,27792
2023,Chiapas,07,Suchiate,07087,21479,22417,43896
2023,Chiapas,07,Sunuapa,07088,1372,1337,2709
2023,Chiapas,07,Tapachula,07089,192052,209605,401657
2023,Chiapas,07,Tapalapa,07090,2184,2299,4483
2023,Chiapas,07,Tapilula,07091,7230,7607,14837
2023,Chiapas,07,Tecpatán,07092,23357,23726,47083
2023,Chiapas,07,Tenejapa,07093,24050,25365,49415
2023,Chiapas,07,Teopisca,07094,23970,25352,49322
2023,Chiapas,07,Tila,07096,44667,44527,89194
2023,Chiapas,07,Tonalá,07097,50170,51574,101744
2023,Chiapas,07,Totolapa,07098,4132,4089,8221
2023,Chiapas,07,Tumbalá,07100,18964,19872,38836
2023,Chiapas,07,Tuxtla Chico,07102,23355,24807,48162
2023,Chiapas,07,Tuxtla Gutiérrez,07101,327867,361709,689576
2023,Chiapas,07,Tuzantán,07103,18082,18627,36709
2023,Chiapas,07,Tzimol,07104,8602,9022,17624
2023,Chiapas,07,Unión Juárez,07105,8525,9013,17538
2023,Chiapas,07,Venustiano Carranza,07106,36622,36991,73613
2023,Chiapas,07,Villa Comaltitlán,07071,16125,16535,32660
2023,Chiapas,07,Villa Corzo,07107,43641,45278,88919
2023,Chiapas,07,Villaflores,07108,58852,61517,120369
2023,Chiapas,07,Yajalón,07109,21241,22219,43460
2023,Chiapas,07,Zinacantán,07111,21843,24864,46707
2023,Chihuahua,08,Ahumada,08001,6706,6577,13283
2023,Chihuahua,08,Aldama,08002,13514,13663,27177
2023,Chihuahua,08,Allende,08003,4984,4869,9853
2023,Chihuahua,08,Aquiles Serdán,08004,10346,9801,20147
2023,Chihuahua,08,Ascensión,08005,13656,13343,26999
2023,Chihuahua,08,Bachíniva,08006,3604,3462,7066
2023,Chihuahua,08,Balleza,08007,9197,8933,18130
2023,Chihuahua,08,Batopilas,08008,6443,6479,12922
2023,Chihuahua,08,Bocoyna,08009,14773,15435,30208
2023,Chihuahua,08,Buenaventura,08010,13006,12755,25761
2023,Chihuahua,08,Camargo,08011,28058,29137,57195
2023,Chihuahua,08,Carichí,08012,5312,5235,10547
2023,Chihuahua,08,Casas Grandes,08013,6491,6208,12699
2023,Chihuahua,08,Chihuahua,08019,477820,503939,981759
2023,Chihuahua,08,Chínipas,08020,4591,4162,8753
2023,Chihuahua,08,Coronado,08014,1291,1188,2479
2023,Chihuahua,08,Coyame del Sotol,08015,1055,864,1919
2023,Chihuahua,08,Cuauhtémoc,08017,91456,97336,188792
2023,Chihuahua,08,Cusihuiriachi,08018,2725,2529,5254
2023,Chihuahua,08,Delicias,08021,81124,85149,166273
2023,Chihuahua,08,Dr. Belisario Domínguez,08022,1488,1449,2937
2023,Chihuahua,08,El Tule,08064,964,932,1896
2023,Chihuahua,08,Galeana,08023,3671,3667,7338
2023,Chihuahua,08,Gran Morelos,08026,1477,1417,2894
2023,Chihuahua,08,Guachochi,08027,24759,25993,50752
2023,Chihuahua,08,Guadalupe,08028,2372,2440,4812
2023,Chihuahua,08,Guadalupe y Calvo,08029,30114,29519,59633
2023,Chihuahua,08,Guazapares,08030,4515,4307,8822
2023,Chihuahua,08,Guerrero,08031,22096,21785,43881
2023,Chihuahua,08,Gómez Farías,08025,5035,5013,10048
2023,Chihuahua,08,Hidalgo del Parral,08032,58571,62363,120934
2023,Chihuahua,08,Huejotitán,08033,562,560,1122
2023,Chihuahua,08,Ignacio Zaragoza,08034,3936,3870,7806
2023,Chihuahua,08,Janos,08035,6402,5851,12253
2023,Chihuahua,08,Jiménez,08036,23336,23721,47057
2023,Chihuahua,08,Julimes,08038,2582,2494,5076
2023,Chihuahua,08,Juárez,08037,743809,745698,1489507
2023,Chihuahua,08,La Cruz,08016,2257,2138,4395
2023,Chihuahua,08,López,08039,2341,2177,4518
2023,Chihuahua,08,Madera,08040,15883,15707,31590
2023,Chihuahua,08,Maguarichi,08041,885,837,1722
2023,Chihuahua,08,Manuel Benavides,08042,888,751,1639
2023,Chihuahua,08,Matachí,08043,1738,1712,3450
2023,Chihuahua,08,Matamoros,08044,2579,2479,5058
2023,Chihuahua,08,Meoqui,08045,24600,25109,49709
2023,Chihuahua,08,Morelos,08046,4206,4125,8331
2023,Chihuahua,08,Moris,08047,2919,2739,5658
2023,Chihuahua,08,Namiquipa,08048,13810,13151,26961
2023,Chihuahua,08,Nonoava,08049,1502,1421,2923
2023,Chihuahua,08,Nuevo Casas Grandes,08050,34005,35527,69532
2023,Chihuahua,08,Ocampo,08051,4278,3955,8233
2023,Chihuahua,08,Ojinaga,08052,15745,15558,31303
2023,Chihuahua,08,Praxedis G. Guerrero,08053,2508,2477,4985
2023,Chihuahua,08,Riva Palacio,08054,4308,4151,8459
2023,Chihuahua,08,Rosales,08055,9585,9417,19002
2023,Chihuahua,08,Rosario,08056,1163,1108,2271
2023,Chihuahua,08,San Francisco de Borja,08057,1335,1254,2589
2023,Chihuahua,08,San Francisco de Conchos,08058,1515,1413,2928
2023,Chihuahua,08,San Francisco del Oro,08059,2930,2911,5841
2023,Chihuahua,08,Santa Bárbara,08060,6007,6095,12102
2023,Chihuahua,08,Santa Isabel,08024,2203,2255,4458
2023,Chihuahua,08,Satevó,08061,1795,1689,3484
2023,Chihuahua,08,Saucillo,08062,17752,17539,35291
2023,Chihuahua,08,Temósachic,08063,3750,3584,7334
2023,Chihuahua,08,Urique,08065,11599,11244,22843
2023,Chihuahua,08,Uruachi,08066,3363,3206,6569
2023,Chihuahua,08,Valle de Zaragoza,08067,3051,2916,5967
2023,Ciudad de México,09,Azcapotzalco,09002,190482,215299,405781
2023,Ciudad de México,09,Benito Juárez,09014,203362,238239,441601
2023,Ciudad de México,09,Coyoacán,09003,290025,328441,618466
2023,Ciudad de México,09,Cuajimalpa de Morelos,09004,95758,103417,199175
2023,Ciudad de México,09,Cuauhtémoc,09015,261211,289259,550470
2023,Ciudad de México,09,Gustavo A. Madero,09005,560140,607801,1167941
2023,Ciudad de México,09,Iztacalco,09006,185736,206705,392441
2023,Ciudad de México,09,Iztapalapa,09007,867546,921639,1789185
2023,Ciudad de México,09,La Magdalena Contreras,09008,117130,126420,243550
2023,Ciudad de México,09,Miguel Hidalgo,09016,176556,205251,381807
2023,Ciudad de México,09,Milpa Alta,09009,67834,70919,138753
2023,Ciudad de México,09,Tlalpan,09012,325310,354691,680001
2023,Ciudad de México,09,Tláhuac,09011,174278,187582,361860
2023,Ciudad de México,09,Venustiano Carranza,09017,202831,228548,431379
2023,Ciudad de México,09,Xochimilco,09013,201855,210493,412348
2023,Ciudad de México,09,Álvaro Obregón,09010,358915,393885,752800
2023,Coahuila,05,Abasolo,05001,595,591,1186
2023,Coahuila,05,Acuña,05002,84093,83391,167484
2023,Coahuila,05,Allende,05003,12602,12905,25507
2023,Coahuila,05,Arteaga,05004,13564,12939,26503
2023,Coahuila,05,Candela,05005,1065,962,2027
2023,Coahuila,05,Castaños,05006,15944,15883,31827
2023,Coahuila,05,Cuatro Ciénegas,05007,7662,7500,15162
2023,Coahuila,05,Escobedo,05008,1787,1706,3493
2023,Coahuila,05,Francisco I. Madero,05009,33639,33683,67322
2023,Coahuila,05,Frontera,05010,45914,45394,91308
2023,Coahuila,05,General Cepeda,05011,7337,6735,14072
2023,Coahuila,05,Guerrero,05012,1067,953,2020
2023,Coahuila,05,Hidalgo,05013,990,945,1935
2023,Coahuila,05,Jiménez,05014,5735,5556,11291
2023,Coahuila,05,Juárez,05015,933,854,1787
2023,Coahuila,05,Lamadrid,05016,1074,1005,2079
2023,Coahuila,05,Matamoros,05017,61935,61708,123643
2023,Coahuila,05,Monclova,05018,129776,131346,261122
2023,Coahuila,05,Morelos,05019,4983,4845,9828
2023,Coahuila,05,Múzquiz,05020,39789,38862,78651
2023,Coahuila,05,Nadadores,05021,3734,3683,7417
2023,Coahuila,05,Nava,05022,17572,16663,34235
2023,Coahuila,05,Ocampo,05023,6094,5649,11743
2023,Coahuila,05,Parras,05024,25555,24419,49974
2023,Coahuila,05,Piedras Negras,05025,91967,91041,183008
2023,Coahuila,05,Progreso,05026,1959,1821,3780
2023,Coahuila,05,Ramos Arizpe,05027,55712,53431,109143
2023,Coahuila,05,Sabinas,05028,36266,36034,72300
2023,Coahuila,05,Sacramento,05029,1381,1340,2721
2023,Coahuila,05,Saltillo,05030,450893,453345,904238
2023,Coahuila,05,San Buenaventura,05031,13506,13479,26985
2023,Coahuila,05,San Juan de Sabinas,05032,24135,25049,49184
2023,Coahuila,05,San Pedro,05033,61266,61355,122621
2023,Coahuila,05,Sierra Mojada,05034,4295,3966,8261
2023,Coahuila,05,Torreón,05035,378528,395745,774273
2023,Coahuila,05,Viesca,05036,12645,12154,24799
2023,Coahuila,05,Villa Unión,05037,3627,3436,7063
2023,Coahuila,05,Zaragoza,05038,7346,7283,14629
2023,Colima,06,Armería,06001,17047,16732,33779
2023,Colima,06,Colima,06002,86149,90748,176897
2023,Colima,06,Comala,06003,12536,12327,24863
2023,Colima,06,Coquimatlán,06004,11682,11391,23073
2023,Colima,06,Cuauhtémoc,06005,17297,17065,34362
2023,Colima,06,Ixtlahuacán,06006,3217,3146,6363
2023,Colima,06,Manzanillo,06007,107842,105274,213116
2023,Colima,06,Minatitlán,06008,5271,4827,10098
2023,Colima,06,Tecomán,06009,70986,69457,140443
2023,Colima,06,Villa de Álvarez,06010,77071,80706,157777
2023,Durango,10,Canatlán,10001,17620,18051,35671
2023,Durango,10,Canelas,10002,2573,2343,4916
2023,Durango,10,Coneto de Comonfort,10003,2352,2384,4736
2023,Durango,10,Cuencamé,10004,19356,19025,38381
2023,Durango,10,Durango,10005,345720,369127,714847
2023,Durango,10,El Oro,10018,6312,6369,12681
2023,Durango,10,General Simón Bolívar,10006,5466,5581,11047
2023,Durango,10,Guadalupe Victoria,10008,19171,19499,38670
2023,Durango,10,Guanaceví,10009,5508,5161,10669
2023,Durango,10,Gómez Palacio,10007,187019,190863,377882
2023,Durango,10,Hidalgo,10010,2150,2089,4239
2023,Durango,10,Indé,10011,2808,2785,5593
2023,Durango,10,Lerdo,10012,84113,84931,169044
2023,Durango,10,Mapimí,10013,14542,14519,29061
2023,Durango,10,Mezquital,10014,20413,21051,41464
2023,Durango,10,Nazas,10015,7117,7145,14262
2023,Durango,10,Nombre de Dios,10016,10706,10770,21476
2023,Durango,10,Nuevo Ideal,10039,14732,14873,29605
2023,Durango,10,Ocampo,10017,5448,5225,10673
2023,Durango,10,Otáez,10019,2896,2670,5566
2023,Durango,10,Peñón Blanco,10021,5941,5870,11811
2023,Durango,10,Poanas,10022,13610,13956,27566
2023,Durango,10,Pueblo Nuevo,10023,26654,26866,53520
2023,Durango,10,Pánuco de Coronado,10020,6510,6688,13198
2023,Durango,10,Rodeo,10024,7470,7421,14891
2023,Durango,10,San Bernardo,10025,1877,1670,3547
2023,Durango,10,San Dimas,10026,10456,9813,20269
2023,Durango,10,San Juan de Guadalupe,10027,2956,3056,6012
2023,Durango,10,San Juan del Río,10028,6778,6943,13721
2023,Durango,10,San Luis del Cordero,10029,1176,1138,2314
2023,Durango,10,San Pedro del Gallo,10030,875,806,1681
2023,Durango,10,Santa Clara,10031,3845,3847,7692
2023,Durango,10,Santiago Papasquiaro,10032,26184,26170,52354
2023,Durango,10,Súchil,10033,3266,3559,6825
2023,Durango,10,Tamazula,10034,14271,13073,27344
2023,Durango,10,Tepehuanes,10035,5858,5875,11733
2023,Durango,10,Tlahualilo,10036,13084,12802,25886
2023,Durango,10,Topia,10037,5237,4891,10128
2023,Durango,10,Vicente Guerrero,10038,11507,12211,23718
2023,Estado de México,15,Acambay de Ruíz Castañeda,15001,34681,36773,71454
2023,Estado de México,15,Acolman,15002,98252,97824,196076
2023,Estado de México,15,Aculco,15003,26588,27195,53783
2023,Estado de México,15,Almoloya de Alquisiras,15004,7618,8273,15891
2023,Estado de México,15,Almoloya de Juárez,15005,96730,98591,195321
2023,Estado de México,15,Almoloya del Río,15006,6078,6495,12573
2023,Estado de México,15,Amanalco,15007,12997,13510,26507
2023,Estado de México,15,Amatepec,15008,14149,14970,29119
2023,Estado de México,15,Amecameca,15009,27005,28852,55857
2023,Estado de México,15,Apaxco,15010,16041,16432,32473
2023,Estado de México,15,Atenco,15011,36084,36821,72905
2023,Estado de México,15,Atizapán,15012,6278,6632,12910
2023,Estado de México,15,Atizapán de Zaragoza,15013,276437,292884,569321
2023,Estado de México,15,Atlacomulco,15014,53103,57539,110642
2023,Estado de México,15,Atlautla,15015,16514,17226,33740
2023,Estado de México,15,Axapusco,15016,15491,15655,31146
2023,Estado de México,15,Ayapango,15017,5684,5902,11586
2023,Estado de México,15,Calimaya,15018,30681,32114,62795
2023,Estado de México,15,Capulhuac,15019,19039,20159,39198
2023,Estado de México,15,Chalco,15025,205420,213800,419220
2023,Estado de México,15,Chapa de Mota,15026,15324,15928,31252
2023,Estado de México,15,Chapultepec,15027,6719,6921,13640
2023,Estado de México,15,Chiautla,15028,16258,16804,33062
2023,Estado de México,15,Chicoloapan,15029,114753,121684,236437
2023,Estado de México,15,Chiconcuac,15030,14132,14487,28619
2023,Estado de México,15,Chimalhuacán,15031,362005,374410,736415
2023,Estado de México,15,Coacalco de Berriozábal,15020,152135,163966,316101
2023,Estado de México,15,Coatepec Harinas,15021,20704,22198,42902
2023,Estado de México,15,Cocotitlán,15022,7787,8154,15941
2023,Estado de México,15,Coyotepec,15023,22276,22711,44987
2023,Estado de México,15,Cuautitlán,15024,90022,92036,182058
2023,Estado de México,15,Cuautitlán Izcalli,15121,288034,302959,590993
2023,Estado de México,15,Donato Guerra,15032,18171,18767,36938
2023,Estado de México,15,Ecatepec de Morelos,15033,858613,880811,1739424
2023,Estado de México,15,Ecatzingo,15034,5080,5237,10317
2023,Estado de México,15,El Oro,15064,19755,20969,40724
2023,Estado de México,15,Huehuetoca,15035,76822,78807,155629
2023,Estado de México,15,Hueypoxtla,15036,24351,23879,48230
2023,Estado de México,15,Huixquilucan,15037,144786,155083,299869
2023,Estado de México,15,Isidro Fabela,15038,6414,6517,12931
2023,Estado de México,15,Ixtapaluca,15039,278042,288404,566446
2023,Estado de México,15,Ixtapan de la Sal,15040,19048,20416,39464
2023,Estado de México,15,Ixtapan del Oro,15041,3790,3691,7481
2023,Estado de México,15,Ixtlahuaca,15042,81273,86888,168161
2023,Estado de México,15,Jaltenco,15044,14327,15205,29532
2023,Estado de México,15,Jilotepec,15045,48188,49745,97933
2023,Estado de México,15,Jilotzingo,15046,10382,10944,21326
2023,Estado de México,15,Jiquipilco,15047,39642,42098,81740
2023,Estado de México,15,Jocotitlán,15048,35095,37533,72628
2023,Estado de México,15,Joquicingo,15049,7412,7725,15137
2023,Estado de México,15,Juchitepec,15050,13847,14226,28073
2023,Estado de México,15,La Paz,15070,157452,161286,318738
2023,Estado de México,15,Lerma,15051,81929,84064,165993
2023,Estado de México,15,Luvianos,15123,15154,15329,30483
2023,Estado de México,15,Malinalco,15052,15029,15434,30463
2023,Estado de México,15,Melchor Ocampo,15053,31197,32482,63679
2023,Estado de México,15,Metepec,15054,122493,130078,252571
2023,Estado de México,15,Mexicaltzingo,15055,6888,7327,14215
2023,Estado de México,15,Morelos,15056,15700,17012,32712
2023,Estado de México,15,Naucalpan de Juárez,15057,454105,480452,934557
2023,Estado de México,15,Nextlalpan,15059,22606,23043,45649
2023,Estado de México,15,Nezahualcóyotl,15058,559287,601644,1160931
2023,Estado de México,15,Nicolás Romero,15060,224014,232997,457011
2023,Estado de México,15,Nopaltepec,15061,4982,5007,9989
2023,Estado de México,15,Ocoyoacac,15062,36454,37612,74066
2023,Estado de México,15,Ocuilan,15063,18537,19253,37790
2023,Estado de México,15,Otumba,15065,19807,19493,39300
2023,Estado de México,15,Otzoloapan,15066,2127,2079,4206
2023,Estado de México,15,Otzolotepec,15067,46237,47323,93560
2023,Estado de México,15,Ozumba,15068,15452,16645,32097
2023,Estado de México,15,Papalotla,15069,2173,2285,4458
2023,Estado de México,15,Polotitlán,15071,7637,7951,15588
2023,Estado de México,15,Rayón,15072,7447,7669,15116
2023,Estado de México,15,San Antonio la Isla,15073,16541,16942,33483
2023,Estado de México,15,San Felipe del Progreso,15074,66396,74333,140729
2023,Estado de México,15,San José del Rincón,15124,49862,50705,100567
2023,Estado de México,15,San Martín de las Pirámides,15075,14890,15235,30125
2023,Estado de México,15,San Mateo Atenco,15076,40684,42045,82729
2023,Estado de México,15,San Simón de Guerrero,15077,3254,3453,6707
2023,Estado de México,15,Santo Tomás,15078,5191,5328,10519
2023,Estado de México,15,Soyaniquilpan de Juárez,15079,7365,7512,14877
2023,Estado de México,15,Sultepec,15080,13665,15187,28852
2023,Estado de México,15,Tecámac,15081,257281,269342,526623
2023,Estado de México,15,Tejupilco,15082,38980,42153,81133
2023,Estado de México,15,Temamatla,15083,6839,7268,14107
2023,Estado de México,15,Temascalapa,15084,21434,21432,42866
2023,Estado de México,15,Temascalcingo,15085,33005,35801,68806
2023,Estado de México,15,Temascaltepec,15086,17215,17890,35105
2023,Estado de México,15,Temoaya,15087,54988,57985,112973
2023,Estado de México,15,Tenancingo,15088,52894,55812,108706
2023,Estado de México,15,Tenango del Aire,15089,6864,7015,13879
2023,Estado de México,15,Tenango del Valle,15090,46560,48356,94916
2023,Estado de México,15,Teoloyucan,15091,34450,35123,69573
2023,Estado de México,15,Teotihuacán,15092,30875,31852,62727
2023,Estado de México,15,Tepetlaoxtoc,15093,16941,17239,34180
2023,Estado de México,15,Tepetlixpa,15094,10737,11009,21746
2023,Estado de México,15,Tepotzotlán,15095,53202,54985,108187
2023,Estado de México,15,Tequixquiac,15096,20348,20548,40896
2023,Estado de México,15,Texcaltitlán,15097,10038,10672,20710
2023,Estado de México,15,Texcalyacac,15098,2898,2975,5873
2023,Estado de México,15,Texcoco,15099,130613,138454,269067
2023,Estado de México,15,Tezoyuca,15100,24278,24512,48790
2023,Estado de México,15,Tianguistenco,15101,41329,43547,84876
2023,Estado de México,15,Timilpan,15102,8285,8965,17250
2023,Estado de México,15,Tlalmanalco,15103,25418,27309,52727
2023,Estado de México,15,Tlalnepantla de Baz,15104,377729,403253,780982
2023,Estado de México,15,Tlatlaya,15105,19028,19744,38772
2023,Estado de México,15,Toluca,15106,472495,505255,977750
2023,Estado de México,15,Tonanitla,15125,5478,5616,11094
2023,Estado de México,15,Tonatico,15107,6810,7230,14040
2023,Estado de México,15,Tultepec,15108,81571,84601,166172
2023,Estado de México,15,Tultitlán,15109,278412,288746,567158
2023,Estado de México,15,Valle de Bravo,15110,35238,36563,71801
2023,Estado de México,15,Valle de Chalco Solidaridad,15122,212120,219227,431347
2023,Estado de México,15,Villa Guerrero,15113,36549,37569,74118
2023,Estado de México,15,Villa Victoria,15114,56740,57394,114134
2023,Estado de México,15,Villa de Allende,15111,27585,28673,56258
2023,Estado de México,15,Villa del Carbón,15112,26149,25850,51999
2023,Estado de México,15,Xalatlaco,15043,16253,17112,33365
2023,Estado de México,15,Xonacatlán,15115,28055,27802,55857
2023,Estado de México,15,Zacazonapan,15116,2224,2202,4426
2023,Estado de México,15,Zacualpan,15117,7874,8644,16518
2023,Estado de México,15,Zinacantepec,15118,103314,106028,209342
2023,Estado de México,15,Zumpahuacán,15119,8753,9537,18290
2023,Estado de México,15,Zumpango,15120,109863,117224,227087
2023,Guanajuato,11,Abasolo,11001,47491,50328,97819
2023,Guanajuato,11,Acámbaro,11002,58732,63309,122041
2023,Guanajuato,11,Apaseo el Alto,11004,36030,37723,73753
2023,Guanajuato,11,Apaseo el Grande,11005,49488,52406,101894
2023,Guanajuato,11,Atarjea,11006,2780,2884,5664
2023,Guanajuato,11,Celaya,11007,264301,279269,543570
2023,Guanajuato,11,Comonfort,11009,42219,46803,89022
2023,Guanajuato,11,Coroneo,11010,6297,7029,13326
2023,Guanajuato,11,Cortazar,11011,50469,53289,103758
2023,Guanajuato,11,Cuerámaro,11012,14789,15892,30681
2023,Guanajuato,11,Doctor Mora,11013,12563,13506,26069
2023,Guanajuato,11,Dolores Hidalgo Cuna de la Independencia Nacional,11014,77250,86082,163332
2023,Guanajuato,11,Guanajuato,11015,99556,103675,203231
2023,Guanajuato,11,Huanímaro,11016,11004,12163,23167
2023,Guanajuato,11,Irapuato,11017,305732,320825,626557
2023,Guanajuato,11,Jaral del Progreso,11018,20882,21478,42360
2023,Guanajuato,11,Jerécuaro,11019,24267,27769,52036
2023,Guanajuato,11,León,11020,853953,866801,1720754
2023,Guanajuato,11,Manuel Doblado,11008,19894,21636,41530
2023,Guanajuato,11,Moroleón,11021,26748,29140,55888
2023,Guanajuato,11,Ocampo,11022,12247,13038,25285
2023,Guanajuato,11,Pueblo Nuevo,11024,6189,6838,13027
2023,Guanajuato,11,Purísima del Rincón,11025,44570,44359,88929
2023,Guanajuato,11,Pénjamo,11023,78051,85090,163141
2023,Guanajuato,11,Romita,11026,31107,32749,63856
2023,Guanajuato,11,Salamanca,11027,146779,154215,300994
2023,Guanajuato,11,Salvatierra,11028,52444,57401,109845
2023,Guanajuato,11,San Diego de la Unión,11029,19798,22714,42512
2023,Guanajuato,11,San Felipe,11030,58756,62204,120960
2023,Guanajuato,11,San Francisco del Rincón,11031,62606,65600,128206
2023,Guanajuato,11,San José Iturbide,11032,41703,44137,85840
2023,Guanajuato,11,San Luis de la Paz,11033,62015,68148,130163
2023,Guanajuato,11,San Miguel de Allende,11003,90350,97500,187850
2023,Guanajuato,11,Santa Catarina,11034,2723,2992,5715
2023,Guanajuato,11,Santa Cruz de Juventino Rosas,11035,43796,46875,90671
2023,Guanajuato,11,Santiago Maravatío,11036,3633,3979,7612
2023,Guanajuato,11,Silao de la Victoria,11037,102058,104483,206541
2023,Guanajuato,11,Tarandacuao,11038,6395,7012,13407
2023,Guanajuato,11,Tarimoro,11039,18202,19090,37292
2023,Guanajuato,11,Tierra Blanca,11040,10024,10697,20721
2023,Guanajuato,11,Uriangato,11041,33434,35557,68991
2023,Guanajuato,11,Valle de Santiago,11042,74954,82046,157000
2023,Guanajuato,11,Victoria,11043,10410,11581,21991
2023,Guanajuato,11,Villagrán,11044,31553,32831,64384
2023,Guanajuato,11,Xichú,11045,6007,6564,12571
2023,Guanajuato,11,Yuriria,11046,36089,39632,75721
2023,Guerrero,12,Acapulco de Juárez,12001,408469,440178,848647
2023,Guerrero,12,Acatepec,12076,18912,19810,38722
2023,Guerrero,12,Ahuacuotzingo,12002,12930,14690,27620
2023,Guerrero,12,Ajuchitlán del Progreso,12003,18828,20021,38849
2023,Guerrero,12,Alcozauca de Guerrero,12004,9511,10839,20350
2023,Guerrero,12,Alpoyeca,12005,3320,3709,7029
2023,Guerrero,12,Apaxtla,12006,5629,6097,11726
2023,Guerrero,12,Arcelia,12007,15812,16794,32606
2023,Guerrero,12,Atenango del Río,12008,4324,4691,9015
2023,Guerrero,12,Atlamajalcingo del Monte,12009,2455,2740,5195
2023,Guerrero,12,Atlixtac,12010,13693,14618,28311
2023,Guerrero,12,Atoyac de Álvarez,12011,30875,31989,62864
2023,Guerrero,12,Ayutla de los Libres,12012,34614,36144,70758
2023,Guerrero,12,Azoyú,12013,6213,6599,12812
2023,Guerrero,12,Benito Juárez,12014,7859,8274,16133
2023,Guerrero,12,Buenavista de Cuéllar,12015,6767,7104,13871
2023,Guerrero,12,Chilapa de Álvarez,12028,63955,70935,134890
2023,Guerrero,12,Chilpancingo de los Bravo,12029,138297,150746,289043
2023,Guerrero,12,Coahuayutla de José María Izazaga,12016,6412,6102,12514
2023,Guerrero,12,Cochoapa el Grande,12078,9123,10068,19191
2023,Guerrero,12,Cocula,12017,6802,7285,14087
2023,Guerrero,12,Copala,12018,7282,7539,14821
2023,Guerrero,12,Copalillo,12019,7205,7924,15129
2023,Guerrero,12,Copanatoyac,12020,10006,10979,20985
2023,Guerrero,12,Coyuca de Benítez,12021,39079,40526,79605
2023,Guerrero,12,Coyuca de Catalán,12022,20403,19785,40188
2023,Guerrero,12,Cuajinicuilapa,12023,14158,14061,28219
2023,Guerrero,12,Cualác,12024,3805,4077,7882
2023,Guerrero,12,Cuautepec,12025,8289,8359,16648
2023,Guerrero,12,Cuetzala del Progreso,12026,4379,4606,8985
2023,Guerrero,12,Cutzamala de Pinzón,12027,10067,10403,20470
2023,Guerrero,12,Eduardo Neri,12075,26343,27470,53813
2023,Guerrero,12,Florencio Villarreal,12030,10716,10966,21682
2023,Guerrero,12,General Canuto A. Neri,12031,2864,3089,5953
2023,Guerrero,12,General Heliodoro Castillo,12032,18913,18896,37809
2023,Guerrero,12,Huamuxtitlán,12033,7496,8434,15930
2023,Guerrero,12,Huitzuco de los Figueroa,12034,18791,20307,39098
2023,Guerrero,12,Iguala de la Independencia,12035,77345,82982,160327
2023,Guerrero,12,Igualapa,12036,5726,5920,11646
2023,Guerrero,12,Iliatenco,12081,5403,5960,11363
2023,Guerrero,12,Ixcateopan de Cuauhtémoc,12037,3092,3409,6501
2023,Guerrero,12,José Joaquín de Herrera,12079,8939,9105,18044
2023,Guerrero,12,Juan R. Escudero,12039,12621,13310,25931
2023,Guerrero,12,Juchitán,12080,4047,3963,8010
2023,Guerrero,12,La Unión de Isidoro Montes de Oca,12068,13841,13227,27068
2023,Guerrero,12,Leonardo Bravo,12040,13392,13666,27058
2023,Guerrero,12,Malinaltepec,12041,13084,14774,27858
2023,Guerrero,12,Marquelia,12077,7157,7242,14399
2023,Guerrero,12,Metlatónoc,12043,8651,9981,18632
2023,Guerrero,12,Mochitlán,12044,6587,6865,13452
2023,Guerrero,12,Mártir de Cuilapan,12042,9360,10275,19635
2023,Guerrero,12,Olinalá,12045,12782,13802,26584
2023,Guerrero,12,Ometepec,12046,34484,36259,70743
2023,Guerrero,12,Pedro Ascencio Alquisiras,12047,3266,3791,7057
2023,Guerrero,12,Petatlán,12048,22444,22888,45332
2023,Guerrero,12,Pilcaya,12049,6547,6939,13486
2023,Guerrero,12,Pungarabato,12050,18766,19969,38735
2023,Guerrero,12,Quechultenango,12051,18167,19018,37185
2023,Guerrero,12,San Luis Acatlán,12052,22238,22880,45118
2023,Guerrero,12,San Marcos,12053,25229,26028,51257
2023,Guerrero,12,San Miguel Totolapan,12054,13825,14368,28193
2023,Guerrero,12,Taxco de Alarcón,12055,54371,59219,113590
2023,Guerrero,12,Tecoanapa,12056,23554,24244,47798
2023,Guerrero,12,Teloloapan,12058,28273,31709,59982
2023,Guerrero,12,Tepecoacuilco de Trujano,12059,16110,17419,33529
2023,Guerrero,12,Tetipac,12060,7340,7759,15099
2023,Guerrero,12,Tixtla de Guerrero,12061,21635,23427,45062
2023,Guerrero,12,Tlacoachistlahuaca,12062,11570,13056,24626
2023,Guerrero,12,Tlacoapa,12063,5026,5551,10577
2023,Guerrero,12,Tlalchapa,12064,6506,6486,12992
2023,Guerrero,12,Tlalixtaquilla de Maldonado,12065,3713,4016,7729
2023,Guerrero,12,Tlapa de Comonfort,12066,45148,50137,95285
2023,Guerrero,12,Tlapehuala,12067,10997,11783,22780
2023,Guerrero,12,Técpan de Galeana,12057,33687,34177,67864
2023,Guerrero,12,Xalpatláhuac,12069,5625,6604,12229
2023,Guerrero,12,Xochihuehuetlán,12070,3495,3952,7447
2023,Guerrero,12,Xochistlahuaca,12071,14773,15676,30449
2023,Guerrero,12,Zapotitlán Tablas,12072,6317,6964,13281
2023,Guerrero,12,Zihuatanejo de Azueta,12038,65165,66885,132050
2023,Guerrero,12,Zirándaro,12073,9210,8791,18001
2023,Guerrero,12,Zitlala,12074,11396,12767,24163
2023,Hidalgo,13,Acatlán,13001,10930,11732,22662
2023,Hidalgo,13,Acaxochitlán,13002,22827,24725,47552
2023,Hidalgo,13,Actopan,13003,30006,33224,63230
2023,Hidalgo,13,Agua Blanca de Iturbide,13004,4707,5231,9938
2023,Hidalgo,13,Ajacuba,13005,10060,10484,20544
2023,Hidalgo,13,Alfajayucan,13006,11147,11815,22962
2023,Hidalgo,13,Almoloya,13007,6716,6797,13513
2023,Hidalgo,13,Apan,13008,23712,25727,49439
2023,Hidalgo,13,Atitalaquia,13010,16489,16840,33329
2023,Hidalgo,13,Atlapexco,13011,10713,11567,22280
2023,Hidalgo,13,Atotonilco de Tula,13013,20787,21957,42744
2023,Hidalgo,13,Atotonilco el Grande,13012,14370,16011,30381
2023,Hidalgo,13,Calnali,13014,9270,10009,19279
2023,Hidalgo,13,Cardonal,13015,9829,10688,20517
2023,Hidalgo,13,Chapantongo,13017,7404,7817,15221
2023,Hidalgo,13,Chapulhuacán,13018,13185,13031,26216
2023,Hidalgo,13,Chilcuautla,13019,9964,10308,20272
2023,Hidalgo,13,Cuautepec de Hinojosa,13016,30721,33677,64398
2023,Hidalgo,13,El Arenal,13009,10004,10881,20885
2023,Hidalgo,13,Eloxochitlán,13020,1448,1648,3096
2023,Hidalgo,13,Emiliano Zapata,13021,7755,8599,16354
2023,Hidalgo,13,Epazoyucan,13022,8097,8566,16663
2023,Hidalgo,13,Francisco I. Madero,13023,19260,20975,40235
2023,Hidalgo,13,Huasca de Ocampo,13024,9390,10258,19648
2023,Hidalgo,13,Huautla,13025,11348,12385,23733
2023,Hidalgo,13,Huazalingo,13026,7548,7951,15499
2023,Hidalgo,13,Huehuetla,13027,13583,14507,28090
2023,Hidalgo,13,Huejutla de Reyes,13028,70372,72903,143275
2023,Hidalgo,13,Huichapan,13029,24623,26724,51347
2023,Hidalgo,13,Ixmiquilpan,13030,48639,54430,103069
2023,Hidalgo,13,Jacala de Ledezma,13031,7099,7901,15000
2023,Hidalgo,13,Jaltocán,13032,6523,6706,13229
2023,Hidalgo,13,Juárez Hidalgo,13033,1683,1847,3530
2023,Hidalgo,13,La Misión,13040,5514,5680,11194
2023,Hidalgo,13,Lolotla,13034,5097,5361,10458
2023,Hidalgo,13,Metepec,13035,6019,6834,12853
2023,Hidalgo,13,Metztitlán,13037,10808,11981,22789
2023,Hidalgo,13,Mineral de la Reforma,13051,93919,102992,196911
2023,Hidalgo,13,Mineral del Chico,13038,4893,5185,10078
2023,Hidalgo,13,Mineral del Monte,13039,7784,8517,16301
2023,Hidalgo,13,Mixquiahuala de Juárez,13041,24878,26801,51679
2023,Hidalgo,13,Molango de Escamilla,13042,6326,6595,12921
2023,Hidalgo,13,Nicolás Flores,13043,3586,4043,7629
2023,Hidalgo,13,Nopala de Villagrán,13044,9190,9519,18709
2023,Hidalgo,13,Omitlán de Juárez,13045,5235,5710,10945
2023,Hidalgo,13,Pachuca de Soto,13048,136143,149469,285612
2023,Hidalgo,13,Pacula,13047,2552,2939,5491
2023,Hidalgo,13,Pisaflores,13049,9578,9578,19156
2023,Hidalgo,13,Progreso de Obregón,13050,12424,13802,26226
2023,Hidalgo,13,San Agustín Metzquititlán,13036,5116,5560,10676
2023,Hidalgo,13,San Agustín Tlaxiaca,13052,19940,20846,40786
2023,Hidalgo,13,San Bartolo Tutotepec,13053,10156,10420,20576
2023,Hidalgo,13,San Felipe Orizatlán,13046,20859,21699,42558
2023,Hidalgo,13,San Salvador,13054,18978,20303,39281
2023,Hidalgo,13,Santiago Tulantepec de Lugo Guerrero,13056,19799,21621,41420
2023,Hidalgo,13,Santiago de Anaya,13055,9297,9734,19031
2023,Hidalgo,13,Singuilucan,13057,8885,9102,17987
2023,Hidalgo,13,Tasquillo,13058,8266,9728,17994
2023,Hidalgo,13,Tecozautla,13059,20108,21736,41844
2023,Hidalgo,13,Tenango de Doria,13060,9586,10613,20199
2023,Hidalgo,13,Tepeapulco,13061,29334,31211,60545
2023,Hidalgo,13,Tepehuacán de Guerrero,13062,17079,16567,33646
2023,Hidalgo,13,Tepeji del Río de Ocampo,13063,47611,48911,96522
2023,Hidalgo,13,Tepetitlán,13064,5965,6276,12241
2023,Hidalgo,13,Tetepango,13065,6430,6467,12897
2023,Hidalgo,13,Tezontepec de Aldama,13067,29157,29811,58968
2023,Hidalgo,13,Tianguistengo,13068,8091,8450,16541
2023,Hidalgo,13,Tizayuca,13069,71537,73379,144916
2023,Hidalgo,13,Tlahuelilpan,13070,10562,10896,21458
2023,Hidalgo,13,Tlahuiltepa,13071,5619,5663,11282
2023,Hidalgo,13,Tlanalapa,13072,5573,5938,11511
2023,Hidalgo,13,Tlanchinol,13073,21516,21877,43393
2023,Hidalgo,13,Tlaxcoapan,13074,15604,15987,31591
2023,Hidalgo,13,Tolcayuca,13075,8941,9457,18398
2023,Hidalgo,13,Tula de Allende,13076,59577,63025,122602
2023,Hidalgo,13,Tulancingo de Bravo,13077,83049,92067,175116
2023,Hidalgo,13,Villa de Tezontepec,13066,6779,7067,13846
2023,Hidalgo,13,Xochiatipan,13078,10569,11197,21766
2023,Hidalgo,13,Xochicoatlán,13079,4230,4369,8599
2023,Hidalgo,13,Yahualica,13080,13126,13699,26825
2023,Hidalgo,13,Zacualtipán de Ángeles,13081,18642,20347,38989
2023,Hidalgo,13,Zapotlán de Juárez,13082,10081,10889,20970
2023,Hidalgo,13,Zempoala,13083,25874,27363,53237
2023,Hidalgo,13,Zimapán,13084,20273,23536,43809
2023,Jalisco,14,Acatic,14001,11583,12030,23613
2023,Jalisco,14,Acatlán de Juárez,14002,12516,11901,24417
2023,Jalisco,14,Ahualulco de Mercado,14003,12511,12908,25419
2023,Jalisco,14,Amacueca,14004,2923,3060,5983
2023,Jalisco,14,Amatitán,14005,8389,8470,16859
2023,Jalisco,14,Ameca,14006,32850,34147,66997
2023,Jalisco,14,Arandas,14008,39183,42061,81244
2023,Jalisco,14,Atemajac de Brizuela,14010,3619,3660,7279
2023,Jalisco,14,Atengo,14011,3177,2941,6118
2023,Jalisco,14,Atenguillo,14012,2146,2219,4365
2023,Jalisco,14,Atotonilco el Alto,14013,32775,33804,66579
2023,Jalisco,14,Atoyac,14014,4283,4628,8911
2023,Jalisco,14,Autlán de Navarro,14015,33253,34315,67568
2023,Jalisco,14,Ayotlán,14016,20332,21189,41521
2023,Jalisco,14,Ayutla,14017,6875,6846,13721
2023,Jalisco,14,Bolaños,14019,4270,4274,8544
2023,Jalisco,14,Cabo Corrientes,14020,5942,5481,11423
2023,Jalisco,14,Casimiro Castillo,14021,11984,11974,23958
2023,Jalisco,14,Cañadas de Obregón,14117,2253,2344,4597
2023,Jalisco,14,Chapala,14030,27604,28927,56531
2023,Jalisco,14,Chimaltitán,14031,1782,1823,3605
2023,Jalisco,14,Chiquilistlán,14032,3357,3296,6653
2023,Jalisco,14,Cihuatlán,14022,23068,22488,45556
2023,Jalisco,14,Cocula,14024,14313,14991,29304
2023,Jalisco,14,Colotlán,14025,9553,10221,19774
2023,Jalisco,14,Concepción de Buenos Aires,14026,3460,3315,6775
2023,Jalisco,14,Cuautitlán de García Barragán,14027,9904,9640,19544
2023,Jalisco,14,Cuautla,14028,1156,1231,2387
2023,Jalisco,14,Cuquío,14029,9558,10407,19965
2023,Jalisco,14,Degollado,14033,11397,12067,23464
2023,Jalisco,14,Ejutla,14034,1098,1019,2117
2023,Jalisco,14,El Arenal,14009,10806,10910,21716
2023,Jalisco,14,El Grullo,14037,13173,13907,27080
2023,Jalisco,14,El Limón,14054,3050,3048,6098
2023,Jalisco,14,El Salto,14070,103716,104551,208267
2023,Jalisco,14,Encarnación de Díaz,14035,28380,30418,58798
2023,Jalisco,14,Etzatlán,14036,10648,11153,21801
2023,Jalisco,14,Guachinango,14038,2383,2295,4678
2023,Jalisco,14,Guadalajara,14039,742921,786670,1529591
2023,Jalisco,14,Gómez Farías,14079,7633,8128,15761
2023,Jalisco,14,Hostotipaquillo,14040,6076,5246,11322
2023,Jalisco,14,Huejuquilla el Alto,14042,4697,5056,9753
2023,Jalisco,14,Huejúcar,14041,3065,3362,6427
2023,Jalisco,14,Ixtlahuacán de los Membrillos,14044,31369,31933,63302
2023,Jalisco,14,Ixtlahuacán del Río,14045,10139,10748,20887
2023,Jalisco,14,Jalostotitlán,14046,18358,18754,37112
2023,Jalisco,14,Jamay,14047,13664,13641,27305
2023,Jalisco,14,Jesús María,14048,9578,11345,20923
2023,Jalisco,14,Jilotlán de los Dolores,14049,5278,5046,10324
2023,Jalisco,14,Jocotepec,14050,25326,25635,50961
2023,Jalisco,14,Juanacatlán,14051,10011,9979,19990
2023,Jalisco,14,Juchitlán,14052,3018,3182,6200
2023,Jalisco,14,La Barca,14018,34746,36878,71624
2023,Jalisco,14,La Huerta,14043,13694,13170,26864
2023,Jalisco,14,La Manzanilla de la Paz,14057,1998,2143,4141
2023,Jalisco,14,Lagos de Moreno,14053,88360,92013,180373
2023,Jalisco,14,Magdalena,14055,12408,12385,24793
2023,Jalisco,14,Mascota,14058,7946,8206,16152
2023,Jalisco,14,Mazamitla,14059,7417,8029,15446
2023,Jalisco,14,Mexticacán,14060,2530,2952,5482
2023,Jalisco,14,Mezquitic,14061,10379,11006,21385
2023,Jalisco,14,Mixtlán,14062,1953,1921,3874
2023,Jalisco,14,Ocotlán,14063,53454,55226,108680
2023,Jalisco,14,Ojuelos de Jalisco,14064,17009,17856,34865
2023,Jalisco,14,Pihuamo,14065,6202,6100,12302
2023,Jalisco,14,Poncitlán,14066,27914,28627,56541
2023,Jalisco,14,Puerto Vallarta,14067,155938,152257,308195
2023,Jalisco,14,Quitupan,14069,4268,4741,9009
2023,Jalisco,14,San Cristóbal de la Barranca,14071,1597,1601,3198
2023,Jalisco,14,San Diego de Alejandría,14072,3833,4097,7930
2023,Jalisco,14,San Gabriel,14113,8846,9175,18021
2023,Jalisco,14,San Ignacio Cerro Gordo,14125,10059,10667,20726
2023,Jalisco,14,San Juan de los Lagos,14073,37919,38350,76269
2023,Jalisco,14,San Juanito de Escobedo,14007,5162,5088,10250
2023,Jalisco,14,San Julián,14074,8345,9171,17516
2023,Jalisco,14,San Marcos,14075,2102,2053,4155
2023,Jalisco,14,San Martín Hidalgo,14077,14885,15580,30465
2023,Jalisco,14,San Martín de Bolaños,14076,1640,1639,3279
2023,Jalisco,14,San Miguel el Alto,14078,17636,18480,36116
2023,Jalisco,14,San Pedro Tlaquepaque,14098,361647,365023,726670
2023,Jalisco,14,San Sebastián del Oeste,14080,3211,2883,6094
2023,Jalisco,14,Santa María de los Ángeles,14081,1650,1820,3470
2023,Jalisco,14,Santa María del Oro,14056,1119,1107,2226
2023,Jalisco,14,Sayula,14082,19434,20897,40331
2023,Jalisco,14,Tala,14083,44287,44832,89119
2023,Jalisco,14,Talpa de Allende,14084,8302,8171,16473
2023,Jalisco,14,Tamazula de Gordiano,14085,20700,21631,42331
2023,Jalisco,14,Tapalpa,14086,10373,10790,21163
2023,Jalisco,14,Tecalitlán,14087,8873,9268,18141
2023,Jalisco,14,Techaluta de Montenegro,14089,2046,2104,4150
2023,Jalisco,14,Tecolotlán,14088,9543,9535,19078
2023,Jalisco,14,Tenamaxtlán,14090,3839,3823,7662
2023,Jalisco,14,Teocaltiche,14091,21699,23730,45429
2023,Jalisco,14,Teocuitatlán de Corona,14092,5649,5831,11480
2023,Jalisco,14,Tepatitlán de Morelos,14093,75903,78522,154425
2023,Jalisco,14,Tequila,14094,22688,22974,45662
2023,Jalisco,14,Teuchitlán,14095,5265,5444,10709
2023,Jalisco,14,Tizapán el Alto,14096,11317,11857,23174
2023,Jalisco,14,Tlajomulco de Zúñiga,14097,338605,343799,682404
2023,Jalisco,14,Tolimán,14099,5603,5667,11270
2023,Jalisco,14,Tomatlán,14100,19896,18896,38792
2023,Jalisco,14,Tonalá,14101,296457,296693,593150
2023,Jalisco,14,Tonaya,14102,3249,3385,6634
2023,Jalisco,14,Tonila,14103,4343,4360,8703
2023,Jalisco,14,Totatiche,14104,2425,2449,4874
2023,Jalisco,14,Tototlán,14105,12582,12855,25437
2023,Jalisco,14,Tuxcacuesco,14106,2456,2342,4798
2023,Jalisco,14,Tuxcueca,14107,3311,3528,6839
2023,Jalisco,14,Tuxpan,14108,18564,19707,38271
2023,Jalisco,14,Unión de San Antonio,14109,9589,10222,19811
2023,Jalisco,14,Unión de Tula,14110,7171,7634,14805
2023,Jalisco,14,Valle de Guadalupe,14111,3851,3864,7715
2023,Jalisco,14,Valle de Juárez,14112,2947,3102,6049
2023,Jalisco,14,Villa Corona,14114,9770,9995,19765
2023,Jalisco,14,Villa Guerrero,14115,2989,3068,6057
2023,Jalisco,14,Villa Hidalgo,14116,10862,11593,22455
2023,Jalisco,14,Villa Purificación,14068,6187,5731,11918
2023,Jalisco,14,Yahualica de González Gallo,14118,11678,12732,24410
2023,Jalisco,14,Zacoalco de Torres,14119,15548,15758,31306
2023,Jalisco,14,Zapopan,14120,722818,747148,1469966
2023,Jalisco,14,Zapotiltic,14121,15750,16359,32109
2023,Jalisco,14,Zapotitlán de Vadillo,14122,3871,3823,7694
2023,Jalisco,14,Zapotlanejo,14124,36728,37591,74319
2023,Jalisco,14,Zapotlán del Rey,14123,9918,9952,19870
2023,Jalisco,14,Zapotlán el Grande,14023,57058,59916,116974
2023,Michoacán,16,Acuitzio,16001,5910,6348,12258
2023,Michoacán,16,Aguililla,16002,7676,7499,15175
2023,Michoacán,16,Angamacutiro,16004,7757,8536,16293
2023,Michoacán,16,Angangueo,16005,5829,6169,11998
2023,Michoacán,16,Apatzingán,16006,67367,68279,135646
2023,Michoacán,16,Aporo,16007,1694,1805,3499
2023,Michoacán,16,Aquila,16008,13552,13138,26690
2023,Michoacán,16,Ario,16009,19248,20255,39503
2023,Michoacán,16,Arteaga,16010,11485,11597,23082
2023,Michoacán,16,Briseñas,16011,5984,6272,12256
2023,Michoacán,16,Buenavista,16012,25981,24700,50681
2023,Michoacán,16,Carácuaro,16013,4885,4843,9728
2023,Michoacán,16,Charapan,16021,6227,7026,13253
2023,Michoacán,16,Charo,16022,12204,11448,23652
2023,Michoacán,16,Chavinda,16023,5400,5640,11040
2023,Michoacán,16,Cherán,16024,9842,10585,20427
2023,Michoacán,16,Chilchota,16025,20290,21864,42154
2023,Michoacán,16,Chinicuila,16026,2606,2386,4992
2023,Michoacán,16,Chucándiro,16027,2083,2445,4528
2023,Michoacán,16,Churintzio,16028,2593,2899,5492
2023,Michoacán,16,Churumuco,16029,8117,8081,16198
2023,Michoacán,16,Coahuayana,16014,8062,7438,15500
2023,Michoacán,16,Coalcomán de Vázquez Pallares,16015,9147,9332,18479
2023,Michoacán,16,Coeneo,16016,10357,11952,22309
2023,Michoacán,16,Cojumatlán de Régules,16074,5481,5684,11165
2023,Michoacán,16,Contepec,16017,17732,18683,36415
2023,Michoacán,16,Copándaro,16018,4575,5078,9653
2023,Michoacán,16,Cotija,16019,9443,10394,19837
2023,Michoacán,16,Cuitzeo,16020,15249,16775,32024
2023,Michoacán,16,Ecuandureo,16030,6146,7235,13381
2023,Michoacán,16,Epitacio Huerta,16031,8721,9097,17818
2023,Michoacán,16,Erongarícuaro,16032,7939,8526,16465
2023,Michoacán,16,Gabriel Zamora,16033,12170,12218,24388
2023,Michoacán,16,Hidalgo,16034,64002,67149,131151
2023,Michoacán,16,Huandacareo,16036,5993,6812,12805
2023,Michoacán,16,Huaniqueo,16037,4011,4670,8681
2023,Michoacán,16,Huetamo,16038,21044,21985,43029
2023,Michoacán,16,Huiramba,16039,4655,4807,9462
2023,Michoacán,16,Indaparapeo,16040,8695,9152,17847
2023,Michoacán,16,Irimbo,16041,7763,8471,16234
2023,Michoacán,16,Ixtlán,16042,6783,6928,13711
2023,Michoacán,16,Jacona,16043,35903,37908,73811
2023,Michoacán,16,Jiménez,16044,6556,7094,13650
2023,Michoacán,16,Jiquilpan,16045,16793,18429,35222
2023,Michoacán,16,José Sixto Verduzco,16113,13431,14737,28168
2023,Michoacán,16,Jungapeo,16047,11280,11416,22696
2023,Michoacán,16,Juárez,16046,7639,8004,15643
2023,Michoacán,16,La Huacana,16035,18047,18177,36224
2023,Michoacán,16,La Piedad,16069,54059,58773,112832
2023,Michoacán,16,Lagunillas,16048,2954,3031,5985
2023,Michoacán,16,Los Reyes,16075,36776,38397,75173
2023,Michoacán,16,Lázaro Cárdenas,16052,97507,96695,194202
2023,Michoacán,16,Madero,16049,9658,9420,19078
2023,Michoacán,16,Maravatío,16050,45712,49250,94962
2023,Michoacán,16,Marcos Castellanos,16051,7201,7698,14899
2023,Michoacán,16,Morelia,16053,405166,436678,841844
2023,Michoacán,16,Morelos,16054,3604,4313,7917
2023,Michoacán,16,Múgica,16055,24043,24553,48596
2023,Michoacán,16,Nahuatzen,16056,14798,15663,30461
2023,Michoacán,16,Nocupétaro,16057,4297,4343,8640
2023,Michoacán,16,Nuevo Parangaricutiro,16058,10476,10813,21289
2023,Michoacán,16,Nuevo Urecho,16059,4298,4308,8606
2023,Michoacán,16,Numarán,16060,4989,5480,10469
2023,Michoacán,16,Ocampo,16061,12862,12871,25733
2023,Michoacán,16,Pajacuarán,16062,9983,10638,20621
2023,Michoacán,16,Panindícuaro,16063,7959,8906,16865
2023,Michoacán,16,Paracho,16065,19224,20993,40217
2023,Michoacán,16,Parácuaro,16064,14446,14070,28516
2023,Michoacán,16,Penjamillo,16067,8505,9647,18152
2023,Michoacán,16,Peribán,16068,15172,14943,30115
2023,Michoacán,16,Puruándiro,16071,33787,37497,71284
2023,Michoacán,16,Purépero,16070,7981,8314,16295
2023,Michoacán,16,Pátzcuaro,16066,48040,51997,100037
2023,Michoacán,16,Queréndaro,16072,7118,7453,14571
2023,Michoacán,16,Quiroga,16073,14230,15560,29790
2023,Michoacán,16,Sahuayo,16076,40772,42543,83315
2023,Michoacán,16,Salvador Escalante,16079,25704,27095,52799
2023,Michoacán,16,San Lucas,16077,9559,9690,19249
2023,Michoacán,16,Santa Ana Maya,16078,6266,7114,13380
2023,Michoacán,16,Senguio,16080,9871,10499,20370
2023,Michoacán,16,Susupuato,16081,4640,4653,9293
2023,Michoacán,16,Tacámbaro,16082,40766,42519,83285
2023,Michoacán,16,Tancítaro,16083,16887,16395,33282
2023,Michoacán,16,Tangamandapio,16084,15207,16296,31503
2023,Michoacán,16,Tangancícuaro,16085,17509,18548,36057
2023,Michoacán,16,Tanhuato,16086,8092,8471,16563
2023,Michoacán,16,Taretan,16087,7839,7996,15835
2023,Michoacán,16,Tarímbaro,16088,60155,64875,125030
2023,Michoacán,16,Tepalcatepec,16089,12834,12534,25368
2023,Michoacán,16,Tingambato,16090,7888,8325,16213
2023,Michoacán,16,Tingüindín,16091,7574,8154,15728
2023,Michoacán,16,Tiquicheo de Nicolás Romero,16092,7030,7123,14153
2023,Michoacán,16,Tlalpujahua,16093,14637,16232,30869
2023,Michoacán,16,Tlazazalca,16094,3319,3506,6825
2023,Michoacán,16,Tocumbo,16095,6429,6517,12946
2023,Michoacán,16,Tumbiscatío,16096,3488,3357,6845
2023,Michoacán,16,Turicato,16097,16003,16754,32757
2023,Michoacán,16,Tuxpan,16098,13914,14919,28833
2023,Michoacán,16,Tuzantla,16099,7997,8052,16049
2023,Michoacán,16,Tzintzuntzan,16100,7365,8114,15479
2023,Michoacán,16,Tzitzio,16101,4573,4433,9006
2023,Michoacán,16,Uruapan,16102,175623,186493,362116
2023,Michoacán,16,Venustiano Carranza,16103,13137,13611,26748
2023,Michoacán,16,Villamar,16104,8548,9203,17751
2023,Michoacán,16,Vista Hermosa,16105,10927,11320,22247
2023,Michoacán,16,Yurécuaro,16106,16519,17341,33860
2023,Michoacán,16,Zacapu,16107,39075,42027,81102
2023,Michoacán,16,Zamora,16108,103212,108979,212191
2023,Michoacán,16,Zinapécuaro,16110,24179,26102,50281
2023,Michoacán,16,Zináparo,16109,1591,1847,3438
2023,Michoacán,16,Ziracuaretiro,16111,9279,9441,18720
2023,Michoacán,16,Zitácuaro,16112,83739,91317,175056
2023,Michoacán,16,Álvaro Obregón,16003,11366,12078,23444
2023,Morelos,17,Amacuzac,17001,9480,9904,19384
2023,Morelos,17,Atlatlahucan,17002,12383,12813,25196
2023,Morelos,17,Axochiapan,17003,19507,19891,39398
2023,Morelos,17,Ayala,17004,45449,48374,93823
2023,Morelos,17,Coatlán del Río,17005,5366,5485,10851
2023,Morelos,17,Cuautla,17006,103956,111188,215144
2023,Morelos,17,Cuernavaca,17007,192776,217055,409831
2023,Morelos,17,Emiliano Zapata,17008,54673,56271,110944
2023,Morelos,17,Huitzilac,17009,10478,10524,21002
2023,Morelos,17,Jantetelco,17010,9309,9681,18990
2023,Morelos,17,Jiutepec,17011,112990,119937,232927
2023,Morelos,17,Jojutla,17012,30530,32615,63145
2023,Morelos,17,Jonacatepec,17013,8310,8927,17237
2023,Morelos,17,Mazatepec,17014,5392,5607,10999
2023,Morelos,17,Miacatlán,17015,14192,14864,29056
2023,Morelos,17,Ocuituco,17016,10050,10268,20318
2023,Morelos,17,Puente de Ixtla,17017,35831,37176,73007
2023,Morelos,17,Temixco,17018,62314,64809,127123
2023,Morelos,17,Temoac,17033,8553,9000,17553
2023,Morelos,17,Tepalcingo,17019,14595,15158,29753
2023,Morelos,17,Tepoztlán,17020,26362,27222,53584
2023,Morelos,17,Tetecala,17021,4293,4307,8600
2023,Morelos,17,Tetela del Volcán,17022,11061,11632,22693
2023,Morelos,17,Tlalnepantla,17023,4038,3917,7955
2023,Morelos,17,Tlaltizapán de Zapata,17024,27951,29238,57189
2023,Morelos,17,Tlaquiltenango,17025,18449,18879,37328
2023,Morelos,17,Tlayacapan,17026,9781,9952,19733
2023,Morelos,17,Totolapan,17027,6507,6674,13181
2023,Morelos,17,Xochitepec,17028,39007,38123,77130
2023,Morelos,17,Yautepec,17029,55069,57948,113017
2023,Morelos,17,Yecapixtla,17030,28896,29466,58362
2023,Morelos,17,Zacatepec,17031,19398,20911,40309
2023,Morelos,17,Zacualpan,17032,5164,5365,10529
2023,Nayarit,18,Acaponeta,18001,20926,20796,41722
2023,Nayarit,18,Ahuacatlán,18002,9001,8883,17884
2023,Nayarit,18,Amatlán de Cañas,18003,6764,6502,13266
2023,Nayarit,18,Bahía de Banderas,18020,94181,90440,184621
2023,Nayarit,18,Compostela,18004,42728,42290,85018
2023,Nayarit,18,Del Nayar,18009,23557,23443,47000
2023,Nayarit,18,Huajicori,18005,7129,6876,14005
2023,Nayarit,18,Ixtlán del Río,18006,15962,16957,32919
2023,Nayarit,18,Jala,18007,10269,10413,20682
2023,Nayarit,18,La Yesca,18019,7885,7408,15293
2023,Nayarit,18,Rosamorada,18010,19600,18686,38286
2023,Nayarit,18,Ruíz,18011,14164,13771,27935
2023,Nayarit,18,San Blas,18012,26354,23539,49893
2023,Nayarit,18,San Pedro Lagunillas,18013,4335,4199,8534
2023,Nayarit,18,Santa María del Oro,18014,13410,12896,26306
2023,Nayarit,18,Santiago Ixcuintla,18015,56168,54099,110267
2023,Nayarit,18,Tecuala,18016,22668,21905,44573
2023,Nayarit,18,Tepic,18017,226131,236822,462953
2023,Nayarit,18,Tuxpan,18018,17255,17349,34604
2023,Nayarit,18,Xalisco,18008,31673,32911,64584
2023,Nuevo León,19,Abasolo,19001,1471,1476,2947
2023,Nuevo León,19,Agualeguas,19002,1335,1268,2603
2023,Nuevo León,19,Allende,19004,20043,19768,39811
2023,Nuevo León,19,Anáhuac,19005,10218,10317,20535
2023,Nuevo León,19,Apodaca,19006,349533,343512,693045
2023,Nuevo León,19,Aramberri,19007,9378,9196,18574
2023,Nuevo León,19,Bustamante,19008,2293,2276,4569
2023,Nuevo León,19,Cadereyta Jiménez,19009,55827,53380,109207
2023,Nuevo León,19,Cerralvo,19011,4377,4096,8473
2023,Nuevo León,19,China,19013,6354,6049,12403
2023,Nuevo León,19,Ciénega de Flores,19012,27503,26424,53927
2023,Nuevo León,19,Doctor Arroyo,19014,19830,19422,39252
2023,Nuevo León,19,Doctor Coss,19015,991,956,1947
2023,Nuevo León,19,Doctor González,19016,1730,1649,3379
2023,Nuevo León,19,El Carmen,19010,25710,25138,50848
2023,Nuevo León,19,Galeana,19017,23597,23075,46672
2023,Nuevo León,19,García,19018,162603,160366,322969
2023,Nuevo León,19,General Bravo,19020,3271,3119,6390
2023,Nuevo León,19,General Escobedo,19021,242448,241368,483816
2023,Nuevo León,19,General Terán,19022,8457,8513,16970
2023,Nuevo León,19,General Treviño,19023,596,627,1223
2023,Nuevo León,19,General Zaragoza,19024,3532,3304,6836
2023,Nuevo León,19,General Zuazua,19025,49738,48794,98532
2023,Nuevo León,19,Guadalupe,19026,368675,359866,728541
2023,Nuevo León,19,Hidalgo,19047,8110,8032,16142
2023,Nuevo León,19,Higueras,19028,919,851,1770
2023,Nuevo León,19,Hualahuises,19029,3993,4052,8045
2023,Nuevo León,19,Iturbide,19030,2148,1981,4129
2023,Nuevo León,19,Juárez,19031,213572,208226,421798
2023,Nuevo León,19,Lampazos de Naranjo,19032,3051,2968,6019
2023,Nuevo León,19,Linares,19033,45965,46015,91980
2023,Nuevo León,19,Los Aldamas,19003,817,796,1613
2023,Nuevo León,19,Los Herreras,19027,1032,1059,2091
2023,Nuevo León,19,Los Ramones,19042,2693,2634,5327
2023,Nuevo León,19,Marín,19034,3277,3077,6354
2023,Nuevo León,19,Melchor Ocampo,19035,575,554,1129
2023,Nuevo León,19,Mier y Noriega,19036,3950,3872,7822
2023,Nuevo León,19,Mina,19037,3087,2948,6035
2023,Nuevo León,19,Montemorelos,19038,35253,35105,70358
2023,Nuevo León,19,Monterrey,19039,570262,594665,1164927
2023,Nuevo León,19,Parás,19040,565,554,1119
2023,Nuevo León,19,Pesquería,19041,60992,60293,121285
2023,Nuevo León,19,Rayones,19043,1619,1512,3131
2023,Nuevo León,19,Sabinas Hidalgo,19044,19897,20579,40476
2023,Nuevo León,19,Salinas Victoria,19045,33429,31970,65399
2023,Nuevo León,19,San Nicolás de los Garza,19046,237196,246053,483249
2023,Nuevo León,19,San Pedro Garza García,19019,67198,75020,142218
2023,Nuevo León,19,Santa Catarina,19048,167097,165117,332214
2023,Nuevo León,19,Santiago,19049,24461,24243,48704
2023,Nuevo León,19,Vallecillo,19050,1096,927,2023
2023,Nuevo León,19,Villaldama,19051,2377,2366,4743
2023,Oaxaca,20,Abejones,20001,429,585,1014
2023,Oaxaca,20,Acatlán de Pérez Figueroa,20002,23595,24651,48246
2023,Oaxaca,20,Asunción Cacalotepec,20003,1055,1127,2182
2023,Oaxaca,20,Asunción Cuyotepeji,20004,486,561,1047
2023,Oaxaca,20,Asunción Ixtaltepec,20005,7999,8098,16097
2023,Oaxaca,20,Asunción Nochixtlán,20006,9471,10616,20087
2023,Oaxaca,20,Asunción Ocotlán,20007,1092,1359,2451
2023,Oaxaca,20,Asunción Tlacolulita,20008,396,419,815
2023,Oaxaca,20,Ayoquezco de Aldama,20398,2102,2366,4468
2023,Oaxaca,20,Ayotzintepec,20009,3757,3814,7571
2023,Oaxaca,20,Calihualá,20011,588,622,1210
2023,Oaxaca,20,Candelaria Loxicha,20012,5344,5660,11004
2023,Oaxaca,20,Capulálpam de Méndez,20247,747,912,1659
2023,Oaxaca,20,Chahuites,20025,6088,6170,12258
2023,Oaxaca,20,Chalcatongo de Hidalgo,20026,4517,5147,9664
2023,Oaxaca,20,Chiquihuitlán de Benito Juárez,20027,1120,1334,2454
2023,Oaxaca,20,Ciudad Ixtepec,20014,14925,16221,31146
2023,Oaxaca,20,Ciénega de Zimatlán,20013,1528,1661,3189
2023,Oaxaca,20,Coatecas Altas,20015,2173,2493,4666
2023,Oaxaca,20,Coicoyán de las Flores,20016,4982,5640,10622
2023,Oaxaca,20,Concepción Buenavista,20018,406,429,835
2023,Oaxaca,20,Concepción Pápalo,20019,1555,1560,3115
2023,Oaxaca,20,Constancia del Rosario,20020,1901,2206,4107
2023,Oaxaca,20,Cosolapa,20021,7907,8556,16463
2023,Oaxaca,20,Cosoltepec,20022,361,426,787
2023,Oaxaca,20,Cuilápam de Guerrero,20023,11415,12076,23491
2023,Oaxaca,20,Cuyamecalco Villa de Zaragoza,20024,1934,1901,3835
2023,Oaxaca,20,El Barrio de la Soledad,20010,7253,7845,15098
2023,Oaxaca,20,El Espinal,20030,4544,4746,9290
2023,Oaxaca,20,Eloxochitlán de Flores Magón,20029,2125,2387,4512
2023,Oaxaca,20,Fresnillo de Trujano,20032,526,564,1090
2023,Oaxaca,20,Guadalupe Etla,20033,1369,1518,2887
2023,Oaxaca,20,Guadalupe de Ramírez,20034,663,680,1343
2023,Oaxaca,20,Guelatao de Juárez,20035,276,291,567
2023,Oaxaca,20,Guevea de Humboldt,20036,2683,2815,5498
2023,Oaxaca,20,Heroica Ciudad de Ejutla de Crespo,20028,10642,11878,22520
2023,Oaxaca,20,Heroica Ciudad de Huajuapan de León,20039,39425,43833,83258
2023,Oaxaca,20,Heroica Ciudad de Juchitán de Zaragoza,20043,51183,53792,104975
2023,Oaxaca,20,Heroica Ciudad de Tlaxiaco,20397,20379,23082,43461
2023,Oaxaca,20,Huautepec,20040,3010,3475,6485
2023,Oaxaca,20,Huautla de Jiménez,20041,15140,17448,32588
2023,Oaxaca,20,Ixpantepec Nieves,20065,526,661,1187
2023,Oaxaca,20,Ixtlán de Juárez,20042,4249,4394,8643
2023,Oaxaca,20,La Compañía,20017,1630,1800,3430
2023,Oaxaca,20,La Pe,20069,1355,1448,2803
2023,Oaxaca,20,La Reforma,20076,1593,1746,3339
2023,Oaxaca,20,La Trinidad Vista Hermosa,20556,120,145,265
2023,Oaxaca,20,Loma Bonita,20044,21637,23689,45326
2023,Oaxaca,20,Magdalena Apasco,20045,4558,5073,9631
2023,Oaxaca,20,Magdalena Jaltepec,20046,1540,1810,3350
2023,Oaxaca,20,Magdalena Mixtepec,20048,690,718,1408
2023,Oaxaca,20,Magdalena Ocotlán,20049,589,635,1224
2023,Oaxaca,20,Magdalena Peñasco,20050,1692,1971,3663
2023,Oaxaca,20,Magdalena Teitipac,20051,2333,2502,4835
2023,Oaxaca,20,Magdalena Tequisistlán,20052,3145,3310,6455
2023,Oaxaca,20,Magdalena Tlacotepec,20053,635,693,1328
2023,Oaxaca,20,Magdalena Yodocono de Porfirio Díaz,20562,796,844,1640
2023,Oaxaca,20,Magdalena Zahuatlán,20054,204,230,434
2023,Oaxaca,20,Mariscala de Juárez,20055,1806,1961,3767
2023,Oaxaca,20,Matías Romero Avendaño,20057,19798,21239,41037
2023,Oaxaca,20,Mazatlán Villa de Flores,20058,6725,6865,13590
2023,Oaxaca,20,Mesones Hidalgo,20037,2112,2501,4613
2023,Oaxaca,20,Miahuatlán de Porfirio Díaz,20059,22289,24457,46746
2023,Oaxaca,20,Mixistlán de la Reforma,20060,1292,1441,2733
2023,Oaxaca,20,Monjas,20061,1340,1581,2921
2023,Oaxaca,20,Mártires de Tacubaya,20056,734,795,1529
2023,Oaxaca,20,Natividad,20062,314,355,669
2023,Oaxaca,20,Nazareno Etla,20063,2054,2262,4316
2023,Oaxaca,20,Nejapa de Madero,20064,3848,4000,7848
2023,Oaxaca,20,Nuevo Zoquiápam,20504,816,887,1703
2023,Oaxaca,20,Oaxaca de Juárez,20067,121222,138633,259855
2023,Oaxaca,20,Ocotlán de Morelos,20068,11160,12135,23295
2023,Oaxaca,20,Pinotepa de Don Luis,20070,3597,3692,7289
2023,Oaxaca,20,Pluma Hidalgo,20071,1471,1541,3012
2023,Oaxaca,20,Putla Villa de Guerrero,20073,16555,18648,35203
2023,Oaxaca,20,Reforma de Pineda,20075,1426,1530,2956
2023,Oaxaca,20,Reyes Etla,20077,2039,2167,4206
2023,Oaxaca,20,Rojas de Cuauhtémoc,20078,556,627,1183
2023,Oaxaca,20,Salina Cruz,20079,45214,48929,94143
2023,Oaxaca,20,San Agustín Amatengo,20080,710,805,1515
2023,Oaxaca,20,San Agustín Atenango,20081,844,965,1809
2023,Oaxaca,20,San Agustín Chayuco,20082,1932,2142,4074
2023,Oaxaca,20,San Agustín Etla,20084,2082,2300,4382
2023,Oaxaca,20,San Agustín Loxicha,20085,12837,13345,26182
2023,Oaxaca,20,San Agustín Tlacotepec,20086,427,573,1000
2023,Oaxaca,20,San Agustín Yatareni,20087,2214,2506,4720
2023,Oaxaca,20,San Agustín de las Juntas,20083,5137,5339,10476
2023,Oaxaca,20,San Andrés Cabecera Nueva,20088,1436,1465,2901
2023,Oaxaca,20,San Andrés Dinicuiti,20089,1076,1139,2215
2023,Oaxaca,20,San Andrés Huaxpaltepec,20090,3137,3314,6451
2023,Oaxaca,20,San Andrés Huayápam,20091,2748,3005,5753
2023,Oaxaca,20,San Andrés Ixtlahuaca,20092,801,906,1707
2023,Oaxaca,20,San Andrés Lagunas,20093,236,276,512
2023,Oaxaca,20,San Andrés Nuxiño,20094,860,940,1800
2023,Oaxaca,20,San Andrés Paxtlán,20095,2275,2283,4558
2023,Oaxaca,20,San Andrés Sinaxtla,20096,370,424,794
2023,Oaxaca,20,San Andrés Solaga,20097,880,935,1815
2023,Oaxaca,20,San Andrés Teotilálpam,20098,2215,2413,4628
2023,Oaxaca,20,San Andrés Tepetlapa,20099,247,284,531
2023,Oaxaca,20,San Andrés Yaá,20100,217,260,477
2023,Oaxaca,20,San Andrés Zabache,20101,330,414,744
2023,Oaxaca,20,San Andrés Zautla,20102,2397,2548,4945
2023,Oaxaca,20,San Antonino Castillo Velasco,20103,3089,3385,6474
2023,Oaxaca,20,San Antonino Monte Verde,20105,3481,4070,7551
2023,Oaxaca,20,San Antonino el Alto,20104,1406,1448,2854
2023,Oaxaca,20,San Antonio Acutla,20106,117,146,263
2023,Oaxaca,20,San Antonio Huitepec,20108,2139,2494,4633
2023,Oaxaca,20,San Antonio Nanahuatípam,20109,644,649,1293
2023,Oaxaca,20,San Antonio Sinicahua,20110,766,887,1653
2023,Oaxaca,20,San Antonio Tepetlapa,20111,2170,2342,4512
2023,Oaxaca,20,San Antonio de la Cal,20107,12395,13806,26201
2023,Oaxaca,20,San Baltazar Chichicápam,20112,1236,1411,2647
2023,Oaxaca,20,San Baltazar Loxicha,20113,1518,1586,3104
2023,Oaxaca,20,San Baltazar Yatzachi el Bajo,20114,322,365,687
2023,Oaxaca,20,San Bartolo Coyotepec,20115,4957,5509,10466
2023,Oaxaca,20,San Bartolo Soyaltepec,20121,304,380,684
2023,Oaxaca,20,San Bartolo Yautepec,20122,339,348,687
2023,Oaxaca,20,San Bartolomé Ayautla,20116,2291,2447,4738
2023,Oaxaca,20,San Bartolomé Loxicha,20117,1182,1224,2406
2023,Oaxaca,20,San Bartolomé Quialana,20118,1054,1503,2557
2023,Oaxaca,20,San Bartolomé Yucuañe,20119,162,233,395
2023,Oaxaca,20,San Bartolomé Zoogocho,20120,128,181,309
2023,Oaxaca,20,San Bernardo Mixtepec,20123,1362,1469,2831
2023,Oaxaca,20,San Blas Atempa,20124,9575,9471,19046
2023,Oaxaca,20,San Carlos Yautepec,20125,6469,6353,12822
2023,Oaxaca,20,San Cristóbal Amatlán,20126,2588,2938,5526
2023,Oaxaca,20,San Cristóbal Amoltepec,20127,520,622,1142
2023,Oaxaca,20,San Cristóbal Lachirioag,20128,642,695,1337
2023,Oaxaca,20,San Cristóbal Suchixtlahuaca,20129,189,199,388
2023,Oaxaca,20,San Dionisio Ocotepec,20131,5273,5994,11267
2023,Oaxaca,20,San Dionisio Ocotlán,20132,601,616,1217
2023,Oaxaca,20,San Dionisio del Mar,20130,2764,2646,5410
2023,Oaxaca,20,San Esteban Atatlahuca,20133,1924,2022,3946
2023,Oaxaca,20,San Felipe Jalapa de Díaz,20134,14134,15117,29251
2023,Oaxaca,20,San Felipe Tejalápam,20135,3997,4379,8376
2023,Oaxaca,20,San Felipe Usila,20136,5800,6292,12092
2023,Oaxaca,20,San Francisco Cahuacuá,20137,1757,1788,3545
2023,Oaxaca,20,San Francisco Cajonos,20138,218,243,461
2023,Oaxaca,20,San Francisco Chapulapa,20139,1036,1119,2155
2023,Oaxaca,20,San Francisco Chindúa,20140,416,442,858
2023,Oaxaca,20,San Francisco Huehuetlán,20142,497,628,1125
2023,Oaxaca,20,San Francisco Ixhuatán,20143,4653,4722,9375
2023,Oaxaca,20,San Francisco Jaltepetongo,20144,516,533,1049
2023,Oaxaca,20,San Francisco Lachigoló,20145,2328,2415,4743
2023,Oaxaca,20,San Francisco Logueche,20146,1442,1655,3097
2023,Oaxaca,20,San Francisco Nuxaño,20147,204,190,394
2023,Oaxaca,20,San Francisco Ozolotepec,20148,959,1020,1979
2023,Oaxaca,20,San Francisco Sola,20149,861,952,1813
2023,Oaxaca,20,San Francisco Telixtlahuaca,20150,6641,7127,13768
2023,Oaxaca,20,San Francisco Teopan,20151,179,164,343
2023,Oaxaca,20,San Francisco Tlapancingo,20152,1061,1336,2397
2023,Oaxaca,20,San Francisco del Mar,20141,4158,4064,8222
2023,Oaxaca,20,San Gabriel Mixtepec,20153,2507,2667,5174
2023,Oaxaca,20,San Ildefonso Amatlán,20154,1227,1408,2635
2023,Oaxaca,20,San Ildefonso Sola,20155,516,509,1025
2023,Oaxaca,20,San Ildefonso Villa Alta,20156,1749,1847,3596
2023,Oaxaca,20,San Jacinto Amilpas,20157,8947,9868,18815
2023,Oaxaca,20,San Jacinto Tlacotepec,20158,1093,1152,2245
2023,Oaxaca,20,San Jerónimo Coatlán,20159,2676,2833,5509
2023,Oaxaca,20,San Jerónimo Silacayoapilla,20160,687,716,1403
2023,Oaxaca,20,San Jerónimo Sosola,20161,1296,1454,2750
2023,Oaxaca,20,San Jerónimo Taviche,20162,969,1052,2021
2023,Oaxaca,20,San Jerónimo Tecóatl,20163,799,895,1694
2023,Oaxaca,20,San Jerónimo Tlacochahuaya,20550,2765,3104,5869
2023,Oaxaca,20,San Jorge Nuchita,20164,1351,1602,2953
2023,Oaxaca,20,San José Ayuquila,20165,754,875,1629
2023,Oaxaca,20,San José Chiltepec,20166,6243,6597,12840
2023,Oaxaca,20,San José Estancia Grande,20168,553,555,1108
2023,Oaxaca,20,San José Independencia,20169,1845,1981,3826
2023,Oaxaca,20,San José Lachiguiri,20170,1619,2015,3634
2023,Oaxaca,20,San José Tenango,20171,9143,9917,19060
2023,Oaxaca,20,San José del Peñasco,20167,1097,1143,2240
2023,Oaxaca,20,San José del Progreso,20072,3475,3679,7154
2023,Oaxaca,20,San Juan Achiutla,20172,212,219,431
2023,Oaxaca,20,San Juan Atepec,20173,744,834,1578
2023,Oaxaca,20,San Juan Bautista Atatlahuca,20175,809,862,1671
2023,Oaxaca,20,San Juan Bautista Coixtlahuaca,20176,1313,1464,2777
2023,Oaxaca,20,San Juan Bautista Cuicatlán,20177,5111,5420,10531
2023,Oaxaca,20,San Juan Bautista Guelache,20178,3862,4316,8178
2023,Oaxaca,20,San Juan Bautista Jayacatlán,20179,806,792,1598
2023,Oaxaca,20,San Juan Bautista Lo de Soto,20180,1351,1380,2731
2023,Oaxaca,20,San Juan Bautista Suchitepec,20181,215,256,471
2023,Oaxaca,20,San Juan Bautista Tlachichilco,20183,673,777,1450
2023,Oaxaca,20,San Juan Bautista Tlacoatzintepec,20182,1060,1181,2241
2023,Oaxaca,20,San Juan Bautista Tuxtepec,20184,83005,89942,172947
2023,Oaxaca,20,San Juan Bautista Valle Nacional,20559,11299,12303,23602
2023,Oaxaca,20,San Juan Cacahuatepec,20185,4601,4805,9406
2023,Oaxaca,20,San Juan Chicomezúchil,20191,166,191,357
2023,Oaxaca,20,San Juan Chilateca,20192,751,874,1625
2023,Oaxaca,20,San Juan Cieneguilla,20186,294,321,615
2023,Oaxaca,20,San Juan Coatzóspam,20187,1088,1071,2159
2023,Oaxaca,20,San Juan Colorado,20188,5080,5398,10478
2023,Oaxaca,20,San Juan Comaltepec,20189,1463,1530,2993
2023,Oaxaca,20,San Juan Cotzocón,20190,12108,12748,24856
2023,Oaxaca,20,San Juan Diuxi,20195,551,567,1118
2023,Oaxaca,20,San Juan Evangelista Analco,20196,215,233,448
2023,Oaxaca,20,San Juan Guelavía,20197,1690,1795,3485
2023,Oaxaca,20,San Juan Guichicovi,20198,14737,16630,31367
2023,Oaxaca,20,San Juan Ihualtepec,20199,298,350,648
2023,Oaxaca,20,San Juan Juquila Mixes,20200,1904,2130,4034
2023,Oaxaca,20,San Juan Juquila Vijanos,20201,978,1071,2049
2023,Oaxaca,20,San Juan Lachao,20202,2433,2602,5035
2023,Oaxaca,20,San Juan Lachigalla,20203,1660,1795,3455
2023,Oaxaca,20,San Juan Lajarcia,20204,310,379,689
2023,Oaxaca,20,San Juan Lalana,20205,8608,9033,17641
2023,Oaxaca,20,San Juan Mazatlán,20207,9675,9804,19479
2023,Oaxaca,20,San Juan Mixtepec Distrito 08,20208,3361,3840,7201
2023,Oaxaca,20,San Juan Mixtepec Distrito 26,20209,283,412,695
2023,Oaxaca,20,San Juan Ozolotepec,20211,1387,1368,2755
2023,Oaxaca,20,San Juan Petlapa,20212,1486,1583,3069
2023,Oaxaca,20,San Juan Quiahije,20213,1921,2192,4113
2023,Oaxaca,20,San Juan Quiotepec,20214,1048,1082,2130
2023,Oaxaca,20,San Juan Sayultepec,20215,397,466,863
2023,Oaxaca,20,San Juan Tabaá,20216,674,740,1414
2023,Oaxaca,20,San Juan Tamazola,20217,1502,1578,3080
2023,Oaxaca,20,San Juan Teita,20218,317,334,651
2023,Oaxaca,20,San Juan Teitipac,20219,1312,1440,2752
2023,Oaxaca,20,San Juan Tepeuxila,20220,1413,1332,2745
2023,Oaxaca,20,San Juan Teposcolula,20221,632,666,1298
2023,Oaxaca,20,San Juan Yaeé,20222,742,838,1580
2023,Oaxaca,20,San Juan Yatzona,20223,209,271,480
2023,Oaxaca,20,San Juan Yucuita,20224,281,335,616
2023,Oaxaca,20,San Juan de los Cués,20206,1243,1274,2517
2023,Oaxaca,20,San Juan del Estado,20193,1365,1476,2841
2023,Oaxaca,20,San Juan del Río,20194,614,734,1348
2023,Oaxaca,20,San Juan Ñumí,20210,2865,3292,6157
2023,Oaxaca,20,San Lorenzo,20225,3093,3331,6424
2023,Oaxaca,20,San Lorenzo Albarradas,20226,1491,1442,2933
2023,Oaxaca,20,San Lorenzo Cacaotepec,20227,8200,8906,17106
2023,Oaxaca,20,San Lorenzo Cuaunecuiltitla,20228,447,407,854
2023,Oaxaca,20,San Lorenzo Texmelúcan,20229,4003,4673,8676
2023,Oaxaca,20,San Lorenzo Victoria,20230,509,526,1035
2023,Oaxaca,20,San Lucas Camotlán,20231,1515,1629,3144
2023,Oaxaca,20,San Lucas Ojitlán,20232,10214,10862,21076
2023,Oaxaca,20,San Lucas Quiaviní,20233,751,1067,1818
2023,Oaxaca,20,San Lucas Zoquiápam,20234,3782,4005,7787
2023,Oaxaca,20,San Luis Amatlán,20235,1763,2076,3839
2023,Oaxaca,20,San Marcial Ozolotepec,20236,744,821,1565
2023,Oaxaca,20,San Marcos Arteaga,20237,625,726,1351
2023,Oaxaca,20,San Martín Huamelúlpam,20239,507,600,1107
2023,Oaxaca,20,San Martín Itunyoso,20240,999,1274,2273
2023,Oaxaca,20,San Martín Lachilá,20241,506,633,1139
2023,Oaxaca,20,San Martín Peras,20242,6045,6527,12572
2023,Oaxaca,20,San Martín Tilcajete,20243,854,1059,1913
2023,Oaxaca,20,San Martín Toxpalan,20244,1952,2068,4020
2023,Oaxaca,20,San Martín Zacatepec,20245,667,685,1352
2023,Oaxaca,20,San Martín de los Cansecos,20238,446,457,903
2023,Oaxaca,20,San Mateo Cajonos,20246,299,362,661
2023,Oaxaca,20,San Mateo Etlatongo,20250,581,619,1200
2023,Oaxaca,20,San Mateo Nejápam,20251,567,623,1190
2023,Oaxaca,20,San Mateo Peñasco,20252,1050,1210,2260
2023,Oaxaca,20,San Mateo Piñas,20253,956,969,1925
2023,Oaxaca,20,San Mateo Río Hondo,20254,1612,1686,3298
2023,Oaxaca,20,San Mateo Sindihui,20255,1009,1125,2134
2023,Oaxaca,20,San Mateo Tlapiltepec,20256,103,127,230
2023,Oaxaca,20,San Mateo Yoloxochitlán,20249,1806,2001,3807
2023,Oaxaca,20,San Mateo Yucutindoo,20566,1572,1608,3180
2023,Oaxaca,20,San Mateo del Mar,20248,8174,7911,16085
2023,Oaxaca,20,San Melchor Betaza,20257,506,583,1089
2023,Oaxaca,20,San Miguel Achiutla,20258,375,421,796
2023,Oaxaca,20,San Miguel Ahuehuetitlán,20259,1194,1324,2518
2023,Oaxaca,20,San Miguel Aloápam,20260,1063,1209,2272
2023,Oaxaca,20,San Miguel Amatitlán,20261,3757,4213,7970
2023,Oaxaca,20,San Miguel Amatlán,20262,499,529,1028
2023,Oaxaca,20,San Miguel Chicahua,20264,1012,1247,2259
2023,Oaxaca,20,San Miguel Chimalapa,20265,3715,3501,7216
2023,Oaxaca,20,San Miguel Coatlán,20263,1574,1859,3433
2023,Oaxaca,20,San Miguel Ejutla,20268,487,570,1057
2023,Oaxaca,20,San Miguel Huautla,20270,533,623,1156
2023,Oaxaca,20,San Miguel Mixtepec,20271,1654,1701,3355
2023,Oaxaca,20,San Miguel Panixtlahuaca,20272,3007,3708,6715
2023,Oaxaca,20,San Miguel Peras,20273,1682,1816,3498
2023,Oaxaca,20,San Miguel Piedras,20274,652,694,1346
2023,Oaxaca,20,San Miguel Quetzaltepec,20275,4408,4345,8753
2023,Oaxaca,20,San Miguel Santa Flor,20276,369,364,733
2023,Oaxaca,20,San Miguel Soyaltepec,20278,19847,21120,40967
2023,Oaxaca,20,San Miguel Suchixtepec,20279,1352,1500,2852
2023,Oaxaca,20,San Miguel Tecomatlán,20281,173,149,322
2023,Oaxaca,20,San Miguel Tenango,20282,386,372,758
2023,Oaxaca,20,San Miguel Tequixtepec,20283,514,556,1070
2023,Oaxaca,20,San Miguel Tilquiápam,20284,1412,1808,3220
2023,Oaxaca,20,San Miguel Tlacamama,20285,1898,1954,3852
2023,Oaxaca,20,San Miguel Tlacotepec,20286,1518,1740,3258
2023,Oaxaca,20,San Miguel Tulancingo,20287,127,197,324
2023,Oaxaca,20,San Miguel Yotao,20288,294,329,623
2023,Oaxaca,20,San Miguel del Puerto,20266,4291,4383,8674
2023,Oaxaca,20,San Miguel del Río,20267,144,136,280
2023,Oaxaca,20,San Miguel el Grande,20269,2131,2401,4532
2023,Oaxaca,20,San Nicolás,20289,553,669,1222
2023,Oaxaca,20,San Nicolás Hidalgo,20290,491,572,1063
2023,Oaxaca,20,San Pablo Coatlán,20291,2160,2256,4416
2023,Oaxaca,20,San Pablo Cuatro Venados,20292,685,781,1466
2023,Oaxaca,20,San Pablo Etla,20293,9374,10402,19776
2023,Oaxaca,20,San Pablo Huitzo,20294,3596,4045,7641
2023,Oaxaca,20,San Pablo Huixtepec,20295,4754,5217,9971
2023,Oaxaca,20,San Pablo Macuiltianguis,20296,460,484,944
2023,Oaxaca,20,San Pablo Tijaltepec,20297,1127,1359,2486
2023,Oaxaca,20,San Pablo Villa de Mitla,20298,6447,7015,13462
2023,Oaxaca,20,San Pablo Yaganiza,20299,526,593,1119
2023,Oaxaca,20,San Pedro Amuzgos,20300,3330,3820,7150
2023,Oaxaca,20,San Pedro Apóstol,20301,744,876,1620
2023,Oaxaca,20,San Pedro Atoyac,20302,2213,2480,4693
2023,Oaxaca,20,San Pedro Cajonos,20303,525,638,1163
2023,Oaxaca,20,San Pedro Comitancillo,20305,2162,2367,4529
2023,Oaxaca,20,San Pedro Coxcaltepec Cántaros,20304,366,406,772
2023,Oaxaca,20,San Pedro Huamelula,20307,5167,5194,10361
2023,Oaxaca,20,San Pedro Huilotepec,20308,1652,1681,3333
2023,Oaxaca,20,San Pedro Ixcatlán,20309,5820,6104,11924
2023,Oaxaca,20,San Pedro Ixtlahuaca,20310,4710,4988,9698
2023,Oaxaca,20,San Pedro Jaltepetongo,20311,277,312,589
2023,Oaxaca,20,San Pedro Jicayán,20312,6187,6805,12992
2023,Oaxaca,20,San Pedro Jocotipac,20313,367,446,813
2023,Oaxaca,20,San Pedro Juchatengo,20314,798,885,1683
2023,Oaxaca,20,San Pedro Mixtepec Distrito 22,20318,25604,26837,52441
2023,Oaxaca,20,San Pedro Mixtepec Distrito 26,20319,539,585,1124
2023,Oaxaca,20,San Pedro Molinos,20320,333,369,702
2023,Oaxaca,20,San Pedro Mártir,20315,762,963,1725
2023,Oaxaca,20,San Pedro Mártir Quiechapa,20316,343,390,733
2023,Oaxaca,20,San Pedro Mártir Yucuxaco,20317,596,703,1299
2023,Oaxaca,20,San Pedro Nopala,20321,359,394,753
2023,Oaxaca,20,San Pedro Ocopetatillo,20322,394,457,851
2023,Oaxaca,20,San Pedro Ocotepec,20323,1069,1149,2218
2023,Oaxaca,20,San Pedro Pochutla,20324,24648,25498,50146
2023,Oaxaca,20,San Pedro Quiatoni,20325,5594,5910,11504
2023,Oaxaca,20,San Pedro Sochiápam,20326,2613,2678,5291
2023,Oaxaca,20,San Pedro Tapanatepec,20327,7660,7837,15497
2023,Oaxaca,20,San Pedro Taviche,20328,622,638,1260
2023,Oaxaca,20,San Pedro Teozacoalco,20329,622,667,1289
2023,Oaxaca,20,San Pedro Teutila,20330,2189,2263,4452
2023,Oaxaca,20,San Pedro Tidaá,20331,446,517,963
2023,Oaxaca,20,San Pedro Topiltepec,20332,182,202,384
2023,Oaxaca,20,San Pedro Totolápam,20333,1319,1462,2781
2023,Oaxaca,20,San Pedro Yaneri,20335,463,494,957
2023,Oaxaca,20,San Pedro Yucunama,20341,103,136,239
2023,Oaxaca,20,San Pedro Yólox,20336,852,924,1776
2023,Oaxaca,20,San Pedro el Alto,20306,1798,1914,3712
2023,Oaxaca,20,San Pedro y San Pablo Ayutla,20337,2501,2985,5486
2023,Oaxaca,20,San Pedro y San Pablo Teposcolula,20339,2083,2307,4390
2023,Oaxaca,20,San Pedro y San Pablo Tequixtepec,20340,821,1003,1824
2023,Oaxaca,20,San Raymundo Jalpan,20342,1765,2117,3882
2023,Oaxaca,20,San Sebastián Abasolo,20343,976,1061,2037
2023,Oaxaca,20,San Sebastián Coatlán,20344,1377,1459,2836
2023,Oaxaca,20,San Sebastián Ixcapa,20345,2133,2186,4319
2023,Oaxaca,20,San Sebastián Nicananduta,20346,659,868,1527
2023,Oaxaca,20,San Sebastián Río Hondo,20347,1899,1934,3833
2023,Oaxaca,20,San Sebastián Tecomaxtlahuaca,20348,4127,4554,8681
2023,Oaxaca,20,San Sebastián Teitipac,20349,941,1118,2059
2023,Oaxaca,20,San Sebastián Tutla,20350,8901,10297,19198
2023,Oaxaca,20,San Simón Almolongas,20351,1371,1581,2952
2023,Oaxaca,20,San Simón Zahuatlán,20352,2196,2248,4444
2023,Oaxaca,20,San Vicente Coatlán,20534,1859,2223,4082
2023,Oaxaca,20,San Vicente Lachixío,20535,1340,1537,2877
2023,Oaxaca,20,San Vicente Nuñú,20536,209,243,452
2023,Oaxaca,20,Santa Ana,20353,1112,1202,2314
2023,Oaxaca,20,Santa Ana Ateixtlahuaca,20354,268,265,533
2023,Oaxaca,20,Santa Ana Cuauhtémoc,20355,359,385,744
2023,Oaxaca,20,Santa Ana Tavela,20357,407,440,847
2023,Oaxaca,20,Santa Ana Tlapacoyan,20358,1034,1114,2148
2023,Oaxaca,20,Santa Ana Yareni,20359,437,501,938
2023,Oaxaca,20,Santa Ana Zegache,20360,1879,2119,3998
2023,Oaxaca,20,Santa Ana del Valle,20356,1062,1119,2181
2023,Oaxaca,20,Santa Catalina Quierí,20361,427,534,961
2023,Oaxaca,20,Santa Catarina Cuixtla,20362,688,864,1552
2023,Oaxaca,20,Santa Catarina Ixtepeji,20363,1323,1431,2754
2023,Oaxaca,20,Santa Catarina Juquila,20364,7984,8479,16463
2023,Oaxaca,20,Santa Catarina Lachatao,20365,550,597,1147
2023,Oaxaca,20,Santa Catarina Loxicha,20366,1954,2017,3971
2023,Oaxaca,20,Santa Catarina Mechoacán,20367,2327,2373,4700
2023,Oaxaca,20,Santa Catarina Minas,20368,1012,1048,2060
2023,Oaxaca,20,Santa Catarina Quiané,20369,1000,1051,2051
2023,Oaxaca,20,Santa Catarina Quioquitani,20074,274,302,576
2023,Oaxaca,20,Santa Catarina Tayata,20370,316,377,693
2023,Oaxaca,20,Santa Catarina Ticuá,20371,504,624,1128
2023,Oaxaca,20,Santa Catarina Yosonotú,20372,795,967,1762
2023,Oaxaca,20,Santa Catarina Zapoquila,20373,178,207,385
2023,Oaxaca,20,Santa Cruz Acatepec,20374,792,867,1659
2023,Oaxaca,20,Santa Cruz Amilpas,20375,6557,7571,14128
2023,Oaxaca,20,Santa Cruz Itundujia,20377,5819,6313,12132
2023,Oaxaca,20,Santa Cruz Mixtepec,20378,1776,1951,3727
2023,Oaxaca,20,Santa Cruz Nundaco,20379,1428,1676,3104
2023,Oaxaca,20,Santa Cruz Papalutla,20380,1109,1173,2282
2023,Oaxaca,20,Santa Cruz Tacache de Mina,20381,1353,1486,2839
2023,Oaxaca,20,Santa Cruz Tacahua,20382,546,615,1161
2023,Oaxaca,20,Santa Cruz Tayata,20383,313,322,635
2023,Oaxaca,20,Santa Cruz Xitla,20384,2401,2668,5069
2023,Oaxaca,20,Santa Cruz Xoxocotlán,20385,47977,53854,101831
2023,Oaxaca,20,Santa Cruz Zenzontepec,20386,9342,9805,19147
2023,Oaxaca,20,Santa Cruz de Bravo,20376,187,199,386
2023,Oaxaca,20,Santa Gertrudis,20387,1446,1542,2988
2023,Oaxaca,20,Santa Inés Yatzeche,20389,409,547,956
2023,Oaxaca,20,Santa Inés de Zaragoza,20569,788,903,1691
2023,Oaxaca,20,Santa Inés del Monte,20388,1221,1276,2497
2023,Oaxaca,20,Santa Lucía Miahuatlán,20391,1748,1841,3589
2023,Oaxaca,20,Santa Lucía Monteverde,20392,3224,3525,6749
2023,Oaxaca,20,Santa Lucía Ocotlán,20393,1841,2188,4029
2023,Oaxaca,20,Santa Lucía del Camino,20390,25127,27355,52482
2023,Oaxaca,20,Santa Magdalena Jicotlán,20047,45,55,100
2023,Oaxaca,20,Santa María Alotepec,20394,1452,1486,2938
2023,Oaxaca,20,Santa María Apazco,20395,802,1018,1820
2023,Oaxaca,20,Santa María Atzompa,20399,18548,19915,38463
2023,Oaxaca,20,Santa María Camotlán,20400,802,927,1729
2023,Oaxaca,20,Santa María Chachoápam,20404,363,414,777
2023,Oaxaca,20,Santa María Chilchotla,20406,10339,10752,21091
2023,Oaxaca,20,Santa María Chimalapa,20407,4807,4654,9461
2023,Oaxaca,20,Santa María Colotepec,20401,12707,12898,25605
2023,Oaxaca,20,Santa María Cortijo,20402,537,577,1114
2023,Oaxaca,20,Santa María Coyotepec,20403,1582,1755,3337
2023,Oaxaca,20,Santa María Ecatepec,20410,1749,1787,3536
2023,Oaxaca,20,Santa María Guelacé,20411,390,479,869
2023,Oaxaca,20,Santa María Guienagati,20412,1638,1642,3280
2023,Oaxaca,20,Santa María Huatulco,20413,23359,24280,47639
2023,Oaxaca,20,Santa María Huazolotitlán,20414,5932,6110,12042
2023,Oaxaca,20,Santa María Ipalapa,20415,2483,2753,5236
2023,Oaxaca,20,Santa María Ixcatlán,20416,241,271,512
2023,Oaxaca,20,Santa María Jacatepec,20417,4564,5105,9669
2023,Oaxaca,20,Santa María Jalapa del Marqués,20418,6771,7147,13918
2023,Oaxaca,20,Santa María Jaltianguis,20419,246,299,545
2023,Oaxaca,20,Santa María Lachixío,20420,955,1114,2069
2023,Oaxaca,20,Santa María Mixtequilla,20421,2386,2527,4913
2023,Oaxaca,20,Santa María Nativitas,20422,286,342,628
2023,Oaxaca,20,Santa María Nduayaco,20423,256,257,513
2023,Oaxaca,20,Santa María Ozolotepec,20424,1918,2042,3960
2023,Oaxaca,20,Santa María Petapa,20427,8390,8997,17387
2023,Oaxaca,20,Santa María Peñoles,20426,4337,4565,8902
2023,Oaxaca,20,Santa María Pápalo,20425,1106,1105,2211
2023,Oaxaca,20,Santa María Quiegolani,20428,1031,1013,2044
2023,Oaxaca,20,Santa María Sola,20429,735,804,1539
2023,Oaxaca,20,Santa María Tataltepec,20430,198,211,409
2023,Oaxaca,20,Santa María Tecomavaca,20431,842,905,1747
2023,Oaxaca,20,Santa María Temaxcalapa,20432,473,494,967
2023,Oaxaca,20,Santa María Temaxcaltepec,20433,1255,1426,2681
2023,Oaxaca,20,Santa María Teopoxco,20434,2054,2346,4400
2023,Oaxaca,20,Santa María Tepantlali,20435,1964,2034,3998
2023,Oaxaca,20,Santa María Texcatitlán,20436,494,540,1034
2023,Oaxaca,20,Santa María Tlahuitoltepec,20437,4682,5007,9689
2023,Oaxaca,20,Santa María Tlalixtac,20438,862,917,1779
2023,Oaxaca,20,Santa María Tonameca,20439,13268,13488,26756
2023,Oaxaca,20,Santa María Totolapilla,20440,407,450,857
2023,Oaxaca,20,Santa María Xadani,20441,4695,4612,9307
2023,Oaxaca,20,Santa María Yalina,20442,132,156,288
2023,Oaxaca,20,Santa María Yavesía,20443,239,297,536
2023,Oaxaca,20,Santa María Yolotepec,20444,206,223,429
2023,Oaxaca,20,Santa María Yosoyúa,20445,873,857,1730
2023,Oaxaca,20,Santa María Yucuhiti,20446,3120,3413,6533
2023,Oaxaca,20,Santa María Zacatepec,20447,7912,8898,16810
2023,Oaxaca,20,Santa María Zaniza,20448,1122,1190,2312
2023,Oaxaca,20,Santa María Zoquitlán,20449,1562,1599,3161
2023,Oaxaca,20,Santa María del Rosario,20408,273,252,525
2023,Oaxaca,20,Santa María del Tule,20409,4460,5109,9569
2023,Oaxaca,20,Santa María la Asunción,20396,1509,1916,3425
2023,Oaxaca,20,Santiago Amoltepec,20450,6395,6822,13217
2023,Oaxaca,20,Santiago Apoala,20451,436,512,948
2023,Oaxaca,20,Santiago Apóstol,20452,1843,2289,4132
2023,Oaxaca,20,Santiago Astata,20453,2081,2104,4185
2023,Oaxaca,20,Santiago Atitlán,20454,1590,1538,3128
2023,Oaxaca,20,Santiago Ayuquililla,20455,1357,1490,2847
2023,Oaxaca,20,Santiago Cacaloxtepec,20456,811,889,1700
2023,Oaxaca,20,Santiago Camotlán,20457,1639,1654,3293
2023,Oaxaca,20,Santiago Chazumba,20459,2098,2628,4726
2023,Oaxaca,20,Santiago Choápam,20460,2599,2772,5371
2023,Oaxaca,20,Santiago Comaltepec,20458,468,515,983
2023,Oaxaca,20,Santiago Huajolotitlán,20462,2003,2378,4381
2023,Oaxaca,20,Santiago Huauclilla,20463,256,283,539
2023,Oaxaca,20,Santiago Ihuitlán Plumas,20464,162,205,367
2023,Oaxaca,20,Santiago Ixcuintepec,20465,838,862,1700
2023,Oaxaca,20,Santiago Ixtayutla,20466,6540,6908,13448
2023,Oaxaca,20,Santiago Jamiltepec,20467,9588,10399,19987
2023,Oaxaca,20,Santiago Jocotepec,20468,7217,7400,14617
2023,Oaxaca,20,Santiago Juxtlahuaca,20469,18011,19919,37930
2023,Oaxaca,20,Santiago Lachiguiri,20470,2410,2459,4869
2023,Oaxaca,20,Santiago Lalopa,20471,255,271,526
2023,Oaxaca,20,Santiago Laollaga,20472,1803,1821,3624
2023,Oaxaca,20,Santiago Laxopa,20473,650,728,1378
2023,Oaxaca,20,Santiago Llano Grande,20474,1717,1730,3447
2023,Oaxaca,20,Santiago Matatlán,20475,4869,5518,10387
2023,Oaxaca,20,Santiago Miltepec,20476,220,221,441
2023,Oaxaca,20,Santiago Minas,20477,705,726,1431
2023,Oaxaca,20,Santiago Nacaltepec,20478,866,971,1837
2023,Oaxaca,20,Santiago Nejapilla,20479,114,104,218
2023,Oaxaca,20,Santiago Niltepec,20066,2809,2857,5666
2023,Oaxaca,20,Santiago Nundiche,20480,455,506,961
2023,Oaxaca,20,Santiago Nuyoó,20481,846,936,1782
2023,Oaxaca,20,Santiago Pinotepa Nacional,20482,27427,28731,56158
2023,Oaxaca,20,Santiago Suchilquitongo,20483,5384,5797,11181
2023,Oaxaca,20,Santiago Tamazola,20484,2190,2504,4694
2023,Oaxaca,20,Santiago Tapextla,20485,1633,1581,3214
2023,Oaxaca,20,Santiago Tenango,20487,1081,1078,2159
2023,Oaxaca,20,Santiago Tepetlapa,20488,57,70,127
2023,Oaxaca,20,Santiago Tetepec,20489,2532,2577,5109
2023,Oaxaca,20,Santiago Texcalcingo,20490,1568,1683,3251
2023,Oaxaca,20,Santiago Textitlán,20491,2303,2308,4611
2023,Oaxaca,20,Santiago Tilantongo,20492,1383,1631,3014
2023,Oaxaca,20,Santiago Tillo,20493,268,306,574
2023,Oaxaca,20,Santiago Tlazoyaltepec,20494,2268,2700,4968
2023,Oaxaca,20,Santiago Xanica,20495,1575,1566,3141
2023,Oaxaca,20,Santiago Xiacuí,20496,1051,1152,2203
2023,Oaxaca,20,Santiago Yaitepec,20497,2073,2453,4526
2023,Oaxaca,20,Santiago Yaveo,20498,3642,3619,7261
2023,Oaxaca,20,Santiago Yolomécatl,20499,1039,1216,2255
2023,Oaxaca,20,Santiago Yosondúa,20500,4188,4699,8887
2023,Oaxaca,20,Santiago Yucuyachi,20501,466,504,970
2023,Oaxaca,20,Santiago Zacatepec,20502,2726,2815,5541
2023,Oaxaca,20,Santiago Zoochila,20503,189,210,399
2023,Oaxaca,20,Santiago del Río,20461,278,302,580
2023,Oaxaca,20,Santo Domingo Albarradas,20506,375,434,809
2023,Oaxaca,20,Santo Domingo Armenta,20507,1784,1800,3584
2023,Oaxaca,20,Santo Domingo Chihuitán,20508,786,812,1598
2023,Oaxaca,20,Santo Domingo Ingenio,20505,4230,4237,8467
2023,Oaxaca,20,Santo Domingo Ixcatlán,20510,291,347,638
2023,Oaxaca,20,Santo Domingo Nuxaá,20511,1617,1727,3344
2023,Oaxaca,20,Santo Domingo Ozolotepec,20512,395,434,829
2023,Oaxaca,20,Santo Domingo Petapa,20513,4902,4822,9724
2023,Oaxaca,20,Santo Domingo Roayaga,20514,516,559,1075
2023,Oaxaca,20,Santo Domingo Tehuantepec,20515,33691,35510,69201
2023,Oaxaca,20,Santo Domingo Teojomulco,20516,2572,2703,5275
2023,Oaxaca,20,Santo Domingo Tepuxtepec,20517,2829,3214,6043
2023,Oaxaca,20,Santo Domingo Tlatayápam,20518,67,78,145
2023,Oaxaca,20,Santo Domingo Tomaltepec,20519,1548,1593,3141
2023,Oaxaca,20,Santo Domingo Tonaltepec,20521,111,140,251
2023,Oaxaca,20,Santo Domingo Tonalá,20520,3451,3827,7278
2023,Oaxaca,20,Santo Domingo Xagacía,20522,573,656,1229
2023,Oaxaca,20,Santo Domingo Yanhuitlán,20523,777,871,1648
2023,Oaxaca,20,Santo Domingo Yodohino,20524,149,157,306
2023,Oaxaca,20,Santo Domingo Zanatepec,20525,6405,6480,12885
2023,Oaxaca,20,Santo Domingo de Morelos,20509,5498,6144,11642
2023,Oaxaca,20,Santo Tomás Jalieza,20530,1799,1985,3784
2023,Oaxaca,20,Santo Tomás Mazaltepec,20531,1355,1482,2837
2023,Oaxaca,20,Santo Tomás Ocotepec,20532,1847,2119,3966
2023,Oaxaca,20,Santo Tomás Tamazulapan,20533,1157,1228,2385
2023,Oaxaca,20,Santos Reyes Nopala,20526,9008,9606,18614
2023,Oaxaca,20,Santos Reyes Pápalo,20527,1318,1432,2750
2023,Oaxaca,20,Santos Reyes Tepejillo,20528,429,586,1015
2023,Oaxaca,20,Santos Reyes Yucuná,20529,664,673,1337
2023,Oaxaca,20,Silacayoápam,20537,3314,3750,7064
2023,Oaxaca,20,Sitio de Xitlapehua,20538,340,383,723
2023,Oaxaca,20,Soledad Etla,20539,2978,3125,6103
2023,Oaxaca,20,Tamazulápam del Espíritu Santo,20031,3528,4269,7797
2023,Oaxaca,20,Tanetze de Zaragoza,20541,828,896,1724
2023,Oaxaca,20,Taniche,20542,387,469,856
2023,Oaxaca,20,Tataltepec de Valdés,20543,2955,3099,6054
2023,Oaxaca,20,Teococuilco de Marcos Pérez,20544,432,525,957
2023,Oaxaca,20,Teotitlán de Flores Magón,20545,4991,5551,10542
2023,Oaxaca,20,Teotitlán del Valle,20546,2920,3242,6162
2023,Oaxaca,20,Teotongo,20547,463,548,1011
2023,Oaxaca,20,Tepelmeme Villa de Morelos,20548,787,944,1731
2023,Oaxaca,20,Tlacolula de Matamoros,20551,11700,13148,24848
2023,Oaxaca,20,Tlacotepec Plumas,20552,225,248,473
2023,Oaxaca,20,Tlalixtac de Cabrera,20553,5303,5869,11172
2023,Oaxaca,20,Totontepec Villa de Morelos,20554,2706,2933,5639
2023,Oaxaca,20,Trinidad Zaachila,20555,1491,1653,3144
2023,Oaxaca,20,Unión Hidalgo,20557,8007,8462,16469
2023,Oaxaca,20,Valerio Trujano,20558,666,812,1478
2023,Oaxaca,20,Villa Díaz Ordaz,20560,3270,3887,7157
2023,Oaxaca,20,Villa Hidalgo,20038,968,1071,2039
2023,Oaxaca,20,Villa Sola de Vega,20277,6320,6450,12770
2023,Oaxaca,20,Villa Talea de Castro,20280,1144,1255,2399
2023,Oaxaca,20,Villa Tejúpam de la Unión,20486,1256,1347,2603
2023,Oaxaca,20,Villa Tezoatlán de Segura y Luna,20549,5293,6214,11507
2023,Oaxaca,20,Villa de Chilapa de Díaz,20405,1009,1279,2288
2023,Oaxaca,20,Villa de Etla,20338,5598,6155,11753
2023,Oaxaca,20,Villa de Tamazulápam del Progreso,20540,3865,4316,8181
2023,Oaxaca,20,Villa de Tututepec de Melchor Ocampo,20334,23395,24376,47771
2023,Oaxaca,20,Villa de Zaachila,20565,23213,25324,48537
2023,Oaxaca,20,Yaxe,20561,1436,1552,2988
2023,Oaxaca,20,Yogana,20563,602,711,1313
2023,Oaxaca,20,Yutanduchi de Guerrero,20564,574,637,1211
2023,Oaxaca,20,Zapotitlán Lagunas,20567,1559,1745,3304
2023,Oaxaca,20,Zapotitlán Palmas,20568,675,836,1511
2023,Oaxaca,20,Zimatlán de Álvarez,20570,9929,11277,21206
2023,Oaxaca,20,Ánimas Trujano,20174,2045,2261,4306
2023,Puebla,21,Acajete,21001,34404,36586,70990
2023,Puebla,21,Acateno,21002,5012,4956,9968
2023,Puebla,21,Acatlán,21003,17872,20728,38600
2023,Puebla,21,Acatzingo,21004,31591,32750,64341
2023,Puebla,21,Acteopan,21005,1502,1691,3193
2023,Puebla,21,Ahuacatlán,21006,8177,9049,17226
2023,Puebla,21,Ahuatlán,21007,1667,1802,3469
2023,Puebla,21,Ahuazotepec,21008,6131,6309,12440
2023,Puebla,21,Ahuehuetitla,21009,890,1020,1910
2023,Puebla,21,Ajalpan,21010,34991,36878,71869
2023,Puebla,21,Albino Zertuche,21011,899,1050,1949
2023,Puebla,21,Aljojuca,21012,3390,3725,7115
2023,Puebla,21,Altepexi,21013,11360,11906,23266
2023,Puebla,21,Amixtlán,21014,2539,2806,5345
2023,Puebla,21,Amozoc,21015,64015,66628,130643
2023,Puebla,21,Aquixtla,21016,4734,4751,9485
2023,Puebla,21,Atempan,21017,14559,16284,30843
2023,Puebla,21,Atexcal,21018,1974,2126,4100
2023,Puebla,21,Atlequizayan,21080,1337,1505,2842
2023,Puebla,21,Atlixco,21019,69900,77918,147818
2023,Puebla,21,Atoyatempan,21020,3683,3906,7589
2023,Puebla,21,Atzala,21021,676,746,1422
2023,Puebla,21,Atzitzihuacán,21022,6201,7097,13298
2023,Puebla,21,Atzitzintla,21023,4929,5034,9963
2023,Puebla,21,Axutla,21024,471,547,1018
2023,Puebla,21,Ayotoxco de Guerrero,21025,4580,4733,9313
2023,Puebla,21,Calpan,21026,7487,8258,15745
2023,Puebla,21,Caltepec,21027,1959,2248,4207
2023,Puebla,21,Camocuautla,21028,1422,1449,2871
2023,Puebla,21,Caxhuacan,21029,1901,2095,3996
2023,Puebla,21,Cañada Morelos,21099,10096,10751,20847
2023,Puebla,21,Chalchicomula de Sesma,21045,24791,26878,51669
2023,Puebla,21,Chapulco,21046,4105,4390,8495
2023,Puebla,21,Chiautla,21047,10497,11148,21645
2023,Puebla,21,Chiautzingo,21048,10530,11561,22091
2023,Puebla,21,Chichiquila,21050,13563,14421,27984
2023,Puebla,21,Chiconcuautla,21049,8866,9233,18099
2023,Puebla,21,Chietla,21051,18053,19325,37378
2023,Puebla,21,Chigmecatitlán,21052,591,698,1289
2023,Puebla,21,Chignahuapan,21053,33585,34722,68307
2023,Puebla,21,Chignautla,21054,18089,19172,37261
2023,Puebla,21,Chila,21055,2338,2629,4967
2023,Puebla,21,Chila de la Sal,21056,756,806,1562
2023,Puebla,21,Chilchotla,21058,10692,10684,21376
2023,Puebla,21,Chinantla,21059,1151,1295,2446
2023,Puebla,21,Coatepec,21030,387,432,819
2023,Puebla,21,Coatzingo,21031,1505,1665,3170
2023,Puebla,21,Cohetzala,21032,735,722,1457
2023,Puebla,21,Cohuecan,21033,2529,2754,5283
2023,Puebla,21,Coronango,21034,21945,22723,44668
2023,Puebla,21,Coxcatlán,21035,10605,11686,22291
2023,Puebla,21,Coyomeapan,21036,7193,7886,15079
2023,Puebla,21,Coyotepec,21037,1161,1362,2523
2023,Puebla,21,Cuapiaxtla de Madero,21038,5510,5545,11055
2023,Puebla,21,Cuautempan,21039,4868,5225,10093
2023,Puebla,21,Cuautinchán,21040,5595,5637,11232
2023,Puebla,21,Cuautlancingo,21041,65056,68550,133606
2023,Puebla,21,Cuayuca de Andrade,21042,1632,1742,3374
2023,Puebla,21,Cuetzalan del Progreso,21043,25427,26727,52154
2023,Puebla,21,Cuyoaco,21044,8177,8867,17044
2023,Puebla,21,Domingo Arenas,21060,3881,4311,8192
2023,Puebla,21,Eloxochitlán,21061,6665,7061,13726
2023,Puebla,21,Epatlán,21062,2549,2684,5233
2023,Puebla,21,Esperanza,21063,7837,8351,16188
2023,Puebla,21,Francisco Z. Mena,21064,9344,9175,18519
2023,Puebla,21,General Felipe Ángeles,21065,10816,11688,22504
2023,Puebla,21,Guadalupe,21066,2883,3322,6205
2023,Puebla,21,Guadalupe Victoria,21067,8999,9476,18475
2023,Puebla,21,Hermenegildo Galeana,21068,4127,4200,8327
2023,Puebla,21,Honey,21057,4127,4486,8613
2023,Puebla,21,Huaquechula,21069,12545,14203,26748
2023,Puebla,21,Huatlatlauca,21070,3213,3838,7051
2023,Puebla,21,Huauchinango,21071,54340,60078,114418
2023,Puebla,21,Huehuetla,21072,10030,10313,20343
2023,Puebla,21,Huehuetlán el Chico,21073,4469,4691,9160
2023,Puebla,21,Huehuetlán el Grande,21150,3818,4049,7867
2023,Puebla,21,Huejotzingo,21074,39591,41412,81003
2023,Puebla,21,Hueyapan,21075,6700,7130,13830
2023,Puebla,21,Hueytamalco,21076,13942,14303,28245
2023,Puebla,21,Hueytlalpan,21077,2882,3029,5911
2023,Puebla,21,Huitzilan de Serdán,21078,8262,8072,16334
2023,Puebla,21,Huitziltepec,21079,2864,3085,5949
2023,Puebla,21,Ixcamilpa de Guerrero,21081,1838,2035,3873
2023,Puebla,21,Ixcaquixtla,21082,4635,5078,9713
2023,Puebla,21,Ixtacamaxtitlán,21083,12927,13254,26181
2023,Puebla,21,Ixtepec,21084,3713,3930,7643
2023,Puebla,21,Izúcar de Matamoros,21085,40096,44545,84641
2023,Puebla,21,Jalpan,21086,6257,6754,13011
2023,Puebla,21,Jolalpan,21087,6795,7327,14122
2023,Puebla,21,Jonotla,21088,2411,2510,4921
2023,Puebla,21,Jopala,21089,6880,7191,14071
2023,Puebla,21,Juan C. Bonilla,21090,11212,12204,23416
2023,Puebla,21,Juan Galindo,21091,5458,6222,11680
2023,Puebla,21,Juan N. Méndez,21092,2825,2881,5706
2023,Puebla,21,La Magdalena Tlatlauquitepec,21095,308,302,610
2023,Puebla,21,Lafragua,21093,4198,4322,8520
2023,Puebla,21,Libres,21094,18015,18962,36977
2023,Puebla,21,Los Reyes de Juárez,21118,14682,15122,29804
2023,Puebla,21,Mazapiltepec de Juárez,21096,1537,1556,3093
2023,Puebla,21,Mixtla,21097,1212,1347,2559
2023,Puebla,21,Molcaxac,21098,3127,3517,6644
2023,Puebla,21,Naupan,21100,5111,5580,10691
2023,Puebla,21,Nauzontla,21101,1759,1974,3733
2023,Puebla,21,Nealtican,21102,6469,7022,13491
2023,Puebla,21,Nicolás Bravo,21103,3308,3520,6828
2023,Puebla,21,Nopalucan,21104,16823,17227,34050
2023,Puebla,21,Ocotepec,21105,2489,2693,5182
2023,Puebla,21,Ocoyucan,21106,14480,16310,30790
2023,Puebla,21,Olintla,21107,6139,6445,12584
2023,Puebla,21,Oriental,21108,9704,10257,19961
2023,Puebla,21,Pahuatlán,21109,11404,12603,24007
2023,Puebla,21,Palmar de Bravo,21110,24818,25280,50098
2023,Puebla,21,Pantepec,21111,9675,10256,19931
2023,Puebla,21,Petlalcingo,21112,4918,5605,10523
2023,Puebla,21,Piaxtla,21113,2291,2479,4770
2023,Puebla,21,Puebla,21114,833348,905229,1738577
2023,Puebla,21,Quecholac,21115,27189,28137,55326
2023,Puebla,21,Quimixtlán,21116,11758,12066,23824
2023,Puebla,21,Rafael Lara Grajales,21117,7203,7728,14931
2023,Puebla,21,San Andrés Cholula,21119,80350,81986,162336
2023,Puebla,21,San Antonio Cañada,21120,2835,3175,6010
2023,Puebla,21,San Diego la Mesa Tochimiltzingo,21121,642,649,1291
2023,Puebla,21,San Felipe Teotlalcingo,21122,5509,5869,11378
2023,Puebla,21,San Felipe Tepatlán,21123,2064,2141,4205
2023,Puebla,21,San Gabriel Chilac,21124,8132,9006,17138
2023,Puebla,21,San Gregorio Atzompa,21125,4835,5107,9942
2023,Puebla,21,San Jerónimo Tecuanipan,21126,3249,3574,6823
2023,Puebla,21,San Jerónimo Xayacatlán,21127,1729,1986,3715
2023,Puebla,21,San José Chiapa,21128,4736,4835,9571
2023,Puebla,21,San José Miahuatlán,21129,6947,7560,14507
2023,Puebla,21,San Juan Atenco,21130,1672,1937,3609
2023,Puebla,21,San Juan Atzompa,21131,492,469,961
2023,Puebla,21,San Martín Texmelucan,21132,80565,86145,166710
2023,Puebla,21,San Martín Totoltepec,21133,317,344,661
2023,Puebla,21,San Matías Tlalancaleca,21134,10941,11305,22246
2023,Puebla,21,San Miguel Ixitlán,21135,259,287,546
2023,Puebla,21,San Miguel Xoxtla,21136,6658,7017,13675
2023,Puebla,21,San Nicolás Buenos Aires,21137,5268,5501,10769
2023,Puebla,21,San Nicolás de los Ranchos,21138,6297,6554,12851
2023,Puebla,21,San Pablo Anicano,21139,1848,2016,3864
2023,Puebla,21,San Pedro Cholula,21140,68938,74618,143556
2023,Puebla,21,San Pedro Yeloixtlahuaca,21141,1725,1865,3590
2023,Puebla,21,San Salvador Huixcolotla,21144,8071,8197,16268
2023,Puebla,21,San Salvador el Seco,21142,16186,17010,33196
2023,Puebla,21,San Salvador el Verde,21143,16997,17547,34544
2023,Puebla,21,San Sebastián Tlacotepec,21145,7443,7539,14982
2023,Puebla,21,Santa Catarina Tlaltempan,21146,438,437,875
2023,Puebla,21,Santa Inés Ahuatempan,21147,3297,3611,6908
2023,Puebla,21,Santa Isabel Cholula,21148,4581,4963,9544
2023,Puebla,21,Santiago Miahuatlán,21149,13723,14425,28148
2023,Puebla,21,Santo Tomás Hueyotlipan,21151,4500,4838,9338
2023,Puebla,21,Soltepec,21152,6564,6877,13441
2023,Puebla,21,Tecali de Herrera,21153,11813,12409,24222
2023,Puebla,21,Tecamachalco,21154,40770,43158,83928
2023,Puebla,21,Tecomatlán,21155,3014,3139,6153
2023,Puebla,21,Tehuacán,21156,165395,183716,349111
2023,Puebla,21,Tehuitzingo,21157,5767,6416,12183
2023,Puebla,21,Tenampulco,21158,3816,3958,7774
2023,Puebla,21,Teopantlán,21159,1786,2224,4010
2023,Puebla,21,Teotlalco,21160,1665,1746,3411
2023,Puebla,21,Tepanco de López,21161,10642,11757,22399
2023,Puebla,21,Tepango de Rodríguez,21162,2089,2333,4422
2023,Puebla,21,Tepatlaxco de Hidalgo,21163,9237,9703,18940
2023,Puebla,21,Tepeaca,21164,42127,45664,87791
2023,Puebla,21,Tepemaxalco,21165,563,599,1162
2023,Puebla,21,Tepeojuma,21166,4304,4989,9293
2023,Puebla,21,Tepetzintla,21167,5992,6412,12404
2023,Puebla,21,Tepexco,21168,3574,3753,7327
2023,Puebla,21,Tepexi de Rodríguez,21169,11521,11487,23008
2023,Puebla,21,Tepeyahualco,21170,9131,9283,18414
2023,Puebla,21,Tepeyahualco de Cuauhtémoc,21171,1866,2037,3903
2023,Puebla,21,Tetela de Ocampo,21172,14816,15876,30692
2023,Puebla,21,Teteles de Ávila Castillo,21173,2931,3447,6378
2023,Puebla,21,Teziutlán,21174,50839,56548,107387
2023,Puebla,21,Tianguismanalco,21175,6700,7208,13908
2023,Puebla,21,Tilapa,21176,4480,4801,9281
2023,Puebla,21,Tlachichuca,21179,15566,16156,31722
2023,Puebla,21,Tlacotepec de Benito Juárez,21177,27038,29400,56438
2023,Puebla,21,Tlacuilotepec,21178,8847,9151,17998
2023,Puebla,21,Tlahuapan,21180,21648,21885,43533
2023,Puebla,21,Tlaltenango,21181,3826,3887,7713
2023,Puebla,21,Tlanepantla,21182,2594,2797,5391
2023,Puebla,21,Tlaola,21183,10538,11172,21710
2023,Puebla,21,Tlapacoya,21184,3424,3577,7001
2023,Puebla,21,Tlapanalá,21185,4366,4769,9135
2023,Puebla,21,Tlatlauquitepec,21186,27980,30772,58752
2023,Puebla,21,Tlaxco,21187,2878,2907,5785
2023,Puebla,21,Tochimilco,21188,9280,10296,19576
2023,Puebla,21,Tochtepec,21189,11071,11917,22988
2023,Puebla,21,Totoltepec de Guerrero,21190,601,730,1331
2023,Puebla,21,Tulcingo,21191,4744,5417,10161
2023,Puebla,21,Tuzamapan de Galeana,21192,3408,3565,6973
2023,Puebla,21,Tzicatlacoyan,21193,3799,3870,7669
2023,Puebla,21,Venustiano Carranza,21194,15470,16570,32040
2023,Puebla,21,Vicente Guerrero,21195,12689,13747,26436
2023,Puebla,21,Xayacatlán de Bravo,21196,780,932,1712
2023,Puebla,21,Xicotepec,21197,42523,45630,88153
2023,Puebla,21,Xicotlán,21198,621,683,1304
2023,Puebla,21,Xiutetelco,21199,21032,22614,43646
2023,Puebla,21,Xochiapulco,21200,1737,1913,3650
2023,Puebla,21,Xochiltepec,21201,1628,1957,3585
2023,Puebla,21,Xochitlán Todos Santos,21203,3334,3688,7022
2023,Puebla,21,Xochitlán de Vicente Suárez,21202,6600,7085,13685
2023,Puebla,21,Yaonáhuac,21204,4137,4545,8682
2023,Puebla,21,Yehualtepec,21205,13207,13882,27089
2023,Puebla,21,Zacapala,21206,2271,2539,4810
2023,Puebla,21,Zacapoaxtla,21207,28606,31473,60079
2023,Puebla,21,Zacatlán,21208,42885,47305,90190
2023,Puebla,21,Zapotitlán,21209,4202,5007,9209
2023,Puebla,21,Zapotitlán de Méndez,21210,3017,3062,6079
2023,Puebla,21,Zaragoza,21211,8147,9540,17687
2023,Puebla,21,Zautla,21212,9642,10938,20580
2023,Puebla,21,Zihuateutla,21213,6996,7392,14388
2023,Puebla,21,Zinacatepec,21214,8888,9710,18598
2023,Puebla,21,Zongozotla,21215,2661,2717,5378
2023,Puebla,21,Zoquiapan,21216,1220,1389,2609
2023,Puebla,21,Zoquitlán,21217,9639,10219,19858
2023,Querétaro,22,Amealco de Bonfil,22001,34516,36560,71076
2023,Querétaro,22,Arroyo Seco,22003,7497,8056,15553
2023,Querétaro,22,Cadereyta de Montes,22004,38639,41894,80533
2023,Querétaro,22,Colón,22005,36425,35660,72085
2023,Querétaro,22,Corregidora,22006,108441,114769,223210
2023,Querétaro,22,El Marqués,22011,96468,94696,191164
2023,Querétaro,22,Ezequiel Montes,22007,23274,24764,48038
2023,Querétaro,22,Huimilpan,22008,21185,22959,44144
2023,Querétaro,22,Jalpan de Serra,22009,14812,16223,31035
2023,Querétaro,22,Landa de Matamoros,22010,10058,10953,21011
2023,Querétaro,22,Pedro Escobedo,22012,39707,40244,79951
2023,Querétaro,22,Peñamiller,22013,11398,11686,23084
2023,Querétaro,22,Pinal de Amoles,22002,14115,15016,29131
2023,Querétaro,22,Querétaro,22014,508281,515233,1023514
2023,Querétaro,22,San Joaquín,22015,5051,5741,10792
2023,Querétaro,22,San Juan del Río,22016,155722,161463,317185
2023,Querétaro,22,Tequisquiapan,22017,40673,42200,82873
2023,Querétaro,22,Tolimán,22018,16148,16766,32914
2023,Quintana Roo,23,Bacalar,23010,24359,24143,48502
2023,Quintana Roo,23,Benito Juárez,23005,451750,446285,898035
2023,Quintana Roo,23,Cozumel,23001,54190,54201,108391
2023,Quintana Roo,23,Felipe Carrillo Puerto,23002,50069,49644,99713
2023,Quintana Roo,23,Isla Mujeres,23003,13158,12111,25269
2023,Quintana Roo,23,José María Morelos,23006,23460,22157,45617
2023,Quintana Roo,23,Lázaro Cárdenas,23007,17200,16429,33629
2023,Quintana Roo,23,Othón P. Blanco,23004,137920,143542,281462
2023,Quintana Roo,23,Solidaridad,23008,134048,121907,255955
2023,Quintana Roo,23,Tulum,23009,20663,18560,39223
2023,San Luis Potosí,24,Ahualulco,24001,9052,10167,19219
2023,San Luis Potosí,24,Alaquines,24002,4364,4499,8863
2023,San Luis Potosí,24,Aquismón,24003,26017,25499,51516
2023,San Luis Potosí,24,Armadillo de los Infante,24004,2147,2228,4375
2023,San Luis Potosí,24,Axtla de Terrazas,24053,19626,20145,39771
2023,San Luis Potosí,24,Catorce,24006,5313,5133,10446
2023,San Luis Potosí,24,Cedral,24007,10005,10487,20492
2023,San Luis Potosí,24,Cerritos,24008,11259,11980,23239
2023,San Luis Potosí,24,Cerro de San Pedro,24009,2473,2413,4886
2023,San Luis Potosí,24,Charcas,24015,10906,11323,22229
2023,San Luis Potosí,24,Ciudad Fernández,24011,23507,24808,48315
2023,San Luis Potosí,24,Ciudad Valles,24013,92664,99177,191841
2023,San Luis Potosí,24,Ciudad del Maíz,24010,18523,18704,37227
2023,San Luis Potosí,24,Coxcatlán,24014,8175,8078,16253
2023,San Luis Potosí,24,Cárdenas,24005,9624,10468,20092
2023,San Luis Potosí,24,Ebano,24016,22906,23794,46700
2023,San Luis Potosí,24,El Naranjo,24058,11906,11760,23666
2023,San Luis Potosí,24,Guadalcázar,24017,14274,14009,28283
2023,San Luis Potosí,24,Huehuetlán,24018,8359,8625,16984
2023,San Luis Potosí,24,Lagunillas,24019,2888,3012,5900
2023,San Luis Potosí,24,Matehuala,24020,51839,54875,106714
2023,San Luis Potosí,24,Matlapa,24057,16144,16321,32465
2023,San Luis Potosí,24,Mexquitic de Carmona,24021,28979,31566,60545
2023,San Luis Potosí,24,Moctezuma,24022,9888,10748,20636
2023,San Luis Potosí,24,Rayón,24023,8134,8567,16701
2023,San Luis Potosí,24,Rioverde,24024,48908,51976,100884
2023,San Luis Potosí,24,Salinas,24025,16284,17553,33837
2023,San Luis Potosí,24,San Antonio,24026,5008,4825,9833
2023,San Luis Potosí,24,San Ciro de Acosta,24027,5327,5703,11030
2023,San Luis Potosí,24,San Luis Potosí,24028,428088,457952,886040
2023,San Luis Potosí,24,San Martín Chalchicuautla,24029,11084,11267,22351
2023,San Luis Potosí,24,San Nicolás Tolentino,24030,2595,2883,5478
2023,San Luis Potosí,24,San Vicente Tancuayalab,24034,7847,7881,15728
2023,San Luis Potosí,24,Santa Catarina,24031,6044,6399,12443
2023,San Luis Potosí,24,Santa María del Río,24032,20174,22160,42334
2023,San Luis Potosí,24,Santo Domingo,24033,6355,6421,12776
2023,San Luis Potosí,24,Soledad de Graciano Sánchez,24035,165683,173953,339636
2023,San Luis Potosí,24,Tamasopo,24036,16273,15966,32239
2023,San Luis Potosí,24,Tamazunchale,24037,50545,51531,102076
2023,San Luis Potosí,24,Tampacán,24038,8235,8112,16347
2023,San Luis Potosí,24,Tampamolón Corona,24039,8080,8274,16354
2023,San Luis Potosí,24,Tamuín,24040,20478,20991,41469
2023,San Luis Potosí,24,Tancanhuitz,24012,10779,11121,21900
2023,San Luis Potosí,24,Tanlajás,24041,10500,10311,20811
2023,San Luis Potosí,24,Tanquián de Escobedo,24042,7914,8290,16204
2023,San Luis Potosí,24,Tierra Nueva,24043,4539,5171,9710
2023,San Luis Potosí,24,Vanegas,24044,4112,4047,8159
2023,San Luis Potosí,24,Venado,24045,7595,7888,15483
2023,San Luis Potosí,24,Villa Hidalgo,24051,7837,7991,15828
2023,San Luis Potosí,24,Villa Juárez,24052,5354,5497,10851
2023,San Luis Potosí,24,Villa de Arista,24056,8078,8170,16248
2023,San Luis Potosí,24,Villa de Arriaga,24046,9434,9596,19030
2023,San Luis Potosí,24,Villa de Guadalupe,24047,5219,5218,10437
2023,San Luis Potosí,24,Villa de Ramos,24049,19185,20260,39445
2023,San Luis Potosí,24,Villa de Reyes,24050,26102,26329,52431
2023,San Luis Potosí,24,Villa de la Paz,24048,2870,2838,5708
2023,San Luis Potosí,24,Xilitla,24054,26922,27953,54875
2023,San Luis Potosí,24,Zaragoza,24055,13622,14008,27630
2023,Sinaloa,25,Ahome,25001,241914,250612,492526
2023,Sinaloa,25,Angostura,25002,26133,25984,52117
2023,Sinaloa,25,Badiraguato,25003,16746,15517,32263
2023,Sinaloa,25,Choix,25007,17955,17005,34960
2023,Sinaloa,25,Concordia,25004,15141,14726,29867
2023,Sinaloa,25,Cosalá,25005,8869,8443,17312
2023,Sinaloa,25,Culiacán,25006,482449,500445,982894
2023,Sinaloa,25,El Fuerte,25010,56061,54854,110915
2023,Sinaloa,25,Elota,25008,30985,28796,59781
2023,Sinaloa,25,Escuinapa,25009,32650,31681,64331
2023,Sinaloa,25,Guasave,25011,160396,162897,323293
2023,Sinaloa,25,Mazatlán,25012,271611,278224,549835
2023,Sinaloa,25,Mocorito,25013,25387,23964,49351
2023,Sinaloa,25,Navolato,25018,83360,80086,163446
2023,Sinaloa,25,Rosario,25014,29786,28783,58569
2023,Sinaloa,25,Salvador Alvarado,25015,43287,45358,88645
2023,Sinaloa,25,San Ignacio,25016,11553,10753,22306
2023,Sinaloa,25,Sinaloa,25017,49125,47821,96946
2023,Sonora,26,Aconchi,26001,1654,1496,3150
2023,Sonora,26,Agua Prieta,26002,45637,45032,90669
2023,Sonora,26,Alamos,26003,14921,13950,28871
2023,Sonora,26,Altar,26004,5308,5329,10637
2023,Sonora,26,Arivechi,26005,680,651,1331
2023,Sonora,26,Arizpe,26006,1561,1483,3044
2023,Sonora,26,Atil,26007,333,316,649
2023,Sonora,26,Bacadéhuachi,26008,661,597,1258
2023,Sonora,26,Bacanora,26009,477,430,907
2023,Sonora,26,Bacerac,26010,824,777,1601
2023,Sonora,26,Bacoachi,26011,905,904,1809
2023,Sonora,26,Banámichi,26013,951,930,1881
2023,Sonora,26,Bavispe,26015,903,811,1714
2023,Sonora,26,Baviácora,26014,1952,1851,3803
2023,Sonora,26,Benito Juárez,26071,12305,12288,24593
2023,Sonora,26,Benjamín Hill,26016,2798,2936,5734
2023,Sonora,26,Bácum,26012,12931,12759,25690
2023,Sonora,26,Caborca,26017,48014,47300,95314
2023,Sonora,26,Cajeme,26018,237079,248374,485453
2023,Sonora,26,Cananea,26019,19379,19844,39223
2023,Sonora,26,Carbó,26020,2826,2599,5425
2023,Sonora,26,Cucurpe,26022,617,501,1118
2023,Sonora,26,Cumpas,26023,3525,3500,7025
2023,Sonora,26,Divisaderos,26024,433,418,851
2023,Sonora,26,Empalme,26025,31146,31455,62601
2023,Sonora,26,Etchojoa,26026,35262,34075,69337
2023,Sonora,26,Fronteras,26027,4884,4722,9606
2023,Sonora,26,General Plutarco Elías Calles,26070,9717,9535,19252
2023,Sonora,26,Granados,26028,618,600,1218
2023,Sonora,26,Guaymas,26029,88228,89535,177763
2023,Sonora,26,Hermosillo,26030,484038,496939,980977
2023,Sonora,26,Huachinera,26031,760,716,1476
2023,Sonora,26,Huatabampo,26033,44844,44766,89610
2023,Sonora,26,Huásabas,26032,544,485,1029
2023,Sonora,26,Huépac,26034,576,555,1131
2023,Sonora,26,Imuris,26035,7177,7108,14285
2023,Sonora,26,La Colorada,26021,1234,992,2226
2023,Sonora,26,Magdalena,26036,17445,17702,35147
2023,Sonora,26,Mazatán,26037,722,629,1351
2023,Sonora,26,Moctezuma,26038,2764,2842,5606
2023,Sonora,26,Naco,26039,3467,3447,6914
2023,Sonora,26,Nacozari de García,26041,7299,7271,14570
2023,Sonora,26,Navojoa,26042,89518,93459,182977
2023,Sonora,26,Nogales,26043,130316,130909,261225
2023,Sonora,26,Nácori Chico,26040,1182,1083,2265
2023,Sonora,26,Onavas,26044,277,236,513
2023,Sonora,26,Opodepe,26045,1624,1437,3061
2023,Sonora,26,Oquitoa,26046,209,236,445
2023,Sonora,26,Pitiquito,26047,5350,5035,10385
2023,Sonora,26,Puerto Peñasco,26048,38492,37192,75684
2023,Sonora,26,Quiriego,26049,1704,1482,3186
2023,Sonora,26,Rayón,26050,903,825,1728
2023,Sonora,26,Rosario,26051,2959,2716,5675
2023,Sonora,26,Sahuaripa,26052,3254,3057,6311
2023,Sonora,26,San Felipe de Jesús,26053,240,233,473
2023,Sonora,26,San Ignacio Río Muerto,26072,8312,7864,16176
2023,Sonora,26,San Javier,26054,415,317,732
2023,Sonora,26,San Luis Río Colorado,26055,107569,106394,213963
2023,Sonora,26,San Miguel de Horcasitas,26056,5610,4770,10380
2023,Sonora,26,San Pedro de la Cueva,26057,919,800,1719
2023,Sonora,26,Santa Ana,26058,9091,9354,18445
2023,Sonora,26,Santa Cruz,26059,1022,1057,2079
2023,Sonora,26,Soyopa,26061,847,708,1555
2023,Sonora,26,Suaqui Grande,26062,687,577,1264
2023,Sonora,26,Sáric,26060,871,834,1705
2023,Sonora,26,Tepache,26063,863,787,1650
2023,Sonora,26,Trincheras,26064,1002,819,1821
2023,Sonora,26,Tubutama,26065,678,641,1319
2023,Sonora,26,Ures,26066,5083,4858,9941
2023,Sonora,26,Villa Hidalgo,26067,908,841,1749
2023,Sonora,26,Villa Pesqueira,26068,701,590,1291
2023,Sonora,26,Yécora,26069,3269,3237,6506
2023,Tabasco,27,Balancán,27001,33116,33235,66351
2023,Tabasco,27,Centla,27003,60661,60787,121448
2023,Tabasco,27,Centro,27004,373365,390496,763861
2023,Tabasco,27,Comalcalco,27005,110443,113845,224288
2023,Tabasco,27,Cunduacán,27006,75338,77757,153095
2023,Tabasco,27,Cárdenas,27002,139114,144473,283587
2023,Tabasco,27,Emiliano Zapata,27007,16217,17769,33986
2023,Tabasco,27,Huimanguillo,27008,101750,104391,206141
2023,Tabasco,27,Jalapa,27009,21331,21257,42588
2023,Tabasco,27,Jalpa de Méndez,27010,48428,48788,97216
2023,Tabasco,27,Jonuta,27011,16874,16784,33658
2023,Tabasco,27,Macuspana,27012,89311,92913,182224
2023,Tabasco,27,Nacajuca,27013,76313,79395,155708
2023,Tabasco,27,Paraíso,27014,52481,52884,105365
2023,Tabasco,27,Tacotalpa,27015,26862,26690,53552
2023,Tabasco,27,Teapa,27016,31551,32787,64338
2023,Tabasco,27,Tenosique,27017,31761,33622,65383
2023,Tamaulipas,28,Abasolo,28001,6547,6563,13110
2023,Tamaulipas,28,Aldama,28002,15870,15612,31482
2023,Tamaulipas,28,Altamira,28003,131481,132996,264477
2023,Tamaulipas,28,Antiguo Morelos,28004,5382,5376,10758
2023,Tamaulipas,28,Burgos,28005,2527,2335,4862
2023,Tamaulipas,28,Bustamante,28006,4528,4164,8692
2023,Tamaulipas,28,Camargo,28007,8323,8121,16444
2023,Tamaulipas,28,Casas,28008,2357,2133,4490
2023,Tamaulipas,28,Ciudad Madero,28009,109204,120022,229226
2023,Tamaulipas,28,Cruillas,28010,1008,983,1991
2023,Tamaulipas,28,El Mante,28021,62568,66374,128942
2023,Tamaulipas,28,González,28012,23606,23871,47477
2023,Tamaulipas,28,Guerrero,28014,2554,2384,4938
2023,Tamaulipas,28,Gustavo Díaz Ordaz,28015,8643,8454,17097
2023,Tamaulipas,28,Gómez Farías,28011,5101,4861,9962
2023,Tamaulipas,28,Güémez,28013,8800,8147,16947
2023,Tamaulipas,28,Hidalgo,28016,12871,12250,25121
2023,Tamaulipas,28,Jaumave,28017,8537,8250,16787
2023,Tamaulipas,28,Jiménez,28018,4316,4323,8639
2023,Tamaulipas,28,Llera,28019,9335,9013,18348
2023,Tamaulipas,28,Mainero,28020,1409,1369,2778
2023,Tamaulipas,28,Matamoros,28022,273417,282435,555852
2023,Tamaulipas,28,Mier,28024,2113,2199,4312
2023,Tamaulipas,28,Miguel Alemán,28025,14743,14906,29649
2023,Tamaulipas,28,Miquihuana,28026,2050,1878,3928
2023,Tamaulipas,28,Méndez,28023,2123,1932,4055
2023,Tamaulipas,28,Nuevo Laredo,28027,214001,214329,428330
2023,Tamaulipas,28,Nuevo Morelos,28028,2014,1834,3848
2023,Tamaulipas,28,Ocampo,28029,7666,7330,14996
2023,Tamaulipas,28,Padilla,28030,7663,7562,15225
2023,Tamaulipas,28,Palmillas,28031,966,929,1895
2023,Tamaulipas,28,Reynosa,28032,351471,352460,703931
2023,Tamaulipas,28,Río Bravo,28033,68449,68254,136703
2023,Tamaulipas,28,San Carlos,28034,5069,4576,9645
2023,Tamaulipas,28,San Fernando,28035,30105,29890,59995
2023,Tamaulipas,28,San Nicolás,28036,599,523,1122
2023,Tamaulipas,28,Soto la Marina,28037,13791,13173,26964
2023,Tamaulipas,28,Tampico,28038,163955,178669,342624
2023,Tamaulipas,28,Tula,28039,15841,15975,31816
2023,Tamaulipas,28,Valle Hermoso,28040,33987,35126,69113
2023,Tamaulipas,28,Victoria,28041,183998,192610,376608
2023,Tamaulipas,28,Villagrán,28042,3467,3258,6725
2023,Tamaulipas,28,Xicoténcatl,28043,12927,12945,25872
2023,Tlaxcala,29,Acuamanala de Miguel Hidalgo,29022,3670,3648,7318
2023,Tlaxcala,29,Altzayanca,29004,9630,9574,19204
2023,Tlaxcala,29,Amaxac de Guerrero,29001,6169,6343,12512
2023,Tlaxcala,29,Apetatitlán de Antonio Carvajal,29002,8122,8673,16795
2023,Tlaxcala,29,Apizaco,29005,41461,45512,86973
2023,Tlaxcala,29,Atlangatepec,29003,3540,3685,7225
2023,Tlaxcala,29,Benito Juárez,29045,3265,3343,6608
2023,Tlaxcala,29,Calpulalpan,29006,26061,27362,53423
2023,Tlaxcala,29,Chiautempan,29010,38797,41525,80322
2023,Tlaxcala,29,Contla de Juan Cuamatzi,29018,20972,21499,42471
2023,Tlaxcala,29,Cuapiaxtla,29008,8436,8410,16846
2023,Tlaxcala,29,Cuaxomulco,29009,2929,2965,5894
2023,Tlaxcala,29,El Carmen Tequexquitla,29007,9294,9512,18806
2023,Tlaxcala,29,Emiliano Zapata,29046,2430,2535,4965
2023,Tlaxcala,29,Españita,29012,4783,4879,9662
2023,Tlaxcala,29,Huamantla,29013,50675,52575,103250
2023,Tlaxcala,29,Hueyotlipan,29014,7915,8086,16001
2023,Tlaxcala,29,Ixtacuixtla de Mariano Matamoros,29015,21164,22287,43451
2023,Tlaxcala,29,Ixtenco,29016,3866,4162,8028
2023,Tlaxcala,29,La Magdalena Tlaltelulco,29048,9895,10649,20544
2023,Tlaxcala,29,Lázaro Cárdenas,29047,1677,1698,3375
2023,Tlaxcala,29,Mazatecochco de José María Morelos,29017,5934,6019,11953
2023,Tlaxcala,29,Muñoz de Domingo Arenas,29011,2517,2491,5008
2023,Tlaxcala,29,Nanacamilpa de Mariano Arista,29021,9776,10212,19988
2023,Tlaxcala,29,Natívitas,29023,13677,14584,28261
2023,Tlaxcala,29,Panotla,29024,14406,15476,29882
2023,Tlaxcala,29,Papalotla de Xicohténcatl,29041,16283,17353,33636
2023,Tlaxcala,29,San Damián Texóloc,29049,3122,3130,6252
2023,Tlaxcala,29,San Francisco Tetlanohcan,29050,5780,5991,11771
2023,Tlaxcala,29,San Jerónimo Zacualpan,29051,2033,2235,4268
2023,Tlaxcala,29,San José Teacalco,29052,3237,3386,6623
2023,Tlaxcala,29,San Juan Huactzinco,29053,3971,4323,8294
2023,Tlaxcala,29,San Lorenzo Axocomanitla,29054,3011,3220,6231
2023,Tlaxcala,29,San Lucas Tecopilco,29055,1675,1765,3440
2023,Tlaxcala,29,San Pablo del Monte,29025,42349,42408,84757
2023,Tlaxcala,29,Sanctórum de Lázaro Cárdenas,29020,5536,5648,11184
2023,Tlaxcala,29,Santa Ana Nopalucan,29056,4252,4381,8633
2023,Tlaxcala,29,Santa Apolonia Teacalco,29057,2422,2686,5108
2023,Tlaxcala,29,Santa Catarina Ayometla,29058,4747,5103,9850
2023,Tlaxcala,29,Santa Cruz Quilehtla,29059,3979,3965,7944
2023,Tlaxcala,29,Santa Cruz Tlaxcala,29026,11303,11654,22957
2023,Tlaxcala,29,Santa Isabel Xiloxoxtla,29060,2709,2840,5549
2023,Tlaxcala,29,Tenancingo,29027,7123,7339,14462
2023,Tlaxcala,29,Teolocholco,29028,13078,13828,26906
2023,Tlaxcala,29,Tepetitla de Lardizábal,29019,11350,12192,23542
2023,Tlaxcala,29,Tepeyanco,29029,7401,8067,15468
2023,Tlaxcala,29,Terrenate,29030,8567,8459,17026
2023,Tlaxcala,29,Tetla de la Solidaridad,29031,17790,18227,36017
2023,Tlaxcala,29,Tetlatlahuca,29032,7832,8287,16119
2023,Tlaxcala,29,Tlaxcala,29033,50619,55657,106276
2023,Tlaxcala,29,Tlaxco,29034,23068,23895,46963
2023,Tlaxcala,29,Tocatlán,29035,3208,3264,6472
2023,Tlaxcala,29,Totolac,29036,11971,13021,24992
2023,Tlaxcala,29,Tzompantepec,29038,9424,10083,19507
2023,Tlaxcala,29,Xaloztoc,29039,13343,13247,26590
2023,Tlaxcala,29,Xaltocan,29040,5896,6313,12209
2023,Tlaxcala,29,Xicohtzinco,29042,7298,8027,15325
2023,Tlaxcala,29,Yauhquemehcan,29043,21052,22358,43410
2023,Tlaxcala,29,Zacatelco,29044,23621,25685,49306
2023,Tlaxcala,29,Ziltlaltépec de Trinidad Sánchez Santos,29037,4675,5077,9752
2023,Veracruz,30,Acajete,30001,4705,4524,9229
2023,Veracruz,30,Acatlán,30002,1670,1718,3388
2023,Veracruz,30,Acayucan,30003,44336,47810,92146
2023,Veracruz,30,Actopan,30004,23018,23834,46852
2023,Veracruz,30,Acula,30005,2911,2896,5807
2023,Veracruz,30,Acultzingo,30006,11936,12346,24282
2023,Veracruz,30,Agua Dulce,30204,25032,26507,51539
2023,Veracruz,30,Alpatláhuac,30008,5337,5352,10689
2023,Veracruz,30,Alto Lucero de Gutiérrez Barrios,30009,15734,15641,31375
2023,Veracruz,30,Altotonga,30010,33405,35858,69263
2023,Veracruz,30,Alvarado,30011,28481,29242,57723
2023,Veracruz,30,Amatitlán,30012,4229,4430,8659
2023,Veracruz,30,Amatlán de los Reyes,30014,23601,25346,48947
2023,Veracruz,30,Angel R. Cabada,30015,17706,18769,36475
2023,Veracruz,30,Apazapan,30017,2173,2204,4377
2023,Veracruz,30,Aquila,30018,964,1021,1985
2023,Veracruz,30,Astacinga,30019,3165,3601,6766
2023,Veracruz,30,Atlahuilco,30020,5595,5859,11454
2023,Veracruz,30,Atoyac,30021,12357,13062,25419
2023,Veracruz,30,Atzacan,30022,11183,11543,22726
2023,Veracruz,30,Atzalan,30023,26715,26937,53652
2023,Veracruz,30,Ayahualulco,30025,14094,14273,28367
2023,Veracruz,30,Banderilla,30026,11916,13274,25190
2023,Veracruz,30,Benito Juárez,30027,9092,9588,18680
2023,Veracruz,30,Boca del Río,30028,72960,82406,155366
2023,Veracruz,30,Calcahualco,30029,6759,6767,13526
2023,Veracruz,30,Camarón de Tejeda,30007,3477,3465,6942
2023,Veracruz,30,Camerino Z. Mendoza,30030,21353,24062,45415
2023,Veracruz,30,Carlos A. Carrillo,30208,12726,13870,26596
2023,Veracruz,30,Carrillo Puerto,30031,8869,9157,18026
2023,Veracruz,30,Castillo de Teayo,30157,10620,10424,21044
2023,Veracruz,30,Catemaco,30032,25411,27200,52611
2023,Veracruz,30,Cazones de Herrera,30033,12242,13022,25264
2023,Veracruz,30,Cerro Azul,30034,13780,15404,29184
2023,Veracruz,30,Chacaltianguis,30054,6491,6885,13376
2023,Veracruz,30,Chalma,30055,7061,7327,14388
2023,Veracruz,30,Chiconamel,30056,3405,3674,7079
2023,Veracruz,30,Chiconquiaco,30057,7428,7535,14963
2023,Veracruz,30,Chicontepec,30058,28937,30495,59432
2023,Veracruz,30,Chinameca,30059,8484,8887,17371
2023,Veracruz,30,Chinampa de Gorostiza,30060,8811,9057,17868
2023,Veracruz,30,Chocamán,30062,11242,11263,22505
2023,Veracruz,30,Chontla,30063,7632,7745,15377
2023,Veracruz,30,Chumatlán,30064,2011,2134,4145
2023,Veracruz,30,Citlaltépetl,30035,6180,6501,12681
2023,Veracruz,30,Coacoatzintla,30036,5449,5706,11155
2023,Veracruz,30,Coahuitlán,30037,4402,4565,8967
2023,Veracruz,30,Coatepec,30038,47946,51685,99631
2023,Veracruz,30,Coatzacoalcos,30039,166764,177399,344163
2023,Veracruz,30,Coatzintla,30040,29964,31567,61531
2023,Veracruz,30,Coetzala,30041,1190,1222,2412
2023,Veracruz,30,Colipa,30042,2895,3022,5917
2023,Veracruz,30,Comapa,30043,10994,10533,21527
2023,Veracruz,30,Cosamaloapan de Carpio,30045,29261,31930,61191
2023,Veracruz,30,Cosautlán de Carvajal,30046,8597,8705,17302
2023,Veracruz,30,Coscomatepec,30047,30449,31421,61870
2023,Veracruz,30,Cosoleacaque,30048,71294,76248,147542
2023,Veracruz,30,Cotaxtla,30049,11130,11136,22266
2023,Veracruz,30,Coxquihui,30050,8695,9111,17806
2023,Veracruz,30,Coyutla,30051,11416,12312,23728
2023,Veracruz,30,Cuichapa,30052,6200,6822,13022
2023,Veracruz,30,Cuitláhuac,30053,14457,15702,30159
2023,Veracruz,30,Córdoba,30044,109391,123267,232658
2023,Veracruz,30,El Higo,30205,10437,10548,20985
2023,Veracruz,30,Emiliano Zapata,30065,42141,45131,87272
2023,Veracruz,30,Espinal,30066,14135,14860,28995
2023,Veracruz,30,Filomeno Mata,30067,9930,9884,19814
2023,Veracruz,30,Fortín,30068,34125,37899,72024
2023,Veracruz,30,Gutiérrez Zamora,30069,12312,13899,26211
2023,Veracruz,30,Hidalgotitlán,30070,10224,9880,20104
2023,Veracruz,30,Huatusco,30071,31323,33517,64840
2023,Veracruz,30,Huayacocotla,30072,11099,11845,22944
2023,Veracruz,30,Hueyapan de Ocampo,30073,22409,23648,46057
2023,Veracruz,30,Huiloapan de Cuauhtémoc,30074,3744,4018,7762
2023,Veracruz,30,Ignacio de la Llave,30075,8859,9703,18562
2023,Veracruz,30,Ilamatlán,30076,6858,7520,14378
2023,Veracruz,30,Isla,30077,22426,23444,45870
2023,Veracruz,30,Ixcatepec,30078,7194,7193,14387
2023,Veracruz,30,Ixhuacán de los Reyes,30079,6137,6033,12170
2023,Veracruz,30,Ixhuatlancillo,30081,13529,14704,28233
2023,Veracruz,30,Ixhuatlán de Madero,30083,28033,29504,57537
2023,Veracruz,30,Ixhuatlán del Café,30080,12137,12194,24331
2023,Veracruz,30,Ixhuatlán del Sureste,30082,8397,8326,16723
2023,Veracruz,30,Ixmatlahuacan,30084,3033,3102,6135
2023,Veracruz,30,Ixtaczoquitlán,30085,35590,37758,73348
2023,Veracruz,30,Jalacingo,30086,22963,24044,47007
2023,Veracruz,30,Jalcomulco,30088,2752,2719,5471
2023,Veracruz,30,Jamapa,30090,5968,6248,12216
2023,Veracruz,30,Jesús Carranza,30091,15495,15570,31065
2023,Veracruz,30,Jilotepec,30093,8749,9177,17926
2023,Veracruz,30,José Azueta,30169,11894,12330,24224
2023,Veracruz,30,Juan Rodríguez Clara,30094,20691,21173,41864
2023,Veracruz,30,Juchique de Ferrer,30095,8302,8461,16763
2023,Veracruz,30,Jáltipan,30089,21326,23303,44629
2023,Veracruz,30,La Antigua,30016,13914,14957,28871
2023,Veracruz,30,La Perla,30127,14466,15036,29502
2023,Veracruz,30,Landero y Coss,30096,830,876,1706
2023,Veracruz,30,Las Choapas,30061,42530,44044,86574
2023,Veracruz,30,Las Minas,30107,1612,1552,3164
2023,Veracruz,30,Las Vigas de Ramírez,30132,10502,10567,21069
2023,Veracruz,30,Lerdo de Tejada,30097,9936,11392,21328
2023,Veracruz,30,Los Reyes,30137,3126,3169,6295
2023,Veracruz,30,Magdalena,30098,1627,1648,3275
2023,Veracruz,30,Maltrata,30099,9262,9867,19129
2023,Veracruz,30,Manlio Fabio Altamirano,30100,12443,12870,25313
2023,Veracruz,30,Mariano Escobedo,30101,18719,20150,38869
2023,Veracruz,30,Martínez de la Torre,30102,53548,58262,111810
2023,Veracruz,30,Mecatlán,30103,6431,6635,13066
2023,Veracruz,30,Mecayapan,30104,8697,9097,17794
2023,Veracruz,30,Medellín,30105,41751,45191,86942
2023,Veracruz,30,Miahuatlán,30106,2460,2536,4996
2023,Veracruz,30,Minatitlán,30108,80810,86081,166891
2023,Veracruz,30,Misantla,30109,33477,35199,68676
2023,Veracruz,30,Mixtla de Altamirano,30110,6264,6154,12418
2023,Veracruz,30,Moloacán,30111,8952,9455,18407
2023,Veracruz,30,Nanchital de Lázaro Cárdenas del Rio,30206,15406,16297,31703
2023,Veracruz,30,Naolinco,30112,11404,11930,23334
2023,Veracruz,30,Naranjal,30113,2346,2511,4857
2023,Veracruz,30,Naranjos Amatlán,30013,14521,16134,30655
2023,Veracruz,30,Nautla,30114,5790,6002,11792
2023,Veracruz,30,Nogales,30115,19343,21186,40529
2023,Veracruz,30,Oluta,30116,8475,9134,17609
2023,Veracruz,30,Omealca,30117,12362,13201,25563
2023,Veracruz,30,Orizaba,30118,62842,74040,136882
2023,Veracruz,30,Otatitlán,30119,2898,3162,6060
2023,Veracruz,30,Oteapan,30120,8570,8857,17427
2023,Veracruz,30,Ozuluama de Mascareñas,30121,12649,12123,24772
2023,Veracruz,30,Pajapan,30122,9255,9181,18436
2023,Veracruz,30,Papantla,30124,83024,84487,167511
2023,Veracruz,30,Paso de Ovejas,30126,17940,18093,36033
2023,Veracruz,30,Paso del Macho,30125,16754,17123,33877
2023,Veracruz,30,Perote,30128,38861,39210,78071
2023,Veracruz,30,Platón Sánchez,30129,9484,9913,19397
2023,Veracruz,30,Playa Vicente,30130,19050,20676,39726
2023,Veracruz,30,Poza Rica de Hidalgo,30131,105551,117060,222611
2023,Veracruz,30,Pueblo Viejo,30133,30885,30867,61752
2023,Veracruz,30,Puente Nacional,30134,11969,12341,24310
2023,Veracruz,30,Pánuco,30123,53519,53943,107462
2023,Veracruz,30,Rafael Delgado,30135,12277,12689,24966
2023,Veracruz,30,Rafael Lucio,30136,4235,4475,8710
2023,Veracruz,30,Río Blanco,30138,21214,24004,45218
2023,Veracruz,30,Saltabarranca,30139,3222,3444,6666
2023,Veracruz,30,San Andrés Tenejapan,30140,1538,1600,3138
2023,Veracruz,30,San Andrés Tuxtla,30141,84261,91062,175323
2023,Veracruz,30,San Juan Evangelista,30142,17746,18383,36129
2023,Veracruz,30,San Rafael,30211,15616,16226,31842
2023,Veracruz,30,Santiago Sochiapan,30212,7327,7820,15147
2023,Veracruz,30,Santiago Tuxtla,30143,29477,31749,61226
2023,Veracruz,30,Sayula de Alemán,30144,17109,17665,34774
2023,Veracruz,30,Sochiapa,30146,1940,1939,3879
2023,Veracruz,30,Soconusco,30145,8515,8958,17473
2023,Veracruz,30,Soledad Atzompa,30147,12231,12345,24576
2023,Veracruz,30,Soledad de Doblado,30148,14584,14898,29482
2023,Veracruz,30,Soteapan,30149,17937,18534,36471
2023,Veracruz,30,Tamalín,30150,6203,6173,12376
2023,Veracruz,30,Tamiahua,30151,12425,12382,24807
2023,Veracruz,30,Tampico Alto,30152,6895,6452,13347
2023,Veracruz,30,Tancoco,30153,2981,3170,6151
2023,Veracruz,30,Tantima,30154,7036,6808,13844
2023,Veracruz,30,Tantoyuca,30155,54322,55754,110076
2023,Veracruz,30,Tatahuicapan de Juárez,30209,8125,8444,16569
2023,Veracruz,30,Tatatila,30156,3271,3000,6271
2023,Veracruz,30,Tecolutla,30158,12566,12967,25533
2023,Veracruz,30,Tehuipango,30159,13419,14236,27655
2023,Veracruz,30,Tempoal,30161,18640,19285,37925
2023,Veracruz,30,Tenampa,30162,3530,3666,7196
2023,Veracruz,30,Tenochtitlán,30163,2649,2831,5480
2023,Veracruz,30,Teocelo,30164,8626,9149,17775
2023,Veracruz,30,Tepatlaxco,30165,4611,4372,8983
2023,Veracruz,30,Tepetlán,30166,5228,5071,10299
2023,Veracruz,30,Tepetzintla,30167,7711,7928,15639
2023,Veracruz,30,Tequila,30168,7956,8221,16177
2023,Veracruz,30,Texcatepec,30170,5681,5968,11649
2023,Veracruz,30,Texhuacán,30171,2686,2997,5683
2023,Veracruz,30,Texistepec,30172,11093,11038,22131
2023,Veracruz,30,Tezonapa,30173,29954,30637,60591
2023,Veracruz,30,Tierra Blanca,30174,54657,58795,113452
2023,Veracruz,30,Tihuatlán,30175,50417,52440,102857
2023,Veracruz,30,Tlachichilco,30180,6048,6260,12308
2023,Veracruz,30,Tlacojalpan,30176,2585,2694,5279
2023,Veracruz,30,Tlacolulan,30177,6099,5891,11990
2023,Veracruz,30,Tlacotalpan,30178,6836,7455,14291
2023,Veracruz,30,Tlacotepec de Mejía,30179,2085,2128,4213
2023,Veracruz,30,Tlalixcoyan,30181,20020,20684,40704
2023,Veracruz,30,Tlalnelhuayocan,30182,9916,10241,20157
2023,Veracruz,30,Tlaltetela,30024,8437,8195,16632
2023,Veracruz,30,Tlapacoyan,30183,32084,33947,66031
2023,Veracruz,30,Tlaquilpa,30184,3789,4337,8126
2023,Veracruz,30,Tlilapan,30185,2764,2902,5666
2023,Veracruz,30,Tomatlán,30186,3663,3770,7433
2023,Veracruz,30,Tonayán,30187,2920,3115,6035
2023,Veracruz,30,Totutla,30188,9264,9333,18597
2023,Veracruz,30,Tres Valles,30207,24009,25305,49314
2023,Veracruz,30,Tuxpan,30189,84580,88927,173507
2023,Veracruz,30,Tuxtilla,30190,1187,1219,2406
2023,Veracruz,30,Ursulo Galván,30191,16128,17050,33178
2023,Veracruz,30,Uxpanapa,30210,15645,15202,30847
2023,Veracruz,30,Vega de Alatorre,30192,10472,11195,21667
2023,Veracruz,30,Veracruz,30193,306144,332114,638258
2023,Veracruz,30,Villa Aldama,30194,6231,6379,12610
2023,Veracruz,30,Xalapa,30087,245314,275697,521011
2023,Veracruz,30,Xico,30092,20294,20830,41124
2023,Veracruz,30,Xoxocotla,30195,2941,2813,5754
2023,Veracruz,30,Yanga,30196,9102,10259,19361
2023,Veracruz,30,Yecuatla,30197,6277,6485,12762
2023,Veracruz,30,Zacualpan,30198,3694,3977,7671
2023,Veracruz,30,Zaragoza,30199,5874,6120,11994
2023,Veracruz,30,Zentla,30200,7216,7082,14298
2023,Veracruz,30,Zongolica,30201,22895,23394,46289
2023,Veracruz,30,Zontecomatlán de López y Fuentes,30202,7609,7815,15424
2023,Veracruz,30,Zozocolco de Hidalgo,30203,7857,8200,16057
2023,Veracruz,30,Álamo Temapache,30160,55471,56150,111621
2023,Yucatán,31,Abalá,31001,3694,3537,7231
2023,Yucatán,31,Acanceh,31002,8965,8955,17920
2023,Yucatán,31,Akil,31003,5967,6209,12176
2023,Yucatán,31,Baca,31004,3287,3366,6653
2023,Yucatán,31,Bokobá,31005,1240,1192,2432
2023,Yucatán,31,Buctzotz,31006,4929,4910,9839
2023,Yucatán,31,Cacalchén,31007,4119,3911,8030
2023,Yucatán,31,Calotmul,31008,2230,2226,4456
2023,Yucatán,31,Cansahcab,31009,2549,2595,5144
2023,Yucatán,31,Cantamayec,31010,1436,1321,2757
2023,Yucatán,31,Celestún,31011,4370,4149,8519
2023,Yucatán,31,Cenotillo,31012,2107,2251,4358
2023,Yucatán,31,Chacsinkín,31016,1657,1625,3282
2023,Yucatán,31,Chankom,31017,2553,2471,5024
2023,Yucatán,31,Chapab,31018,1749,1745,3494
2023,Yucatán,31,Chemax,31019,20183,19866,40049
2023,Yucatán,31,Chichimilá,31021,4638,4567,9205
2023,Yucatán,31,Chicxulub Pueblo,31020,2552,2422,4974
2023,Yucatán,31,Chikindzonot,31022,2293,2231,4524
2023,Yucatán,31,Chocholá,31023,2661,2570,5231
2023,Yucatán,31,Chumayel,31024,1766,1833,3599
2023,Yucatán,31,Conkal,31013,6217,6204,12421
2023,Yucatán,31,Cuncunul,31014,899,873,1772
2023,Yucatán,31,Cuzamá,31015,2888,2807,5695
2023,Yucatán,31,Dzemul,31026,2075,2064,4139
2023,Yucatán,31,Dzidzantún,31027,4613,4515,9128
2023,Yucatán,31,Dzilam González,31029,3448,3274,6722
2023,Yucatán,31,Dzilam de Bravo,31028,1537,1452,2989
2023,Yucatán,31,Dzitás,31030,2136,2035,4171
2023,Yucatán,31,Dzoncauich,31031,1438,1471,2909
2023,Yucatán,31,Dzán,31025,2869,2998,5867
2023,Yucatán,31,Espita,31032,9035,8765,17800
2023,Yucatán,31,Halachó,31033,11269,11020,22289
2023,Yucatán,31,Hocabá,31034,3404,3400,6804
2023,Yucatán,31,Hoctún,31035,3238,3306,6544
2023,Yucatán,31,Homún,31036,4323,4163,8486
2023,Yucatán,31,Huhí,31037,2940,2831,5771
2023,Yucatán,31,Hunucmá,31038,17900,17986,35886
2023,Yucatán,31,Ixil,31039,2308,2220,4528
2023,Yucatán,31,Izamal,31040,14759,15041,29800
2023,Yucatán,31,Kanasín,31041,56916,57714,114630
2023,Yucatán,31,Kantunil,31042,2898,3044,5942
2023,Yucatán,31,Kaua,31043,1739,1670,3409
2023,Yucatán,31,Kinchil,31044,4003,3909,7912
2023,Yucatán,31,Kopomá,31045,1452,1370,2822
2023,Yucatán,31,Mama,31046,1653,1828,3481
2023,Yucatán,31,Maní,31047,3032,3161,6193
2023,Yucatán,31,Maxcanú,31048,12607,12426,25033
2023,Yucatán,31,Mayapán,31049,2088,1937,4025
2023,Yucatán,31,Mocochá,31051,1841,1799,3640
2023,Yucatán,31,Motul,31052,20038,20368,40406
2023,Yucatán,31,Muna,31053,6834,7112,13946
2023,Yucatán,31,Muxupip,31054,1554,1620,3174
2023,Yucatán,31,Mérida,31050,479624,516962,996586
2023,Yucatán,31,Opichén,31055,3802,3676,7478
2023,Yucatán,31,Oxkutzcab,31056,16325,17810,34135
2023,Yucatán,31,Panabá,31057,4217,4244,8461
2023,Yucatán,31,Peto,31058,13732,13938,27670
2023,Yucatán,31,Progreso,31059,32354,32701,65055
2023,Yucatán,31,Quintana Roo,31060,529,529,1058
2023,Yucatán,31,Río Lagartos,31061,2010,1911,3921
2023,Yucatán,31,Sacalum,31062,2723,2585,5308
2023,Yucatán,31,Samahil,31063,2856,2840,5696
2023,Yucatán,31,San Felipe,31065,1092,1032,2124
2023,Yucatán,31,Sanahcat,31064,951,943,1894
2023,Yucatán,31,Santa Elena,31066,2136,2245,4381
2023,Yucatán,31,Seyé,31067,5423,5192,10615
2023,Yucatán,31,Sinanché,31068,1817,1675,3492
2023,Yucatán,31,Sotuta,31069,4979,4799,9778
2023,Yucatán,31,Sucilá,31070,2192,2121,4313
2023,Yucatán,31,Sudzal,31071,988,886,1874
2023,Yucatán,31,Suma,31072,1035,1003,2038
2023,Yucatán,31,Tahdziú,31073,2860,2688,5548
2023,Yucatán,31,Tahmek,31074,2101,2033,4134
2023,Yucatán,31,Teabo,31075,3607,3643,7250
2023,Yucatán,31,Tecoh,31076,9726,9653,19379
2023,Yucatán,31,Tekal de Venegas,31077,1486,1447,2933
2023,Yucatán,31,Tekantó,31078,2082,2088,4170
2023,Yucatán,31,Tekax,31079,22963,23742,46705
2023,Yucatán,31,Tekit,31080,5710,5547,11257
2023,Yucatán,31,Tekom,31081,1757,1780,3537
2023,Yucatán,31,Telchac Pueblo,31082,2119,2102,4221
2023,Yucatán,31,Telchac Puerto,31083,1028,934,1962
2023,Yucatán,31,Temax,31084,4019,4000,8019
2023,Yucatán,31,Temozón,31085,8633,8386,17019
2023,Yucatán,31,Tepakán,31086,1260,1205,2465
2023,Yucatán,31,Tetiz,31087,2775,2792,5567
2023,Yucatán,31,Teya,31088,1069,1087,2156
2023,Yucatán,31,Ticul,31089,21776,22403,44179
2023,Yucatán,31,Timucuy,31090,4142,3971,8113
2023,Yucatán,31,Tinum,31091,6684,6450,13134
2023,Yucatán,31,Tixcacalcupul,31092,3937,3889,7826
2023,Yucatán,31,Tixkokob,31093,9898,10081,19979
2023,Yucatán,31,Tixmehuac,31094,2681,2665,5346
2023,Yucatán,31,Tixpéhual,31095,3005,3111,6116
2023,Yucatán,31,Tizimín,31096,41974,43108,85082
2023,Yucatán,31,Tunkás,31097,1973,1892,3865
2023,Yucatán,31,Tzucacab,31098,8126,7967,16093
2023,Yucatán,31,Uayma,31099,2315,2218,4533
2023,Yucatán,31,Ucú,31100,2062,2035,4097
2023,Yucatán,31,Umán,31101,29644,29613,59257
2023,Yucatán,31,Valladolid,31102,43990,44733,88723
2023,Yucatán,31,Xocchel,31103,1965,1889,3854
2023,Yucatán,31,Yaxcabá,31104,8621,8124,16745
2023,Yucatán,31,Yaxkukul,31105,1743,1761,3504
2023,Yucatán,31,Yobaín,31106,1284,1235,2519
2023,Zacatecas,32,Apozol,32001,3105,3317,6422
2023,Zacatecas,32,Apulco,32002,2450,2711,5161
2023,Zacatecas,32,Atolinga,32003,1294,1377,2671
2023,Zacatecas,32,Benito Juárez,32004,2220,2144,4364
2023,Zacatecas,32,Calera,32005,24135,24093,48228
2023,Zacatecas,32,Cañitas de Felipe Pescador,32006,4351,4458,8809
2023,Zacatecas,32,Chalchihuites,32009,5912,6223,12135
2023,Zacatecas,32,Concepción del Oro,32007,7204,7075,14279
2023,Zacatecas,32,Cuauhtémoc,32008,6540,6892,13432
2023,Zacatecas,32,El Plateado de Joaquín Amaro,32015,677,691,1368
2023,Zacatecas,32,El Salvador,32041,1280,1240,2520
2023,Zacatecas,32,Fresnillo,32010,122247,125451,247698
2023,Zacatecas,32,Genaro Codina,32012,4238,4451,8689
2023,Zacatecas,32,General Enrique Estrada,32013,3325,3395,6720
2023,Zacatecas,32,General Francisco R. Murguía,32014,11213,11918,23131
2023,Zacatecas,32,General Pánfilo Natera,32016,12085,12547,24632
2023,Zacatecas,32,Guadalupe,32017,100483,105272,205755
2023,Zacatecas,32,Huanusco,32018,2121,2206,4327
2023,Zacatecas,32,Jalpa,32019,12652,13207,25859
2023,Zacatecas,32,Jerez,32020,31349,33223,64572
2023,Zacatecas,32,Jiménez del Teul,32021,2205,2243,4448
2023,Zacatecas,32,Juan Aldama,32022,11285,11951,23236
2023,Zacatecas,32,Juchipila,32023,6478,7190,13668
2023,Zacatecas,32,Loreto,32024,28703,29122,57825
2023,Zacatecas,32,Luis Moya,32025,7113,7169,14282
2023,Zacatecas,32,Mazapil,32026,9888,9001,18889
2023,Zacatecas,32,Melchor Ocampo,32027,1712,1505,3217
2023,Zacatecas,32,Mezquital del Oro,32028,1269,1378,2647
2023,Zacatecas,32,Miguel Auza,32029,12394,12881,25275
2023,Zacatecas,32,Momax,32030,1241,1333,2574
2023,Zacatecas,32,Monte Escobedo,32031,4926,5022,9948
2023,Zacatecas,32,Morelos,32032,6669,6717,13386
2023,Zacatecas,32,Moyahua de Estrada,32033,1994,2258,4252
2023,Zacatecas,32,Nochistlán de Mejía,32034,14267,15663,29930
2023,Zacatecas,32,Noria de Ángeles,32035,8884,9156,18040
2023,Zacatecas,32,Ojocaliente,32036,22504,23481,45985
2023,Zacatecas,32,Pinos,32038,38187,39902,78089
2023,Zacatecas,32,Pánuco,32037,9601,9565,19166
2023,Zacatecas,32,Río Grande,32039,33326,35354,68680
2023,Zacatecas,32,Sain Alto,32040,11551,12160,23711
2023,Zacatecas,32,Santa María de la Paz,32058,1432,1455,2887
2023,Zacatecas,32,Sombrerete,32042,32669,33627,66296
2023,Zacatecas,32,Susticacán,32043,701,768,1469
2023,Zacatecas,32,Tabasco,32044,8092,8503,16595
2023,Zacatecas,32,Tepechitlán,32045,4490,4891,9381
2023,Zacatecas,32,Tepetongo,32046,3730,3956,7686
2023,Zacatecas,32,Teúl de González Ortega,32047,2512,2645,5157
2023,Zacatecas,32,Tlaltenango de Sánchez Román,32048,14093,14677,28770
2023,Zacatecas,32,Trancoso,32057,10238,10465,20703
2023,Zacatecas,32,Trinidad García de la Cadena,32011,1504,1556,3060
2023,Zacatecas,32,Valparaíso,32049,17503,17996,35499
2023,Zacatecas,32,Vetagrande,32050,5315,5451,10766
2023,Zacatecas,32,Villa García,32052,10190,10360,20550
2023,Zacatecas,32,Villa González Ortega,32053,6906,7303,14209
2023,Zacatecas,32,Villa Hidalgo,32054,10171,10302,20473
2023,Zacatecas,32,Villa de Cos,32051,19000,18743,37743
2023,Zacatecas,32,Villanueva,32055,15892,16539,32431
2023,Zacatecas,32,Zacatecas,32056,76831,81367,158198
2024,Aguascalientes,01,Aguascalientes,01001,495734,515612,1011346
2024,Aguascalientes,01,Asientos,01002,26399,26608,53007
2024,Aguascalientes,01,Calvillo,01003,31210,32433,63643
2024,Aguascalientes,01,Cosío,01004,8650,8938,17588
2024,Aguascalientes,01,El Llano,01010,11615,11304,22919
2024,Aguascalientes,01,Jesús María,01005,69207,68363,137570
2024,Aguascalientes,01,Pabellón de Arteaga,01006,25493,26652,52145
2024,Aguascalientes,01,Rincón de Romos,01007,30067,30378,60445
2024,Aguascalientes,01,San Francisco de los Romo,01011,27386,27437,54823
2024,Aguascalientes,01,San José de Gracia,01008,4920,5201,10121
2024,Aguascalientes,01,Tepezalá,01009,11774,12093,23867
2024,Baja California,02,Ensenada,02001,283953,284999,568952
2024,Baja California,02,Mexicali,02002,577113,581370,1158483
2024,Baja California,02,Playas de Rosarito,02005,57396,57226,114622
2024,Baja California,02,Tecate,02003,61829,58551,120380
2024,Baja California,02,Tijuana,02004,939690,947578,1887268
2024,Baja California Sur,03,Comondú,03001,45557,44369,89926
2024,Baja California Sur,03,La Paz,03003,161280,163228,324508
2024,Baja California Sur,03,Loreto,03009,12334,11324,23658
2024,Baja California Sur,03,Los Cabos,03008,184446,174196,358642
2024,Baja California Sur,03,Mulegé,03002,37196,34692,71888
2024,Campeche,04,Calakmul,04010,17037,16381,33418
2024,Campeche,04,Calkiní,04001,33059,34186,67245
2024,Campeche,04,Campeche,04002,163119,175403,338522
2024,Campeche,04,Candelaria,04011,26232,25452,51684
2024,Campeche,04,Carmen,04003,146125,147148,293273
2024,Campeche,04,Champotón,04004,53680,53164,106844
2024,Campeche,04,Escárcega,04009,33248,33887,67135
2024,Campeche,04,Hecelchakán,04005,18364,18446,36810
2024,Campeche,04,Hopelchén,04006,24047,22965,47012
2024,Campeche,04,Palizada,04007,5281,5166,10447
2024,Campeche,04,Tenabo,04008,6504,6177,12681
2024,Chiapas,07,Acacoyagua,07001,10532,10457,20989
2024,Chiapas,07,Acala,07002,18089,18443,36532
2024,Chiapas,07,Acapetahua,07003,16441,16404,32845
2024,Chiapas,07,Aldama,07113,3635,3935,7570
2024,Chiapas,07,Altamirano,07004,19124,18903,38027
2024,Chiapas,07,Amatenango de la Frontera,07006,17383,18384,35767
2024,Chiapas,07,Amatenango del Valle,07007,5444,5902,11346
2024,Chiapas,07,Amatán,07005,11433,11126,22559
2024,Chiapas,07,Angel Albino Corzo,07008,16088,16232,32320
2024,Chiapas,07,Arriaga,07009,22461,24105,46566
2024,Chiapas,07,Bejucal de Ocampo,07010,4393,4358,8751
2024,Chiapas,07,Bella Vista,07011,11544,11683,23227
2024,Chiapas,07,Benemérito de las Américas,07114,11616,11373,22989
2024,Chiapas,07,Berriozábal,07012,30393,30663,61056
2024,Chiapas,07,Bochil,07013,19892,20309,40201
2024,Chiapas,07,Cacahoatán,07015,25921,27274,53195
2024,Chiapas,07,Catazajá,07016,10091,9967,20058
2024,Chiapas,07,Chalchihuitán,07022,9344,9520,18864
2024,Chiapas,07,Chamula,07023,46504,54486,100990
2024,Chiapas,07,Chanal,07024,7053,7090,14143
2024,Chiapas,07,Chapultenango,07025,4309,4292,8601
2024,Chiapas,07,Chenalhó,07026,22791,23289,46080
2024,Chiapas,07,Chiapa de Corzo,07027,58202,60457,118659
2024,Chiapas,07,Chiapilla,07028,3443,3321,6764
2024,Chiapas,07,Chicoasén,07029,2909,2927,5836
2024,Chiapas,07,Chicomuselo,07030,20147,20404,40551
2024,Chiapas,07,Chilón,07031,73349,75098,148447
2024,Chiapas,07,Cintalapa,07017,49268,49839,99107
2024,Chiapas,07,Coapilla,07018,5205,5357,10562
2024,Chiapas,07,Comitán de Domínguez,07019,86096,94590,180686
2024,Chiapas,07,Copainalá,07021,12302,12903,25205
2024,Chiapas,07,El Bosque,07014,12553,13427,25980
2024,Chiapas,07,El Porvenir,07070,8120,8187,16307
2024,Chiapas,07,Escuintla,07032,17980,18516,36496
2024,Chiapas,07,Francisco León,07033,4415,4276,8691
2024,Chiapas,07,Frontera Comalapa,07034,41704,44078,85782
2024,Chiapas,07,Frontera Hidalgo,07035,8174,8604,16778
2024,Chiapas,07,Huehuetán,07037,19578,20679,40257
2024,Chiapas,07,Huitiupán,07039,13209,13037,26246
2024,Chiapas,07,Huixtla,07040,30081,32363,62444
2024,Chiapas,07,Huixtán,07038,13328,13795,27123
2024,Chiapas,07,Ixhuatán,07042,6429,6597,13026
2024,Chiapas,07,Ixtacomitán,07043,6118,6222,12340
2024,Chiapas,07,Ixtapa,07044,15591,15788,31379
2024,Chiapas,07,Ixtapangajoya,07045,3187,3104,6291
2024,Chiapas,07,Jiquipilas,07046,22529,23373,45902
2024,Chiapas,07,Jitotol,07047,12105,11794,23899
2024,Chiapas,07,Juárez,07048,12246,12588,24834
2024,Chiapas,07,La Concordia,07020,26703,26386,53089
2024,Chiapas,07,La Grandeza,07036,4061,4171,8232
2024,Chiapas,07,La Independencia,07041,25769,26702,52471
2024,Chiapas,07,La Libertad,07050,2784,2882,5666
2024,Chiapas,07,La Trinitaria,07099,44438,46542,90980
2024,Chiapas,07,Larráinzar,07049,13398,13879,27277
2024,Chiapas,07,Las Margaritas,07052,70854,72136,142990
2024,Chiapas,07,Las Rosas,07075,16034,16411,32445
2024,Chiapas,07,Mapastepec,07051,27030,27976,55006
2024,Chiapas,07,Maravilla Tenejapa,07115,7363,7124,14487
2024,Chiapas,07,Marqués de Comillas,07116,6620,6429,13049
2024,Chiapas,07,Mazapa de Madero,07053,4435,4605,9040
2024,Chiapas,07,Mazatán,07054,16622,17187,33809
2024,Chiapas,07,Metapa,07055,3145,3403,6548
2024,Chiapas,07,Mitontic,07056,6951,7010,13961
2024,Chiapas,07,Montecristo de Guerrero,07117,4418,4312,8730
2024,Chiapas,07,Motozintla,07057,41234,42858,84092
2024,Chiapas,07,Nicolás Ruíz,07058,2530,2389,4919
2024,Chiapas,07,Ocosingo,07059,125734,126703,252437
2024,Chiapas,07,Ocotepec,07060,7042,7354,14396
2024,Chiapas,07,Ocozocoautla de Espinosa,07061,52234,53664,105898
2024,Chiapas,07,Ostuacán,07062,10595,10465,21060
2024,Chiapas,07,Osumacinta,07063,2142,2147,4289
2024,Chiapas,07,Oxchuc,07064,27247,26995,54242
2024,Chiapas,07,Palenque,07065,68101,70258,138359
2024,Chiapas,07,Pantelhó,07066,12488,12691,25179
2024,Chiapas,07,Pantepec,07067,7013,7130,14143
2024,Chiapas,07,Pichucalco,07068,17839,18286,36125
2024,Chiapas,07,Pijijiapan,07069,30315,31197,61512
2024,Chiapas,07,Pueblo Nuevo Solistahuacán,07072,17531,19076,36607
2024,Chiapas,07,Rayón,07073,5504,5611,11115
2024,Chiapas,07,Reforma,07074,26045,26508,52553
2024,Chiapas,07,Sabanilla,07076,15455,15279,30734
2024,Chiapas,07,Salto de Agua,07077,35999,36406,72405
2024,Chiapas,07,San Andrés Duraznal,07118,3050,3214,6264
2024,Chiapas,07,San Cristóbal de las Casas,07078,115874,128572,244446
2024,Chiapas,07,San Fernando,07079,23113,22678,45791
2024,Chiapas,07,San Juan Cancuc,07112,19706,20584,40290
2024,Chiapas,07,San Lucas,07110,4142,4163,8305
2024,Chiapas,07,Santiago el Pinar,07119,2096,2049,4145
2024,Chiapas,07,Siltepec,07080,20837,20184,41021
2024,Chiapas,07,Simojovel,07081,25188,25618,50806
2024,Chiapas,07,Sitalá,07082,8210,8295,16505
2024,Chiapas,07,Socoltenango,07083,10547,10621,21168
2024,Chiapas,07,Solosuchiapa,07084,4592,4549,9141
2024,Chiapas,07,Soyaló,07085,6224,6173,12397
2024,Chiapas,07,Suchiapa,07086,14087,14095,28182
2024,Chiapas,07,Suchiate,07087,21756,22718,44474
2024,Chiapas,07,Sunuapa,07088,1394,1362,2756
2024,Chiapas,07,Tapachula,07089,194701,212789,407490
2024,Chiapas,07,Tapalapa,07090,2214,2328,4542
2024,Chiapas,07,Tapilula,07091,7325,7718,15043
2024,Chiapas,07,Tecpatán,07092,23668,24031,47699
2024,Chiapas,07,Tenejapa,07093,24291,25643,49934
2024,Chiapas,07,Teopisca,07094,24252,25663,49915
2024,Chiapas,07,Tila,07096,45228,45114,90342
2024,Chiapas,07,Tonalá,07097,50872,52342,103214
2024,Chiapas,07,Totolapa,07098,4185,4142,8327
2024,Chiapas,07,Tumbalá,07100,19185,20129,39314
2024,Chiapas,07,Tuxtla Chico,07102,23713,25216,48929
2024,Chiapas,07,Tuxtla Gutiérrez,07101,331915,366783,698698
2024,Chiapas,07,Tuzantán,07103,18373,18922,37295
2024,Chiapas,07,Tzimol,07104,8725,9151,17876
2024,Chiapas,07,Unión Juárez,07105,8663,9155,17818
2024,Chiapas,07,Venustiano Carranza,07106,37076,37477,74553
2024,Chiapas,07,Villa Comaltitlán,07071,16348,16757,33105
2024,Chiapas,07,Villa Corzo,07107,44208,45873,90081
2024,Chiapas,07,Villaflores,07108,59641,62403,122044
2024,Chiapas,07,Yajalón,07109,21505,22518,44023
2024,Chiapas,07,Zinacantán,07111,22089,25174,47263
2024,Chihuahua,08,Ahumada,08001,6768,6633,13401
2024,Chihuahua,08,Aldama,08002,13655,13803,27458
2024,Chihuahua,08,Allende,08003,5063,4944,10007
2024,Chihuahua,08,Aquiles Serdán,08004,10428,9920,20348
2024,Chihuahua,08,Ascensión,08005,13743,13438,27181
2024,Chihuahua,08,Bachíniva,08006,3667,3525,7192
2024,Chihuahua,08,Balleza,08007,9258,8995,18253
2024,Chihuahua,08,Batopilas,08008,6457,6496,12953
2024,Chihuahua,08,Bocoyna,08009,14856,15528,30384
2024,Chihuahua,08,Buenaventura,08010,13129,12868,25997
2024,Chihuahua,08,Camargo,08011,28370,29467,57837
2024,Chihuahua,08,Carichí,08012,5394,5299,10693
2024,Chihuahua,08,Casas Grandes,08013,6583,6290,12873
2024,Chihuahua,08,Chihuahua,08019,482049,508993,991042
2024,Chihuahua,08,Chínipas,08020,4628,4197,8825
2024,Chihuahua,08,Coronado,08014,1315,1210,2525
2024,Chihuahua,08,Coyame del Sotol,08015,1073,880,1953
2024,Chihuahua,08,Cuauhtémoc,08017,92352,98375,190727
2024,Chihuahua,08,Cusihuiriachi,08018,2765,2563,5328
2024,Chihuahua,08,Delicias,08021,81931,86103,168034
2024,Chihuahua,08,Dr. Belisario Domínguez,08022,1528,1487,3015
2024,Chihuahua,08,El Tule,08064,983,945,1928
2024,Chihuahua,08,Galeana,08023,3702,3698,7400
2024,Chihuahua,08,Gran Morelos,08026,1508,1448,2956
2024,Chihuahua,08,Guachochi,08027,24882,26142,51024
2024,Chihuahua,08,Guadalupe,08028,2368,2438,4806
2024,Chihuahua,08,Guadalupe y Calvo,08029,30249,29652,59901
2024,Chihuahua,08,Guazapares,08030,4558,4351,8909
2024,Chihuahua,08,Guerrero,08031,22373,22043,44416
2024,Chihuahua,08,Gómez Farías,08025,5117,5087,10204
2024,Chihuahua,08,Hidalgo del Parral,08032,59097,62982,122079
2024,Chihuahua,08,Huejotitán,08033,573,572,1145
2024,Chihuahua,08,Ignacio Zaragoza,08034,4002,3931,7933
2024,Chihuahua,08,Janos,08035,6478,5919,12397
2024,Chihuahua,08,Jiménez,08036,23555,23965,47520
2024,Chihuahua,08,Julimes,08038,2618,2529,5147
2024,Chihuahua,08,Juárez,08037,747363,749910,1497273
2024,Chihuahua,08,La Cruz,08016,2285,2166,4451
2024,Chihuahua,08,López,08039,2377,2209,4586
2024,Chihuahua,08,Madera,08040,16045,15873,31918
2024,Chihuahua,08,Maguarichi,08041,889,840,1729
2024,Chihuahua,08,Manuel Benavides,08042,905,765,1670
2024,Chihuahua,08,Matachí,08043,1764,1742,3506
2024,Chihuahua,08,Matamoros,08044,2617,2516,5133
2024,Chihuahua,08,Meoqui,08045,24835,25365,50200
2024,Chihuahua,08,Morelos,08046,4218,4139,8357
2024,Chihuahua,08,Moris,08047,2943,2764,5707
2024,Chihuahua,08,Namiquipa,08048,14051,13380,27431
2024,Chihuahua,08,Nonoava,08049,1521,1440,2961
2024,Chihuahua,08,Nuevo Casas Grandes,08050,34329,35884,70213
2024,Chihuahua,08,Ocampo,08051,4312,3994,8306
2024,Chihuahua,08,Ojinaga,08052,15937,15748,31685
2024,Chihuahua,08,Praxedis G. Guerrero,08053,2518,2483,5001
2024,Chihuahua,08,Riva Palacio,08054,4354,4190,8544
2024,Chihuahua,08,Rosales,08055,9686,9519,19205
2024,Chihuahua,08,Rosario,08056,1186,1124,2310
2024,Chihuahua,08,San Francisco de Borja,08057,1363,1281,2644
2024,Chihuahua,08,San Francisco de Conchos,08058,1535,1433,2968
2024,Chihuahua,08,San Francisco del Oro,08059,2988,2971,5959
2024,Chihuahua,08,Santa Bárbara,08060,6097,6195,12292
2024,Chihuahua,08,Santa Isabel,08024,2234,2290,4524
2024,Chihuahua,08,Satevó,08061,1827,1719,3546
2024,Chihuahua,08,Saucillo,08062,17968,17757,35725
2024,Chihuahua,08,Temósachic,08063,3814,3646,7460
2024,Chihuahua,08,Urique,08065,11700,11335,23035
2024,Chihuahua,08,Uruachi,08066,3367,3208,6575
2024,Chihuahua,08,Valle de Zaragoza,08067,3109,2968,6077
2024,Ciudad de México,09,Azcapotzalco,09002,190228,215248,405476
2024,Ciudad de México,09,Benito Juárez,09014,204014,239319,443333
2024,Ciudad de México,09,Coyoacán,09003,289614,328363,617977
2024,Ciudad de México,09,Cuajimalpa de Morelos,09004,95401,102870,198271
2024,Ciudad de México,09,Cuauhtémoc,09015,261178,289530,550708
2024,Ciudad de México,09,Gustavo A. Madero,09005,558879,606920,1165799
2024,Ciudad de México,09,Iztacalco,09006,185531,206612,392143
2024,Ciudad de México,09,Iztapalapa,09007,862852,916984,1779836
2024,Ciudad de México,09,La Magdalena Contreras,09008,116721,125976,242697
2024,Ciudad de México,09,Miguel Hidalgo,09016,176694,205582,382276
2024,Ciudad de México,09,Milpa Alta,09009,67467,70505,137972
2024,Ciudad de México,09,Tlalpan,09012,324252,353704,677956
2024,Ciudad de México,09,Tláhuac,09011,173186,186370,359556
2024,Ciudad de México,09,Venustiano Carranza,09017,202618,228598,431216
2024,Ciudad de México,09,Xochimilco,09013,200569,209387,409956
2024,Ciudad de México,09,Álvaro Obregón,09010,358037,392975,751012
2024,Coahuila,05,Abasolo,05001,607,599,1206
2024,Coahuila,05,Acuña,05002,84740,84075,168815
2024,Coahuila,05,Allende,05003,12751,13057,25808
2024,Coahuila,05,Arteaga,05004,13745,13111,26856
2024,Coahuila,05,Candela,05005,1085,982,2067
2024,Coahuila,05,Castaños,05006,16149,16088,32237
2024,Coahuila,05,Cuatro Ciénegas,05007,7762,7601,15363
2024,Coahuila,05,Escobedo,05008,1811,1729,3540
2024,Coahuila,05,Francisco I. Madero,05009,34103,34149,68252
2024,Coahuila,05,Frontera,05010,46467,45959,92426
2024,Coahuila,05,General Cepeda,05011,7448,6832,14280
2024,Coahuila,05,Guerrero,05012,1082,967,2049
2024,Coahuila,05,Hidalgo,05013,998,958,1956
2024,Coahuila,05,Jiménez,05014,5800,5617,11417
2024,Coahuila,05,Juárez,05015,949,865,1814
2024,Coahuila,05,Lamadrid,05016,1090,1022,2112
2024,Coahuila,05,Matamoros,05017,62663,62423,125086
2024,Coahuila,05,Monclova,05018,131373,133100,264473
2024,Coahuila,05,Morelos,05019,5046,4911,9957
2024,Coahuila,05,Múzquiz,05020,40330,39404,79734
2024,Coahuila,05,Nadadores,05021,3785,3731,7516
2024,Coahuila,05,Nava,05022,17753,16832,34585
2024,Coahuila,05,Ocampo,05023,6141,5691,11832
2024,Coahuila,05,Parras,05024,25838,24691,50529
2024,Coahuila,05,Piedras Negras,05025,92897,91996,184893
2024,Coahuila,05,Progreso,05026,1987,1849,3836
2024,Coahuila,05,Ramos Arizpe,05027,56456,54122,110578
2024,Coahuila,05,Sabinas,05028,36736,36513,73249
2024,Coahuila,05,Sacramento,05029,1402,1361,2763
2024,Coahuila,05,Saltillo,05030,456112,458795,914907
2024,Coahuila,05,San Buenaventura,05031,13700,13677,27377
2024,Coahuila,05,San Juan de Sabinas,05032,24462,25433,49895
2024,Coahuila,05,San Pedro,05033,62144,62246,124390
2024,Coahuila,05,Sierra Mojada,05034,4381,4039,8420
2024,Coahuila,05,Torreón,05035,383157,400974,784131
2024,Coahuila,05,Viesca,05036,12828,12321,25149
2024,Coahuila,05,Villa Unión,05037,3672,3479,7151
2024,Coahuila,05,Zaragoza,05038,7429,7368,14797
2024,Colima,06,Armería,06001,17321,16978,34299
2024,Colima,06,Colima,06002,87466,92176,179642
2024,Colima,06,Comala,06003,12715,12498,25213
2024,Colima,06,Coquimatlán,06004,11858,11544,23402
2024,Colima,06,Cuauhtémoc,06005,17589,17325,34914
2024,Colima,06,Ixtlahuacán,06006,3273,3194,6467
2024,Colima,06,Manzanillo,06007,109365,106640,216005
2024,Colima,06,Minatitlán,06008,5359,4899,10258
2024,Colima,06,Tecomán,06009,71967,70356,142323
2024,Colima,06,Villa de Álvarez,06010,78019,81655,159674
2024,Durango,10,Canatlán,10001,17787,18236,36023
2024,Durango,10,Canelas,10002,2588,2360,4948
2024,Durango,10,Coneto de Comonfort,10003,2374,2400,4774
2024,Durango,10,Cuencamé,10004,19521,19187,38708
2024,Durango,10,Durango,10005,348174,372120,720294
2024,Durango,10,El Oro,10018,6389,6456,12845
2024,Durango,10,General Simón Bolívar,10006,5521,5630,11151
2024,Durango,10,Guadalupe Victoria,10008,19326,19665,38991
2024,Durango,10,Guanaceví,10009,5550,5200,10750
2024,Durango,10,Gómez Palacio,10007,188191,192242,380433
2024,Durango,10,Hidalgo,10010,2171,2112,4283
2024,Durango,10,Indé,10011,2855,2827,5682
2024,Durango,10,Lerdo,10012,84698,85559,170257
2024,Durango,10,Mapimí,10013,14665,14635,29300
2024,Durango,10,Mezquital,10014,20496,21147,41643
2024,Durango,10,Nazas,10015,7194,7214,14408
2024,Durango,10,Nombre de Dios,10016,10817,10871,21688
2024,Durango,10,Nuevo Ideal,10039,14864,15008,29872
2024,Durango,10,Ocampo,10017,5516,5294,10810
2024,Durango,10,Otáez,10019,2910,2683,5593
2024,Durango,10,Peñón Blanco,10021,5998,5919,11917
2024,Durango,10,Poanas,10022,13741,14076,27817
2024,Durango,10,Pueblo Nuevo,10023,26744,26963,53707
2024,Durango,10,Pánuco de Coronado,10020,6577,6753,13330
2024,Durango,10,Rodeo,10024,7556,7502,15058
2024,Durango,10,San Bernardo,10025,1903,1692,3595
2024,Durango,10,San Dimas,10026,10509,9866,20375
2024,Durango,10,San Juan de Guadalupe,10027,2983,3086,6069
2024,Durango,10,San Juan del Río,10028,6857,7013,13870
2024,Durango,10,San Luis del Cordero,10029,1189,1153,2342
2024,Durango,10,San Pedro del Gallo,10030,889,814,1703
2024,Durango,10,Santa Clara,10031,3885,3885,7770
2024,Durango,10,Santiago Papasquiaro,10032,26386,26381,52767
2024,Durango,10,Súchil,10033,3289,3585,6874
2024,Durango,10,Tamazula,10034,14301,13092,27393
2024,Durango,10,Tepehuanes,10035,5908,5932,11840
2024,Durango,10,Tlahualilo,10036,13231,12955,26186
2024,Durango,10,Topia,10037,5286,4928,10214
2024,Durango,10,Vicente Guerrero,10038,11590,12298,23888
2024,Estado de México,15,Acambay de Ruíz Castañeda,15001,35002,37079,72081
2024,Estado de México,15,Acolman,15002,99279,98889,198168
2024,Estado de México,15,Aculco,15003,26838,27414,54252
2024,Estado de México,15,Almoloya de Alquisiras,15004,7679,8320,15999
2024,Estado de México,15,Almoloya de Juárez,15005,97551,99413,196964
2024,Estado de México,15,Almoloya del Río,15006,6136,6556,12692
2024,Estado de México,15,Amanalco,15007,13101,13605,26706
2024,Estado de México,15,Amatepec,15008,14330,15133,29463
2024,Estado de México,15,Amecameca,15009,27237,29099,56336
2024,Estado de México,15,Apaxco,15010,16177,16564,32741
2024,Estado de México,15,Atenco,15011,36396,37161,73557
2024,Estado de México,15,Atizapán,15012,6324,6679,13003
2024,Estado de México,15,Atizapán de Zaragoza,15013,278580,295292,573872
2024,Estado de México,15,Atlacomulco,15014,53492,57998,111490
2024,Estado de México,15,Atlautla,15015,16683,17380,34063
2024,Estado de México,15,Axapusco,15016,15655,15805,31460
2024,Estado de México,15,Ayapango,15017,5744,5963,11707
2024,Estado de México,15,Calimaya,15018,30981,32411,63392
2024,Estado de México,15,Capulhuac,15019,19181,20320,39501
2024,Estado de México,15,Chalco,15025,208172,216434,424606
2024,Estado de México,15,Chapa de Mota,15026,15448,16060,31508
2024,Estado de México,15,Chapultepec,15027,6799,6990,13789
2024,Estado de México,15,Chiautla,15028,16423,16971,33394
2024,Estado de México,15,Chicoloapan,15029,115690,122715,238405
2024,Estado de México,15,Chiconcuac,15030,14270,14623,28893
2024,Estado de México,15,Chimalhuacán,15031,363912,376256,740168
2024,Estado de México,15,Coacalco de Berriozábal,15020,153091,165165,318256
2024,Estado de México,15,Coatepec Harinas,15021,20883,22361,43244
2024,Estado de México,15,Cocotitlán,15022,7865,8235,16100
2024,Estado de México,15,Coyotepec,15023,22403,22839,45242
2024,Estado de México,15,Cuautitlán,15024,90799,92811,183610
2024,Estado de México,15,Cuautitlán Izcalli,15121,290389,305512,595901
2024,Estado de México,15,Donato Guerra,15032,18275,18874,37149
2024,Estado de México,15,Ecatepec de Morelos,15033,865349,887982,1753331
2024,Estado de México,15,Ecatzingo,15034,5114,5267,10381
2024,Estado de México,15,El Oro,15064,19918,21168,41086
2024,Estado de México,15,Huehuetoca,15035,77614,79568,157182
2024,Estado de México,15,Hueypoxtla,15036,24581,24075,48656
2024,Estado de México,15,Huixquilucan,15037,146130,156490,302620
2024,Estado de México,15,Isidro Fabela,15038,6469,6567,13036
2024,Estado de México,15,Ixtapaluca,15039,279717,289991,569708
2024,Estado de México,15,Ixtapan de la Sal,15040,19223,20591,39814
2024,Estado de México,15,Ixtapan del Oro,15041,3823,3727,7550
2024,Estado de México,15,Ixtlahuaca,15042,81906,87593,169499
2024,Estado de México,15,Jaltenco,15044,14419,15309,29728
2024,Estado de México,15,Jilotepec,15045,48631,50175,98806
2024,Estado de México,15,Jilotzingo,15046,10465,11031,21496
2024,Estado de México,15,Jiquipilco,15047,39970,42444,82414
2024,Estado de México,15,Jocotitlán,15048,35403,37859,73262
2024,Estado de México,15,Joquicingo,15049,7478,7784,15262
2024,Estado de México,15,Juchitepec,15050,13963,14342,28305
2024,Estado de México,15,La Paz,15070,158657,162456,321113
2024,Estado de México,15,Lerma,15051,82674,84823,167497
2024,Estado de México,15,Luvianos,15123,15295,15463,30758
2024,Estado de México,15,Malinalco,15052,15177,15573,30750
2024,Estado de México,15,Melchor Ocampo,15053,31504,32791,64295
2024,Estado de México,15,Metepec,15054,123570,131256,254826
2024,Estado de México,15,Mexicaltzingo,15055,6951,7392,14343
2024,Estado de México,15,Morelos,15056,15845,17163,33008
2024,Estado de México,15,Naucalpan de Juárez,15057,458986,485851,944837
2024,Estado de México,15,Nextlalpan,15059,22812,23245,46057
2024,Estado de México,15,Nezahualcóyotl,15058,565592,608825,1174417
2024,Estado de México,15,Nicolás Romero,15060,225939,235036,460975
2024,Estado de México,15,Nopaltepec,15061,5021,5049,10070
2024,Estado de México,15,Ocoyoacac,15062,36774,37947,74721
2024,Estado de México,15,Ocuilan,15063,18698,19401,38099
2024,Estado de México,15,Otumba,15065,19980,19657,39637
2024,Estado de México,15,Otzoloapan,15066,2138,2088,4226
2024,Estado de México,15,Otzolotepec,15067,46566,47646,94212
2024,Estado de México,15,Ozumba,15068,15592,16790,32382
2024,Estado de México,15,Papalotla,15069,2187,2301,4488
2024,Estado de México,15,Polotitlán,15071,7723,8032,15755
2024,Estado de México,15,Rayón,15072,7517,7735,15252
2024,Estado de México,15,San Antonio la Isla,15073,16725,17114,33839
2024,Estado de México,15,San Felipe del Progreso,15074,66827,74813,141640
2024,Estado de México,15,San José del Rincón,15124,50015,50903,100918
2024,Estado de México,15,San Martín de las Pirámides,15075,15029,15368,30397
2024,Estado de México,15,San Mateo Atenco,15076,40950,42315,83265
2024,Estado de México,15,San Simón de Guerrero,15077,3279,3476,6755
2024,Estado de México,15,Santo Tomás,15078,5238,5373,10611
2024,Estado de México,15,Soyaniquilpan de Juárez,15079,7444,7588,15032
2024,Estado de México,15,Sultepec,15080,13796,15316,29112
2024,Estado de México,15,Tecámac,15081,259978,272065,532043
2024,Estado de México,15,Tejupilco,15082,39328,42486,81814
2024,Estado de México,15,Temamatla,15083,6895,7315,14210
2024,Estado de México,15,Temascalapa,15084,21606,21598,43204
2024,Estado de México,15,Temascalcingo,15085,33288,36104,69392
2024,Estado de México,15,Temascaltepec,15086,17355,18028,35383
2024,Estado de México,15,Temoaya,15087,55373,58399,113772
2024,Estado de México,15,Tenancingo,15088,53362,56286,109648
2024,Estado de México,15,Tenango del Aire,15089,6932,7086,14018
2024,Estado de México,15,Tenango del Valle,15090,46944,48742,95686
2024,Estado de México,15,Teoloyucan,15091,34547,35240,69787
2024,Estado de México,15,Teotihuacán,15092,31125,32108,63233
2024,Estado de México,15,Tepetlaoxtoc,15093,17099,17381,34480
2024,Estado de México,15,Tepetlixpa,15094,10839,11107,21946
2024,Estado de México,15,Tepotzotlán,15095,53681,55479,109160
2024,Estado de México,15,Tequixquiac,15096,20534,20718,41252
2024,Estado de México,15,Texcaltitlán,15097,10125,10748,20873
2024,Estado de México,15,Texcalyacac,15098,2920,3002,5922
2024,Estado de México,15,Texcoco,15099,131639,139685,271324
2024,Estado de México,15,Tezoyuca,15100,24530,24751,49281
2024,Estado de México,15,Tianguistenco,15101,41659,43884,85543
2024,Estado de México,15,Timilpan,15102,8364,9054,17418
2024,Estado de México,15,Tlalmanalco,15103,25653,27570,53223
2024,Estado de México,15,Tlalnepantla de Baz,15104,382540,408619,791159
2024,Estado de México,15,Tlatlaya,15105,19280,19985,39265
2024,Estado de México,15,Toluca,15106,476361,509579,985940
2024,Estado de México,15,Tonanitla,15125,5487,5624,11111
2024,Estado de México,15,Tonatico,15107,6891,7317,14208
2024,Estado de México,15,Tultepec,15108,82171,85183,167354
2024,Estado de México,15,Tultitlán,15109,280108,290559,570667
2024,Estado de México,15,Valle de Bravo,15110,35481,36813,72294
2024,Estado de México,15,Valle de Chalco Solidaridad,15122,213699,220821,434520
2024,Estado de México,15,Villa Guerrero,15113,36867,37861,74728
2024,Estado de México,15,Villa Victoria,15114,57156,57817,114973
2024,Estado de México,15,Villa de Allende,15111,27753,28871,56624
2024,Estado de México,15,Villa del Carbón,15112,26340,26037,52377
2024,Estado de México,15,Xalatlaco,15043,16404,17261,33665
2024,Estado de México,15,Xonacatlán,15115,28265,27990,56255
2024,Estado de México,15,Zacazonapan,15116,2238,2211,4449
2024,Estado de México,15,Zacualpan,15117,7959,8737,16696
2024,Estado de México,15,Zinacantepec,15118,104188,106882,211070
2024,Estado de México,15,Zumpahuacán,15119,8810,9593,18403
2024,Estado de México,15,Zumpango,15120,110936,118328,229264
2024,Guanajuato,11,Abasolo,11001,47880,50688,98568
2024,Guanajuato,11,Acámbaro,11002,59345,63963,123308
2024,Guanajuato,11,Apaseo el Alto,11004,36276,37972,74248
2024,Guanajuato,11,Apaseo el Grande,11005,49862,52803,102665
2024,Guanajuato,11,Atarjea,11006,2805,2909,5714
2024,Guanajuato,11,Celaya,11007,266110,281331,547441
2024,Guanajuato,11,Comonfort,11009,42485,47095,89580
2024,Guanajuato,11,Coroneo,11010,6348,7092,13440
2024,Guanajuato,11,Cortazar,11011,50861,53733,104594
2024,Guanajuato,11,Cuerámaro,11012,14914,16025,30939
2024,Guanajuato,11,Doctor Mora,11013,12629,13582,26211
2024,Guanajuato,11,Dolores Hidalgo Cuna de la Independencia Nacional,11014,77626,86552,164178
2024,Guanajuato,11,Guanajuato,11015,100263,104495,204758
2024,Guanajuato,11,Huanímaro,11016,11108,12265,23373
2024,Guanajuato,11,Irapuato,11017,307911,323265,631176
2024,Guanajuato,11,Jaral del Progreso,11018,21095,21664,42759
2024,Guanajuato,11,Jerécuaro,11019,24456,27974,52430
2024,Guanajuato,11,León,11020,859178,872749,1731927
2024,Guanajuato,11,Manuel Doblado,11008,20093,21802,41895
2024,Guanajuato,11,Moroleón,11021,27021,29463,56484
2024,Guanajuato,11,Ocampo,11022,12335,13126,25461
2024,Guanajuato,11,Pueblo Nuevo,11024,6259,6906,13165
2024,Guanajuato,11,Purísima del Rincón,11025,44884,44656,89540
2024,Guanajuato,11,Pénjamo,11023,78683,85745,164428
2024,Guanajuato,11,Romita,11026,31344,32944,64288
2024,Guanajuato,11,Salamanca,11027,148002,155582,303584
2024,Guanajuato,11,Salvatierra,11028,52984,58009,110993
2024,Guanajuato,11,San Diego de la Unión,11029,19936,22878,42814
2024,Guanajuato,11,San Felipe,11030,59170,62609,121779
2024,Guanajuato,11,San Francisco del Rincón,11031,62964,66005,128969
2024,Guanajuato,11,San José Iturbide,11032,41986,44415,86401
2024,Guanajuato,11,San Luis de la Paz,11033,62352,68536,130888
2024,Guanajuato,11,San Miguel de Allende,11003,91035,98213,189248
2024,Guanajuato,11,Santa Catarina,11034,2743,3015,5758
2024,Guanajuato,11,Santa Cruz de Juventino Rosas,11035,44098,47175,91273
2024,Guanajuato,11,Santiago Maravatío,11036,3689,4034,7723
2024,Guanajuato,11,Silao de la Victoria,11037,102768,105209,207977
2024,Guanajuato,11,Tarandacuao,11038,6470,7093,13563
2024,Guanajuato,11,Tarimoro,11039,18387,19255,37642
2024,Guanajuato,11,Tierra Blanca,11040,10084,10776,20860
2024,Guanajuato,11,Uriangato,11041,33719,35874,69593
2024,Guanajuato,11,Valle de Santiago,11042,75635,82811,158446
2024,Guanajuato,11,Victoria,11043,10485,11679,22164
2024,Guanajuato,11,Villagrán,11044,31762,33056,64818
2024,Guanajuato,11,Xichú,11045,6056,6625,12681
2024,Guanajuato,11,Yuriria,11046,36478,40015,76493
2024,Guerrero,12,Acapulco de Juárez,12001,409434,441689,851123
2024,Guerrero,12,Acatepec,12076,18834,19745,38579
2024,Guerrero,12,Ahuacuotzingo,12002,12952,14710,27662
2024,Guerrero,12,Ajuchitlán del Progreso,12003,18861,20038,38899
2024,Guerrero,12,Alcozauca de Guerrero,12004,9525,10854,20379
2024,Guerrero,12,Alpoyeca,12005,3331,3717,7048
2024,Guerrero,12,Apaxtla,12006,5652,6117,11769
2024,Guerrero,12,Arcelia,12007,15855,16839,32694
2024,Guerrero,12,Atenango del Río,12008,4346,4708,9054
2024,Guerrero,12,Atlamajalcingo del Monte,12009,2448,2737,5185
2024,Guerrero,12,Atlixtac,12010,13690,14612,28302
2024,Guerrero,12,Atoyac de Álvarez,12011,30968,32090,63058
2024,Guerrero,12,Ayutla de los Libres,12012,34620,36147,70767
2024,Guerrero,12,Azoyú,12013,6248,6627,12875
2024,Guerrero,12,Benito Juárez,12014,7909,8327,16236
2024,Guerrero,12,Buenavista de Cuéllar,12015,6791,7135,13926
2024,Guerrero,12,Chilapa de Álvarez,12028,64036,71090,135126
2024,Guerrero,12,Chilpancingo de los Bravo,12029,138636,151130,289766
2024,Guerrero,12,Coahuayutla de José María Izazaga,12016,6416,6097,12513
2024,Guerrero,12,Cochoapa el Grande,12078,9070,10018,19088
2024,Guerrero,12,Cocula,12017,6836,7313,14149
2024,Guerrero,12,Copala,12018,7310,7566,14876
2024,Guerrero,12,Copalillo,12019,7210,7923,15133
2024,Guerrero,12,Copanatoyac,12020,10007,10990,20997
2024,Guerrero,12,Coyuca de Benítez,12021,39187,40637,79824
2024,Guerrero,12,Coyuca de Catalán,12022,20435,19826,40261
2024,Guerrero,12,Cuajinicuilapa,12023,14204,14098,28302
2024,Guerrero,12,Cualác,12024,3817,4082,7899
2024,Guerrero,12,Cuautepec,12025,8304,8371,16675
2024,Guerrero,12,Cuetzala del Progreso,12026,4401,4627,9028
2024,Guerrero,12,Cutzamala de Pinzón,12027,10130,10464,20594
2024,Guerrero,12,Eduardo Neri,12075,26430,27556,53986
2024,Guerrero,12,Florencio Villarreal,12030,10737,10983,21720
2024,Guerrero,12,General Canuto A. Neri,12031,2881,3106,5987
2024,Guerrero,12,General Heliodoro Castillo,12032,18895,18886,37781
2024,Guerrero,12,Huamuxtitlán,12033,7525,8461,15986
2024,Guerrero,12,Huitzuco de los Figueroa,12034,18885,20395,39280
2024,Guerrero,12,Iguala de la Independencia,12035,77576,83287,160863
2024,Guerrero,12,Igualapa,12036,5729,5917,11646
2024,Guerrero,12,Iliatenco,12081,5403,5968,11371
2024,Guerrero,12,Ixcateopan de Cuauhtémoc,12037,3108,3428,6536
2024,Guerrero,12,José Joaquín de Herrera,12079,8939,9110,18049
2024,Guerrero,12,Juan R. Escudero,12039,12663,13338,26001
2024,Guerrero,12,Juchitán,12080,4055,3969,8024
2024,Guerrero,12,La Unión de Isidoro Montes de Oca,12068,13888,13261,27149
2024,Guerrero,12,Leonardo Bravo,12040,13414,13682,27096
2024,Guerrero,12,Malinaltepec,12041,13063,14767,27830
2024,Guerrero,12,Marquelia,12077,7169,7255,14424
2024,Guerrero,12,Metlatónoc,12043,8621,9952,18573
2024,Guerrero,12,Mochitlán,12044,6618,6897,13515
2024,Guerrero,12,Mártir de Cuilapan,12042,9390,10304,19694
2024,Guerrero,12,Olinalá,12045,12807,13813,26620
2024,Guerrero,12,Ometepec,12046,34530,36312,70842
2024,Guerrero,12,Pedro Ascencio Alquisiras,12047,3276,3799,7075
2024,Guerrero,12,Petatlán,12048,22480,22932,45412
2024,Guerrero,12,Pilcaya,12049,6578,6966,13544
2024,Guerrero,12,Pungarabato,12050,18765,19982,38747
2024,Guerrero,12,Quechultenango,12051,18200,19035,37235
2024,Guerrero,12,San Luis Acatlán,12052,22210,22857,45067
2024,Guerrero,12,San Marcos,12053,25310,26100,51410
2024,Guerrero,12,San Miguel Totolapan,12054,13823,14372,28195
2024,Guerrero,12,Taxco de Alarcón,12055,54514,59452,113966
2024,Guerrero,12,Tecoanapa,12056,23584,24278,47862
2024,Guerrero,12,Teloloapan,12058,28407,31864,60271
2024,Guerrero,12,Tepecoacuilco de Trujano,12059,16221,17545,33766
2024,Guerrero,12,Tetipac,12060,7376,7790,15166
2024,Guerrero,12,Tixtla de Guerrero,12061,21695,23505,45200
2024,Guerrero,12,Tlacoachistlahuaca,12062,11584,13073,24657
2024,Guerrero,12,Tlacoapa,12063,5038,5572,10610
2024,Guerrero,12,Tlalchapa,12064,6559,6540,13099
2024,Guerrero,12,Tlalixtaquilla de Maldonado,12065,3730,4028,7758
2024,Guerrero,12,Tlapa de Comonfort,12066,45213,50236,95449
2024,Guerrero,12,Tlapehuala,12067,11024,11812,22836
2024,Guerrero,12,Técpan de Galeana,12057,33845,34344,68189
2024,Guerrero,12,Xalpatláhuac,12069,5623,6604,12227
2024,Guerrero,12,Xochihuehuetlán,12070,3512,3966,7478
2024,Guerrero,12,Xochistlahuaca,12071,14772,15682,30454
2024,Guerrero,12,Zapotitlán Tablas,12072,6400,7052,13452
2024,Guerrero,12,Zihuatanejo de Azueta,12038,65246,66990,132236
2024,Guerrero,12,Zirándaro,12073,9223,8798,18021
2024,Guerrero,12,Zitlala,12074,11417,12793,24210
2024,Hidalgo,13,Acatlán,13001,11030,11834,22864
2024,Hidalgo,13,Acaxochitlán,13002,23011,24938,47949
2024,Hidalgo,13,Actopan,13003,30308,33567,63875
2024,Hidalgo,13,Agua Blanca de Iturbide,13004,4750,5282,10032
2024,Hidalgo,13,Ajacuba,13005,10175,10597,20772
2024,Hidalgo,13,Alfajayucan,13006,11296,11963,23259
2024,Hidalgo,13,Almoloya,13007,6787,6863,13650
2024,Hidalgo,13,Apan,13008,23954,25997,49951
2024,Hidalgo,13,Atitalaquia,13010,16654,17013,33667
2024,Hidalgo,13,Atlapexco,13011,10816,11700,22516
2024,Hidalgo,13,Atotonilco de Tula,13013,21018,22186,43204
2024,Hidalgo,13,Atotonilco el Grande,13012,14537,16183,30720
2024,Hidalgo,13,Calnali,13014,9377,10138,19515
2024,Hidalgo,13,Cardonal,13015,9957,10814,20771
2024,Hidalgo,13,Chapantongo,13017,7503,7920,15423
2024,Hidalgo,13,Chapulhuacán,13018,13319,13160,26479
2024,Hidalgo,13,Chilcuautla,13019,10075,10406,20481
2024,Hidalgo,13,Cuautepec de Hinojosa,13016,31024,34011,65035
2024,Hidalgo,13,El Arenal,13009,10107,10988,21095
2024,Hidalgo,13,Eloxochitlán,13020,1472,1676,3148
2024,Hidalgo,13,Emiliano Zapata,13021,7842,8699,16541
2024,Hidalgo,13,Epazoyucan,13022,8187,8663,16850
2024,Hidalgo,13,Francisco I. Madero,13023,19476,21200,40676
2024,Hidalgo,13,Huasca de Ocampo,13024,9489,10360,19849
2024,Hidalgo,13,Huautla,13025,11469,12553,24022
2024,Hidalgo,13,Huazalingo,13026,7616,8037,15653
2024,Hidalgo,13,Huehuetla,13027,13727,14661,28388
2024,Hidalgo,13,Huejutla de Reyes,13028,70937,73572,144509
2024,Hidalgo,13,Huichapan,13029,24896,27000,51896
2024,Hidalgo,13,Ixmiquilpan,13030,49138,54997,104135
2024,Hidalgo,13,Jacala de Ledezma,13031,7198,8005,15203
2024,Hidalgo,13,Jaltocán,13032,6590,6783,13373
2024,Hidalgo,13,Juárez Hidalgo,13033,1706,1870,3576
2024,Hidalgo,13,La Misión,13040,5580,5744,11324
2024,Hidalgo,13,Lolotla,13034,5142,5417,10559
2024,Hidalgo,13,Metepec,13035,6078,6895,12973
2024,Hidalgo,13,Metztitlán,13037,10941,12120,23061
2024,Hidalgo,13,Mineral de la Reforma,13051,95021,104286,199307
2024,Hidalgo,13,Mineral del Chico,13038,4954,5251,10205
2024,Hidalgo,13,Mineral del Monte,13039,7876,8618,16494
2024,Hidalgo,13,Mixquiahuala de Juárez,13041,25163,27075,52238
2024,Hidalgo,13,Molango de Escamilla,13042,6394,6673,13067
2024,Hidalgo,13,Nicolás Flores,13043,3633,4092,7725
2024,Hidalgo,13,Nopala de Villagrán,13044,9304,9635,18939
2024,Hidalgo,13,Omitlán de Juárez,13045,5297,5766,11063
2024,Hidalgo,13,Pachuca de Soto,13048,137127,150810,287937
2024,Hidalgo,13,Pacula,13047,2585,2975,5560
2024,Hidalgo,13,Pisaflores,13049,9655,9647,19302
2024,Hidalgo,13,Progreso de Obregón,13050,12561,13957,26518
2024,Hidalgo,13,San Agustín Metzquititlán,13036,5179,5628,10807
2024,Hidalgo,13,San Agustín Tlaxiaca,13052,20164,21079,41243
2024,Hidalgo,13,San Bartolo Tutotepec,13053,10251,10530,20781
2024,Hidalgo,13,San Felipe Orizatlán,13046,21029,21903,42932
2024,Hidalgo,13,San Salvador,13054,19185,20531,39716
2024,Hidalgo,13,Santiago Tulantepec de Lugo Guerrero,13056,19980,21821,41801
2024,Hidalgo,13,Santiago de Anaya,13055,9404,9840,19244
2024,Hidalgo,13,Singuilucan,13057,8985,9200,18185
2024,Hidalgo,13,Tasquillo,13058,8355,9818,18173
2024,Hidalgo,13,Tecozautla,13059,20339,21944,42283
2024,Hidalgo,13,Tenango de Doria,13060,9679,10719,20398
2024,Hidalgo,13,Tepeapulco,13061,29663,31557,61220
2024,Hidalgo,13,Tepehuacán de Guerrero,13062,17215,16713,33928
2024,Hidalgo,13,Tepeji del Río de Ocampo,13063,48051,49355,97406
2024,Hidalgo,13,Tepetitlán,13064,6038,6355,12393
2024,Hidalgo,13,Tetepango,13065,6491,6522,13013
2024,Hidalgo,13,Tezontepec de Aldama,13067,29445,30101,59546
2024,Hidalgo,13,Tianguistengo,13068,8178,8548,16726
2024,Hidalgo,13,Tizayuca,13069,72379,74264,146643
2024,Hidalgo,13,Tlahuelilpan,13070,10665,11008,21673
2024,Hidalgo,13,Tlahuiltepa,13071,5700,5732,11432
2024,Hidalgo,13,Tlanalapa,13072,5632,6004,11636
2024,Hidalgo,13,Tlanchinol,13073,21711,22073,43784
2024,Hidalgo,13,Tlaxcoapan,13074,15748,16127,31875
2024,Hidalgo,13,Tolcayuca,13075,9033,9555,18588
2024,Hidalgo,13,Tula de Allende,13076,60166,63694,123860
2024,Hidalgo,13,Tulancingo de Bravo,13077,83833,92975,176808
2024,Hidalgo,13,Villa de Tezontepec,13066,6836,7132,13968
2024,Hidalgo,13,Xochiatipan,13078,10648,11308,21956
2024,Hidalgo,13,Xochicoatlán,13079,4290,4432,8722
2024,Hidalgo,13,Yahualica,13080,13240,13832,27072
2024,Hidalgo,13,Zacualtipán de Ángeles,13081,18830,20554,39384
2024,Hidalgo,13,Zapotlán de Juárez,13082,10169,10992,21161
2024,Hidalgo,13,Zempoala,13083,26209,27725,53934
2024,Hidalgo,13,Zimapán,13084,20503,23780,44283
2024,Jalisco,14,Acatic,14001,11676,12124,23800
2024,Jalisco,14,Acatlán de Juárez,14002,12549,12003,24552
2024,Jalisco,14,Ahualulco de Mercado,14003,12622,13020,25642
2024,Jalisco,14,Amacueca,14004,2954,3089,6043
2024,Jalisco,14,Amatitán,14005,8451,8530,16981
2024,Jalisco,14,Ameca,14006,33217,34514,67731
2024,Jalisco,14,Arandas,14008,39376,42303,81679
2024,Jalisco,14,Atemajac de Brizuela,14010,3642,3683,7325
2024,Jalisco,14,Atengo,14011,3213,2979,6192
2024,Jalisco,14,Atenguillo,14012,2171,2245,4416
2024,Jalisco,14,Atotonilco el Alto,14013,33072,34093,67165
2024,Jalisco,14,Atoyac,14014,4332,4673,9005
2024,Jalisco,14,Autlán de Navarro,14015,33562,34650,68212
2024,Jalisco,14,Ayotlán,14016,20491,21337,41828
2024,Jalisco,14,Ayutla,14017,6951,6919,13870
2024,Jalisco,14,Bolaños,14019,4314,4314,8628
2024,Jalisco,14,Cabo Corrientes,14020,6002,5530,11532
2024,Jalisco,14,Casimiro Castillo,14021,12122,12101,24223
2024,Jalisco,14,Cañadas de Obregón,14117,2283,2377,4660
2024,Jalisco,14,Chapala,14030,27869,29234,57103
2024,Jalisco,14,Chimaltitán,14031,1794,1836,3630
2024,Jalisco,14,Chiquilistlán,14032,3387,3328,6715
2024,Jalisco,14,Cihuatlán,14022,23282,22689,45971
2024,Jalisco,14,Cocula,14024,14462,15140,29602
2024,Jalisco,14,Colotlán,14025,9646,10317,19963
2024,Jalisco,14,Concepción de Buenos Aires,14026,3496,3353,6849
2024,Jalisco,14,Cuautitlán de García Barragán,14027,9976,9713,19689
2024,Jalisco,14,Cuautla,14028,1172,1251,2423
2024,Jalisco,14,Cuquío,14029,9668,10512,20180
2024,Jalisco,14,Degollado,14033,11517,12179,23696
2024,Jalisco,14,Ejutla,14034,1110,1028,2138
2024,Jalisco,14,El Arenal,14009,10905,10995,21900
2024,Jalisco,14,El Grullo,14037,13289,14051,27340
2024,Jalisco,14,El Limón,14054,3093,3094,6187
2024,Jalisco,14,El Salto,14070,104546,105317,209863
2024,Jalisco,14,Encarnación de Díaz,14035,28642,30673,59315
2024,Jalisco,14,Etzatlán,14036,10749,11264,22013
2024,Jalisco,14,Guachinango,14038,2412,2326,4738
2024,Jalisco,14,Guadalajara,14039,749579,794897,1544476
2024,Jalisco,14,Gómez Farías,14079,7698,8199,15897
2024,Jalisco,14,Hostotipaquillo,14040,6136,5298,11434
2024,Jalisco,14,Huejuquilla el Alto,14042,4753,5115,9868
2024,Jalisco,14,Huejúcar,14041,3111,3411,6522
2024,Jalisco,14,Ixtlahuacán de los Membrillos,14044,31724,32267,63991
2024,Jalisco,14,Ixtlahuacán del Río,14045,10242,10850,21092
2024,Jalisco,14,Jalostotitlán,14046,18519,18909,37428
2024,Jalisco,14,Jamay,14047,13792,13763,27555
2024,Jalisco,14,Jesús María,14048,9678,11457,21135
2024,Jalisco,14,Jilotlán de los Dolores,14049,5322,5082,10404
2024,Jalisco,14,Jocotepec,14050,25548,25859,51407
2024,Jalisco,14,Juanacatlán,14051,10114,10075,20189
2024,Jalisco,14,Juchitlán,14052,3056,3220,6276
2024,Jalisco,14,La Barca,14018,35055,37184,72239
2024,Jalisco,14,La Huerta,14043,13849,13298,27147
2024,Jalisco,14,La Manzanilla de la Paz,14057,2022,2165,4187
2024,Jalisco,14,Lagos de Moreno,14053,89046,92687,181733
2024,Jalisco,14,Magdalena,14055,12516,12488,25004
2024,Jalisco,14,Mascota,14058,8043,8300,16343
2024,Jalisco,14,Mazamitla,14059,7490,8103,15593
2024,Jalisco,14,Mexticacán,14060,2552,2980,5532
2024,Jalisco,14,Mezquitic,14061,10455,11087,21542
2024,Jalisco,14,Mixtlán,14062,1977,1945,3922
2024,Jalisco,14,Ocotlán,14063,53872,55681,109553
2024,Jalisco,14,Ojuelos de Jalisco,14064,17127,17984,35111
2024,Jalisco,14,Pihuamo,14065,6283,6178,12461
2024,Jalisco,14,Poncitlán,14066,28103,28813,56916
2024,Jalisco,14,Puerto Vallarta,14067,157045,153329,310374
2024,Jalisco,14,Quitupan,14069,4329,4803,9132
2024,Jalisco,14,San Cristóbal de la Barranca,14071,1618,1617,3235
2024,Jalisco,14,San Diego de Alejandría,14072,3869,4135,8004
2024,Jalisco,14,San Gabriel,14113,8956,9279,18235
2024,Jalisco,14,San Ignacio Cerro Gordo,14125,10135,10751,20886
2024,Jalisco,14,San Juan de los Lagos,14073,38226,38643,76869
2024,Jalisco,14,San Juanito de Escobedo,14007,5216,5137,10353
2024,Jalisco,14,San Julián,14074,8431,9258,17689
2024,Jalisco,14,San Marcos,14075,2119,2073,4192
2024,Jalisco,14,San Martín Hidalgo,14077,15070,15760,30830
2024,Jalisco,14,San Martín de Bolaños,14076,1650,1652,3302
2024,Jalisco,14,San Miguel el Alto,14078,17798,18647,36445
2024,Jalisco,14,San Pedro Tlaquepaque,14098,364091,367531,731622
2024,Jalisco,14,San Sebastián del Oeste,14080,3249,2916,6165
2024,Jalisco,14,Santa María de los Ángeles,14081,1675,1838,3513
2024,Jalisco,14,Santa María del Oro,14056,1126,1113,2239
2024,Jalisco,14,Sayula,14082,19592,21069,40661
2024,Jalisco,14,Tala,14083,44739,45266,90005
2024,Jalisco,14,Talpa de Allende,14084,8384,8252,16636
2024,Jalisco,14,Tamazula de Gordiano,14085,20937,21887,42824
2024,Jalisco,14,Tapalpa,14086,10444,10862,21306
2024,Jalisco,14,Tecalitlán,14087,8967,9360,18327
2024,Jalisco,14,Techaluta de Montenegro,14089,2069,2130,4199
2024,Jalisco,14,Tecolotlán,14088,9650,9644,19294
2024,Jalisco,14,Tenamaxtlán,14090,3872,3864,7736
2024,Jalisco,14,Teocaltiche,14091,21919,23951,45870
2024,Jalisco,14,Teocuitatlán de Corona,14092,5722,5905,11627
2024,Jalisco,14,Tepatitlán de Morelos,14093,76429,79070,155499
2024,Jalisco,14,Tequila,14094,22827,23123,45950
2024,Jalisco,14,Teuchitlán,14095,5333,5507,10840
2024,Jalisco,14,Tizapán el Alto,14096,11434,11970,23404
2024,Jalisco,14,Tlajomulco de Zúñiga,14097,342175,347289,689464
2024,Jalisco,14,Tolimán,14099,5667,5725,11392
2024,Jalisco,14,Tomatlán,14100,20077,19044,39121
2024,Jalisco,14,Tonalá,14101,298005,298519,596524
2024,Jalisco,14,Tonaya,14102,3291,3428,6719
2024,Jalisco,14,Tonila,14103,4393,4406,8799
2024,Jalisco,14,Totatiche,14104,2464,2488,4952
2024,Jalisco,14,Tototlán,14105,12706,12974,25680
2024,Jalisco,14,Tuxcacuesco,14106,2487,2367,4854
2024,Jalisco,14,Tuxcueca,14107,3339,3560,6899
2024,Jalisco,14,Tuxpan,14108,18753,19908,38661
2024,Jalisco,14,Unión de San Antonio,14109,9686,10315,20001
2024,Jalisco,14,Unión de Tula,14110,7251,7714,14965
2024,Jalisco,14,Valle de Guadalupe,14111,3887,3899,7786
2024,Jalisco,14,Valle de Juárez,14112,2980,3139,6119
2024,Jalisco,14,Villa Corona,14114,9881,10107,19988
2024,Jalisco,14,Villa Guerrero,14115,3024,3107,6131
2024,Jalisco,14,Villa Hidalgo,14116,10958,11689,22647
2024,Jalisco,14,Villa Purificación,14068,6256,5788,12044
2024,Jalisco,14,Yahualica de González Gallo,14118,11787,12860,24647
2024,Jalisco,14,Zacoalco de Torres,14119,15709,15915,31624
2024,Jalisco,14,Zapopan,14120,727960,752911,1480871
2024,Jalisco,14,Zapotiltic,14121,15909,16518,32427
2024,Jalisco,14,Zapotitlán de Vadillo,14122,3910,3865,7775
2024,Jalisco,14,Zapotlanejo,14124,37014,37857,74871
2024,Jalisco,14,Zapotlán del Rey,14123,10011,10036,20047
2024,Jalisco,14,Zapotlán el Grande,14023,57524,60453,117977
2024,Michoacán,16,Acuitzio,16001,5946,6388,12334
2024,Michoacán,16,Aguililla,16002,7701,7518,15219
2024,Michoacán,16,Angamacutiro,16004,7846,8605,16451
2024,Michoacán,16,Angangueo,16005,5864,6210,12074
2024,Michoacán,16,Apatzingán,16006,67665,68566,136231
2024,Michoacán,16,Aporo,16007,1703,1817,3520
2024,Michoacán,16,Aquila,16008,13619,13216,26835
2024,Michoacán,16,Ario,16009,19369,20384,39753
2024,Michoacán,16,Arteaga,16010,11548,11662,23210
2024,Michoacán,16,Briseñas,16011,6029,6318,12347
2024,Michoacán,16,Buenavista,16012,26164,24839,51003
2024,Michoacán,16,Carácuaro,16013,4911,4871,9782
2024,Michoacán,16,Charapan,16021,6268,7071,13339
2024,Michoacán,16,Charo,16022,12243,11532,23775
2024,Michoacán,16,Chavinda,16023,5451,5693,11144
2024,Michoacán,16,Cherán,16024,9899,10644,20543
2024,Michoacán,16,Chilchota,16025,20415,21999,42414
2024,Michoacán,16,Chinicuila,16026,2620,2391,5011
2024,Michoacán,16,Chucándiro,16027,2105,2455,4560
2024,Michoacán,16,Churintzio,16028,2633,2939,5572
2024,Michoacán,16,Churumuco,16029,8170,8129,16299
2024,Michoacán,16,Coahuayana,16014,8124,7486,15610
2024,Michoacán,16,Coalcomán de Vázquez Pallares,16015,9191,9357,18548
2024,Michoacán,16,Coeneo,16016,10487,12068,22555
2024,Michoacán,16,Cojumatlán de Régules,16074,5527,5727,11254
2024,Michoacán,16,Contepec,16017,17833,18756,36589
2024,Michoacán,16,Copándaro,16018,4613,5109,9722
2024,Michoacán,16,Cotija,16019,9503,10441,19944
2024,Michoacán,16,Cuitzeo,16020,15361,16886,32247
2024,Michoacán,16,Ecuandureo,16030,6213,7292,13505
2024,Michoacán,16,Epitacio Huerta,16031,8781,9145,17926
2024,Michoacán,16,Erongarícuaro,16032,7995,8586,16581
2024,Michoacán,16,Gabriel Zamora,16033,12248,12290,24538
2024,Michoacán,16,Hidalgo,16034,64321,67450,131771
2024,Michoacán,16,Huandacareo,16036,6048,6878,12926
2024,Michoacán,16,Huaniqueo,16037,4071,4728,8799
2024,Michoacán,16,Huetamo,16038,21172,22132,43304
2024,Michoacán,16,Huiramba,16039,4680,4834,9514
2024,Michoacán,16,Indaparapeo,16040,8752,9188,17940
2024,Michoacán,16,Irimbo,16041,7810,8511,16321
2024,Michoacán,16,Ixtlán,16042,6840,6973,13813
2024,Michoacán,16,Jacona,16043,36059,38071,74130
2024,Michoacán,16,Jiménez,16044,6630,7163,13793
2024,Michoacán,16,Jiquilpan,16045,16919,18561,35480
2024,Michoacán,16,José Sixto Verduzco,16113,13569,14862,28431
2024,Michoacán,16,Jungapeo,16047,11340,11458,22798
2024,Michoacán,16,Juárez,16046,7690,8050,15740
2024,Michoacán,16,La Huacana,16035,18174,18292,36466
2024,Michoacán,16,La Piedad,16069,54410,59177,113587
2024,Michoacán,16,Lagunillas,16048,2980,3051,6031
2024,Michoacán,16,Los Reyes,16075,37022,38667,75689
2024,Michoacán,16,Lázaro Cárdenas,16052,97857,97045,194902
2024,Michoacán,16,Madero,16049,9715,9460,19175
2024,Michoacán,16,Maravatío,16050,46025,49519,95544
2024,Michoacán,16,Marcos Castellanos,16051,7258,7753,15011
2024,Michoacán,16,Morelia,16053,407268,439360,846628
2024,Michoacán,16,Morelos,16054,3645,4336,7981
2024,Michoacán,16,Múgica,16055,24167,24678,48845
2024,Michoacán,16,Nahuatzen,16056,14880,15739,30619
2024,Michoacán,16,Nocupétaro,16057,4324,4365,8689
2024,Michoacán,16,Nuevo Parangaricutiro,16058,10538,10863,21401
2024,Michoacán,16,Nuevo Urecho,16059,4330,4332,8662
2024,Michoacán,16,Numarán,16060,5026,5520,10546
2024,Michoacán,16,Ocampo,16061,12893,12904,25797
2024,Michoacán,16,Pajacuarán,16062,10046,10699,20745
2024,Michoacán,16,Panindícuaro,16063,8042,8981,17023
2024,Michoacán,16,Paracho,16065,19354,21120,40474
2024,Michoacán,16,Parácuaro,16064,14537,14136,28673
2024,Michoacán,16,Penjamillo,16067,8596,9746,18342
2024,Michoacán,16,Peribán,16068,15259,15022,30281
2024,Michoacán,16,Puruándiro,16071,34032,37702,71734
2024,Michoacán,16,Purépero,16070,8031,8367,16398
2024,Michoacán,16,Pátzcuaro,16066,48300,52292,100592
2024,Michoacán,16,Queréndaro,16072,7169,7491,14660
2024,Michoacán,16,Quiroga,16073,14333,15671,30004
2024,Michoacán,16,Sahuayo,16076,41029,42820,83849
2024,Michoacán,16,Salvador Escalante,16079,25856,27232,53088
2024,Michoacán,16,San Lucas,16077,9636,9760,19396
2024,Michoacán,16,Santa Ana Maya,16078,6326,7170,13496
2024,Michoacán,16,Senguio,16080,9934,10555,20489
2024,Michoacán,16,Susupuato,16081,4670,4672,9342
2024,Michoacán,16,Tacámbaro,16082,41041,42777,83818
2024,Michoacán,16,Tancítaro,16083,16970,16457,33427
2024,Michoacán,16,Tangamandapio,16084,15293,16360,31653
2024,Michoacán,16,Tangancícuaro,16085,17653,18691,36344
2024,Michoacán,16,Tanhuato,16086,8148,8523,16671
2024,Michoacán,16,Taretan,16087,7899,8052,15951
2024,Michoacán,16,Tarímbaro,16088,60698,65428,126126
2024,Michoacán,16,Tepalcatepec,16089,12926,12624,25550
2024,Michoacán,16,Tingambato,16090,7931,8368,16299
2024,Michoacán,16,Tingüindín,16091,7635,8218,15853
2024,Michoacán,16,Tiquicheo de Nicolás Romero,16092,7069,7159,14228
2024,Michoacán,16,Tlalpujahua,16093,14707,16316,31023
2024,Michoacán,16,Tlazazalca,16094,3364,3551,6915
2024,Michoacán,16,Tocumbo,16095,6493,6575,13068
2024,Michoacán,16,Tumbiscatío,16096,3492,3359,6851
2024,Michoacán,16,Turicato,16097,16086,16823,32909
2024,Michoacán,16,Tuxpan,16098,13981,14973,28954
2024,Michoacán,16,Tuzantla,16099,8044,8086,16130
2024,Michoacán,16,Tzintzuntzan,16100,7419,8168,15587
2024,Michoacán,16,Tzitzio,16101,4592,4447,9039
2024,Michoacán,16,Uruapan,16102,176515,187610,364125
2024,Michoacán,16,Venustiano Carranza,16103,13247,13729,26976
2024,Michoacán,16,Villamar,16104,8635,9271,17906
2024,Michoacán,16,Vista Hermosa,16105,11013,11414,22427
2024,Michoacán,16,Yurécuaro,16106,16632,17447,34079
2024,Michoacán,16,Zacapu,16107,39303,42303,81606
2024,Michoacán,16,Zamora,16108,103801,109631,213432
2024,Michoacán,16,Zinapécuaro,16110,24352,26268,50620
2024,Michoacán,16,Zináparo,16109,1615,1868,3483
2024,Michoacán,16,Ziracuaretiro,16111,9338,9490,18828
2024,Michoacán,16,Zitácuaro,16112,84110,91812,175922
2024,Michoacán,16,Álvaro Obregón,16003,11459,12153,23612
2024,Morelos,17,Amacuzac,17001,9577,9993,19570
2024,Morelos,17,Atlatlahucan,17002,12524,12939,25463
2024,Morelos,17,Axochiapan,17003,19705,20057,39762
2024,Morelos,17,Ayala,17004,45876,48796,94672
2024,Morelos,17,Coatlán del Río,17005,5438,5548,10986
2024,Morelos,17,Cuautla,17006,104999,112247,217246
2024,Morelos,17,Cuernavaca,17007,194544,219302,413846
2024,Morelos,17,Emiliano Zapata,17008,55193,56756,111949
2024,Morelos,17,Huitzilac,17009,10568,10611,21179
2024,Morelos,17,Jantetelco,17010,9409,9768,19177
2024,Morelos,17,Jiutepec,17011,113794,120755,234549
2024,Morelos,17,Jojutla,17012,30857,32949,63806
2024,Morelos,17,Jonacatepec,17013,8401,9011,17412
2024,Morelos,17,Mazatepec,17014,5448,5662,11110
2024,Morelos,17,Miacatlán,17015,14338,14990,29328
2024,Morelos,17,Ocuituco,17016,10152,10356,20508
2024,Morelos,17,Puente de Ixtla,17017,36154,37491,73645
2024,Morelos,17,Temixco,17018,62834,65300,128134
2024,Morelos,17,Temoac,17033,8643,9079,17722
2024,Morelos,17,Tepalcingo,17019,14760,15298,30058
2024,Morelos,17,Tepoztlán,17020,26664,27517,54181
2024,Morelos,17,Tetecala,17021,4341,4350,8691
2024,Morelos,17,Tetela del Volcán,17022,11170,11721,22891
2024,Morelos,17,Tlalnepantla,17023,4076,3950,8026
2024,Morelos,17,Tlaltizapán de Zapata,17024,28239,29504,57743
2024,Morelos,17,Tlaquiltenango,17025,18656,19082,37738
2024,Morelos,17,Tlayacapan,17026,9873,10034,19907
2024,Morelos,17,Totolapan,17027,6564,6725,13289
2024,Morelos,17,Xochitepec,17028,39292,38452,77744
2024,Morelos,17,Yautepec,17029,55557,58438,113995
2024,Morelos,17,Yecapixtla,17030,29164,29721,58885
2024,Morelos,17,Zacatepec,17031,19609,21137,40746
2024,Morelos,17,Zacualpan,17032,5223,5418,10641
2024,Nayarit,18,Acaponeta,18001,21189,21059,42248
2024,Nayarit,18,Ahuacatlán,18002,9132,9004,18136
2024,Nayarit,18,Amatlán de Cañas,18003,6872,6599,13471
2024,Nayarit,18,Bahía de Banderas,18020,95434,91574,187008
2024,Nayarit,18,Compostela,18004,43267,42819,86086
2024,Nayarit,18,Del Nayar,18009,23761,23652,47413
2024,Nayarit,18,Huajicori,18005,7206,6949,14155
2024,Nayarit,18,Ixtlán del Río,18006,16160,17175,33335
2024,Nayarit,18,Jala,18007,10386,10533,20919
2024,Nayarit,18,La Yesca,18019,7957,7466,15423
2024,Nayarit,18,Rosamorada,18010,19861,18919,38780
2024,Nayarit,18,Ruíz,18011,14343,13939,28282
2024,Nayarit,18,San Blas,18012,26737,23849,50586
2024,Nayarit,18,San Pedro Lagunillas,18013,4396,4259,8655
2024,Nayarit,18,Santa María del Oro,18014,13546,13062,26608
2024,Nayarit,18,Santiago Ixcuintla,18015,56988,54854,111842
2024,Nayarit,18,Tecuala,18016,22997,22229,45226
2024,Nayarit,18,Tepic,18017,228699,239685,468384
2024,Nayarit,18,Tuxpan,18018,17500,17597,35097
2024,Nayarit,18,Xalisco,18008,32040,33277,65317
2024,Nuevo León,19,Abasolo,19001,1483,1488,2971
2024,Nuevo León,19,Agualeguas,19002,1338,1270,2608
2024,Nuevo León,19,Allende,19004,20295,20033,40328
2024,Nuevo León,19,Anáhuac,19005,10343,10446,20789
2024,Nuevo León,19,Apodaca,19006,352922,346691,699613
2024,Nuevo León,19,Aramberri,19007,9534,9344,18878
2024,Nuevo León,19,Bustamante,19008,2326,2310,4636
2024,Nuevo León,19,Cadereyta Jiménez,19009,56460,54051,110511
2024,Nuevo León,19,Cerralvo,19011,4427,4142,8569
2024,Nuevo León,19,China,19013,6452,6144,12596
2024,Nuevo León,19,Ciénega de Flores,19012,27875,26777,54652
2024,Nuevo León,19,Doctor Arroyo,19014,20144,19697,39841
2024,Nuevo León,19,Doctor Coss,19015,1013,978,1991
2024,Nuevo León,19,Doctor González,19016,1753,1668,3421
2024,Nuevo León,19,El Carmen,19010,26100,25503,51603
2024,Nuevo León,19,Galeana,19017,23962,23413,47375
2024,Nuevo León,19,García,19018,164970,162564,327534
2024,Nuevo León,19,General Bravo,19020,3328,3172,6500
2024,Nuevo León,19,General Escobedo,19021,244614,243542,488156
2024,Nuevo León,19,General Terán,19022,8608,8664,17272
2024,Nuevo León,19,General Treviño,19023,607,638,1245
2024,Nuevo León,19,General Zaragoza,19024,3582,3344,6926
2024,Nuevo León,19,General Zuazua,19025,50433,49445,99878
2024,Nuevo León,19,Guadalupe,19026,372622,364202,736824
2024,Nuevo León,19,Hidalgo,19047,8177,8102,16279
2024,Nuevo León,19,Higueras,19028,932,862,1794
2024,Nuevo León,19,Hualahuises,19029,4057,4109,8166
2024,Nuevo León,19,Iturbide,19030,2181,2014,4195
2024,Nuevo León,19,Juárez,19031,216350,210713,427063
2024,Nuevo León,19,Lampazos de Naranjo,19032,3100,3012,6112
2024,Nuevo León,19,Linares,19033,46582,46609,93191
2024,Nuevo León,19,Los Aldamas,19003,844,825,1669
2024,Nuevo León,19,Los Herreras,19027,1055,1084,2139
2024,Nuevo León,19,Los Ramones,19042,2718,2662,5380
2024,Nuevo León,19,Marín,19034,3307,3106,6413
2024,Nuevo León,19,Melchor Ocampo,19035,587,567,1154
2024,Nuevo León,19,Mier y Noriega,19036,4002,3919,7921
2024,Nuevo León,19,Mina,19037,3120,2980,6100
2024,Nuevo León,19,Montemorelos,19038,35746,35592,71338
2024,Nuevo León,19,Monterrey,19039,578411,603952,1182363
2024,Nuevo León,19,Parás,19040,576,564,1140
2024,Nuevo León,19,Pesquería,19041,61941,61197,123138
2024,Nuevo León,19,Rayones,19043,1653,1539,3192
2024,Nuevo León,19,Sabinas Hidalgo,19044,20156,20875,41031
2024,Nuevo León,19,Salinas Victoria,19045,33869,32354,66223
2024,Nuevo León,19,San Nicolás de los Garza,19046,239690,249069,488759
2024,Nuevo León,19,San Pedro Garza García,19019,68136,76065,144201
2024,Nuevo León,19,Santa Catarina,19048,168782,166788,335570
2024,Nuevo León,19,Santiago,19049,24786,24566,49352
2024,Nuevo León,19,Vallecillo,19050,1113,948,2061
2024,Nuevo León,19,Villaldama,19051,2413,2406,4819
2024,Oaxaca,20,Abejones,20001,425,586,1011
2024,Oaxaca,20,Acatlán de Pérez Figueroa,20002,23723,24774,48497
2024,Oaxaca,20,Asunción Cacalotepec,20003,1058,1134,2192
2024,Oaxaca,20,Asunción Cuyotepeji,20004,490,561,1051
2024,Oaxaca,20,Asunción Ixtaltepec,20005,8059,8165,16224
2024,Oaxaca,20,Asunción Nochixtlán,20006,9513,10677,20190
2024,Oaxaca,20,Asunción Ocotlán,20007,1095,1365,2460
2024,Oaxaca,20,Asunción Tlacolulita,20008,404,424,828
2024,Oaxaca,20,Ayoquezco de Aldama,20398,2118,2379,4497
2024,Oaxaca,20,Ayotzintepec,20009,3772,3831,7603
2024,Oaxaca,20,Calihualá,20011,589,623,1212
2024,Oaxaca,20,Candelaria Loxicha,20012,5368,5676,11044
2024,Oaxaca,20,Capulálpam de Méndez,20247,753,921,1674
2024,Oaxaca,20,Chahuites,20025,6122,6204,12326
2024,Oaxaca,20,Chalcatongo de Hidalgo,20026,4553,5188,9741
2024,Oaxaca,20,Chiquihuitlán de Benito Juárez,20027,1127,1348,2475
2024,Oaxaca,20,Ciudad Ixtepec,20014,15027,16345,31372
2024,Oaxaca,20,Ciénega de Zimatlán,20013,1545,1680,3225
2024,Oaxaca,20,Coatecas Altas,20015,2165,2498,4663
2024,Oaxaca,20,Coicoyán de las Flores,20016,4994,5657,10651
2024,Oaxaca,20,Concepción Buenavista,20018,409,436,845
2024,Oaxaca,20,Concepción Pápalo,20019,1562,1573,3135
2024,Oaxaca,20,Constancia del Rosario,20020,1904,2209,4113
2024,Oaxaca,20,Cosolapa,20021,7945,8598,16543
2024,Oaxaca,20,Cosoltepec,20022,366,431,797
2024,Oaxaca,20,Cuilápam de Guerrero,20023,11486,12151,23637
2024,Oaxaca,20,Cuyamecalco Villa de Zaragoza,20024,1943,1911,3854
2024,Oaxaca,20,El Barrio de la Soledad,20010,7291,7896,15187
2024,Oaxaca,20,El Espinal,20030,4576,4784,9360
2024,Oaxaca,20,Eloxochitlán de Flores Magón,20029,2132,2401,4533
2024,Oaxaca,20,Fresnillo de Trujano,20032,532,570,1102
2024,Oaxaca,20,Guadalupe Etla,20033,1376,1529,2905
2024,Oaxaca,20,Guadalupe de Ramírez,20034,670,685,1355
2024,Oaxaca,20,Guelatao de Juárez,20035,278,289,567
2024,Oaxaca,20,Guevea de Humboldt,20036,2692,2824,5516
2024,Oaxaca,20,Heroica Ciudad de Ejutla de Crespo,20028,10722,11973,22695
2024,Oaxaca,20,Heroica Ciudad de Huajuapan de León,20039,39613,44071,83684
2024,Oaxaca,20,Heroica Ciudad de Juchitán de Zaragoza,20043,51398,54071,105469
2024,Oaxaca,20,Heroica Ciudad de Tlaxiaco,20397,20446,23182,43628
2024,Oaxaca,20,Huautepec,20040,3016,3483,6499
2024,Oaxaca,20,Huautla de Jiménez,20041,15170,17514,32684
2024,Oaxaca,20,Ixpantepec Nieves,20065,532,668,1200
2024,Oaxaca,20,Ixtlán de Juárez,20042,4269,4413,8682
2024,Oaxaca,20,La Compañía,20017,1639,1812,3451
2024,Oaxaca,20,La Pe,20069,1360,1453,2813
2024,Oaxaca,20,La Reforma,20076,1601,1751,3352
2024,Oaxaca,20,La Trinidad Vista Hermosa,20556,123,146,269
2024,Oaxaca,20,Loma Bonita,20044,21770,23837,45607
2024,Oaxaca,20,Magdalena Apasco,20045,4586,5106,9692
2024,Oaxaca,20,Magdalena Jaltepec,20046,1549,1826,3375
2024,Oaxaca,20,Magdalena Mixtepec,20048,691,717,1408
2024,Oaxaca,20,Magdalena Ocotlán,20049,594,638,1232
2024,Oaxaca,20,Magdalena Peñasco,20050,1699,1980,3679
2024,Oaxaca,20,Magdalena Teitipac,20051,2338,2506,4844
2024,Oaxaca,20,Magdalena Tequisistlán,20052,3170,3333,6503
2024,Oaxaca,20,Magdalena Tlacotepec,20053,640,698,1338
2024,Oaxaca,20,Magdalena Yodocono de Porfirio Díaz,20562,801,850,1651
2024,Oaxaca,20,Magdalena Zahuatlán,20054,205,231,436
2024,Oaxaca,20,Mariscala de Juárez,20055,1823,1980,3803
2024,Oaxaca,20,Matías Romero Avendaño,20057,19899,21328,41227
2024,Oaxaca,20,Mazatlán Villa de Flores,20058,6746,6897,13643
2024,Oaxaca,20,Mesones Hidalgo,20037,2125,2513,4638
2024,Oaxaca,20,Miahuatlán de Porfirio Díaz,20059,22398,24599,46997
2024,Oaxaca,20,Mixistlán de la Reforma,20060,1294,1443,2737
2024,Oaxaca,20,Monjas,20061,1350,1591,2941
2024,Oaxaca,20,Mártires de Tacubaya,20056,737,800,1537
2024,Oaxaca,20,Natividad,20062,319,362,681
2024,Oaxaca,20,Nazareno Etla,20063,2065,2276,4341
2024,Oaxaca,20,Nejapa de Madero,20064,3877,4029,7906
2024,Oaxaca,20,Nuevo Zoquiápam,20504,824,891,1715
2024,Oaxaca,20,Oaxaca de Juárez,20067,121502,139321,260823
2024,Oaxaca,20,Ocotlán de Morelos,20068,11213,12193,23406
2024,Oaxaca,20,Pinotepa de Don Luis,20070,3612,3709,7321
2024,Oaxaca,20,Pluma Hidalgo,20071,1480,1546,3026
2024,Oaxaca,20,Putla Villa de Guerrero,20073,16639,18745,35384
2024,Oaxaca,20,Reforma de Pineda,20075,1440,1545,2985
2024,Oaxaca,20,Reyes Etla,20077,2055,2183,4238
2024,Oaxaca,20,Rojas de Cuauhtémoc,20078,560,634,1194
2024,Oaxaca,20,Salina Cruz,20079,45448,49207,94655
2024,Oaxaca,20,San Agustín Amatengo,20080,719,815,1534
2024,Oaxaca,20,San Agustín Atenango,20081,852,971,1823
2024,Oaxaca,20,San Agustín Chayuco,20082,1937,2145,4082
2024,Oaxaca,20,San Agustín Etla,20084,2098,2317,4415
2024,Oaxaca,20,San Agustín Loxicha,20085,12889,13400,26289
2024,Oaxaca,20,San Agustín Tlacotepec,20086,428,580,1008
2024,Oaxaca,20,San Agustín Yatareni,20087,2226,2520,4746
2024,Oaxaca,20,San Agustín de las Juntas,20083,5161,5366,10527
2024,Oaxaca,20,San Andrés Cabecera Nueva,20088,1443,1475,2918
2024,Oaxaca,20,San Andrés Dinicuiti,20089,1083,1142,2225
2024,Oaxaca,20,San Andrés Huaxpaltepec,20090,3150,3330,6480
2024,Oaxaca,20,San Andrés Huayápam,20091,2758,3021,5779
2024,Oaxaca,20,San Andrés Ixtlahuaca,20092,810,913,1723
2024,Oaxaca,20,San Andrés Lagunas,20093,238,280,518
2024,Oaxaca,20,San Andrés Nuxiño,20094,862,946,1808
2024,Oaxaca,20,San Andrés Paxtlán,20095,2284,2291,4575
2024,Oaxaca,20,San Andrés Sinaxtla,20096,372,430,802
2024,Oaxaca,20,San Andrés Solaga,20097,889,945,1834
2024,Oaxaca,20,San Andrés Teotilálpam,20098,2218,2423,4641
2024,Oaxaca,20,San Andrés Tepetlapa,20099,248,284,532
2024,Oaxaca,20,San Andrés Yaá,20100,222,263,485
2024,Oaxaca,20,San Andrés Zabache,20101,331,417,748
2024,Oaxaca,20,San Andrés Zautla,20102,2409,2562,4971
2024,Oaxaca,20,San Antonino Castillo Velasco,20103,3112,3410,6522
2024,Oaxaca,20,San Antonino Monte Verde,20105,3491,4085,7576
2024,Oaxaca,20,San Antonino el Alto,20104,1415,1452,2867
2024,Oaxaca,20,San Antonio Acutla,20106,118,146,264
2024,Oaxaca,20,San Antonio Huitepec,20108,2148,2510,4658
2024,Oaxaca,20,San Antonio Nanahuatípam,20109,647,653,1300
2024,Oaxaca,20,San Antonio Sinicahua,20110,769,893,1662
2024,Oaxaca,20,San Antonio Tepetlapa,20111,2177,2349,4526
2024,Oaxaca,20,San Antonio de la Cal,20107,12439,13866,26305
2024,Oaxaca,20,San Baltazar Chichicápam,20112,1249,1426,2675
2024,Oaxaca,20,San Baltazar Loxicha,20113,1524,1589,3113
2024,Oaxaca,20,San Baltazar Yatzachi el Bajo,20114,325,370,695
2024,Oaxaca,20,San Bartolo Coyotepec,20115,4979,5540,10519
2024,Oaxaca,20,San Bartolo Soyaltepec,20121,310,383,693
2024,Oaxaca,20,San Bartolo Yautepec,20122,341,351,692
2024,Oaxaca,20,San Bartolomé Ayautla,20116,2298,2458,4756
2024,Oaxaca,20,San Bartolomé Loxicha,20117,1183,1225,2408
2024,Oaxaca,20,San Bartolomé Quialana,20118,1059,1511,2570
2024,Oaxaca,20,San Bartolomé Yucuañe,20119,165,234,399
2024,Oaxaca,20,San Bartolomé Zoogocho,20120,131,183,314
2024,Oaxaca,20,San Bernardo Mixtepec,20123,1373,1476,2849
2024,Oaxaca,20,San Blas Atempa,20124,9593,9499,19092
2024,Oaxaca,20,San Carlos Yautepec,20125,6513,6385,12898
2024,Oaxaca,20,San Cristóbal Amatlán,20126,2599,2954,5553
2024,Oaxaca,20,San Cristóbal Amoltepec,20127,521,627,1148
2024,Oaxaca,20,San Cristóbal Lachirioag,20128,651,703,1354
2024,Oaxaca,20,San Cristóbal Suchixtlahuaca,20129,191,203,394
2024,Oaxaca,20,San Dionisio Ocotepec,20131,5302,6016,11318
2024,Oaxaca,20,San Dionisio Ocotlán,20132,605,621,1226
2024,Oaxaca,20,San Dionisio del Mar,20130,2773,2654,5427
2024,Oaxaca,20,San Esteban Atatlahuca,20133,1935,2033,3968
2024,Oaxaca,20,San Felipe Jalapa de Díaz,20134,14142,15142,29284
2024,Oaxaca,20,San Felipe Tejalápam,20135,4022,4401,8423
2024,Oaxaca,20,San Felipe Usila,20136,5817,6312,12129
2024,Oaxaca,20,San Francisco Cahuacuá,20137,1761,1792,3553
2024,Oaxaca,20,San Francisco Cajonos,20138,221,246,467
2024,Oaxaca,20,San Francisco Chapulapa,20139,1041,1123,2164
2024,Oaxaca,20,San Francisco Chindúa,20140,419,444,863
2024,Oaxaca,20,San Francisco Huehuetlán,20142,501,635,1136
2024,Oaxaca,20,San Francisco Ixhuatán,20143,4678,4741,9419
2024,Oaxaca,20,San Francisco Jaltepetongo,20144,518,541,1059
2024,Oaxaca,20,San Francisco Lachigoló,20145,2347,2433,4780
2024,Oaxaca,20,San Francisco Logueche,20146,1445,1661,3106
2024,Oaxaca,20,San Francisco Nuxaño,20147,205,195,400
2024,Oaxaca,20,San Francisco Ozolotepec,20148,958,1024,1982
2024,Oaxaca,20,San Francisco Sola,20149,863,959,1822
2024,Oaxaca,20,San Francisco Telixtlahuaca,20150,6670,7164,13834
2024,Oaxaca,20,San Francisco Teopan,20151,180,164,344
2024,Oaxaca,20,San Francisco Tlapancingo,20152,1065,1346,2411
2024,Oaxaca,20,San Francisco del Mar,20141,4175,4078,8253
2024,Oaxaca,20,San Gabriel Mixtepec,20153,2520,2677,5197
2024,Oaxaca,20,San Ildefonso Amatlán,20154,1236,1419,2655
2024,Oaxaca,20,San Ildefonso Sola,20155,518,508,1026
2024,Oaxaca,20,San Ildefonso Villa Alta,20156,1759,1860,3619
2024,Oaxaca,20,San Jacinto Amilpas,20157,8987,9917,18904
2024,Oaxaca,20,San Jacinto Tlacotepec,20158,1094,1153,2247
2024,Oaxaca,20,San Jerónimo Coatlán,20159,2675,2832,5507
2024,Oaxaca,20,San Jerónimo Silacayoapilla,20160,692,717,1409
2024,Oaxaca,20,San Jerónimo Sosola,20161,1306,1469,2775
2024,Oaxaca,20,San Jerónimo Taviche,20162,974,1052,2026
2024,Oaxaca,20,San Jerónimo Tecóatl,20163,802,901,1703
2024,Oaxaca,20,San Jerónimo Tlacochahuaya,20550,2784,3124,5908
2024,Oaxaca,20,San Jorge Nuchita,20164,1354,1612,2966
2024,Oaxaca,20,San José Ayuquila,20165,758,881,1639
2024,Oaxaca,20,San José Chiltepec,20166,6285,6632,12917
2024,Oaxaca,20,San José Estancia Grande,20168,556,561,1117
2024,Oaxaca,20,San José Independencia,20169,1849,1987,3836
2024,Oaxaca,20,San José Lachiguiri,20170,1623,2024,3647
2024,Oaxaca,20,San José Tenango,20171,9164,9957,19121
2024,Oaxaca,20,San José del Peñasco,20167,1102,1146,2248
2024,Oaxaca,20,San José del Progreso,20072,3483,3689,7172
2024,Oaxaca,20,San Juan Achiutla,20172,214,222,436
2024,Oaxaca,20,San Juan Atepec,20173,752,843,1595
2024,Oaxaca,20,San Juan Bautista Atatlahuca,20175,816,867,1683
2024,Oaxaca,20,San Juan Bautista Coixtlahuaca,20176,1322,1475,2797
2024,Oaxaca,20,San Juan Bautista Cuicatlán,20177,5144,5458,10602
2024,Oaxaca,20,San Juan Bautista Guelache,20178,3891,4351,8242
2024,Oaxaca,20,San Juan Bautista Jayacatlán,20179,814,797,1611
2024,Oaxaca,20,San Juan Bautista Lo de Soto,20180,1362,1393,2755
2024,Oaxaca,20,San Juan Bautista Suchitepec,20181,220,258,478
2024,Oaxaca,20,San Juan Bautista Tlachichilco,20183,675,778,1453
2024,Oaxaca,20,San Juan Bautista Tlacoatzintepec,20182,1063,1181,2244
2024,Oaxaca,20,San Juan Bautista Tuxtepec,20184,83331,90315,173646
2024,Oaxaca,20,San Juan Bautista Valle Nacional,20559,11364,12345,23709
2024,Oaxaca,20,San Juan Cacahuatepec,20185,4624,4832,9456
2024,Oaxaca,20,San Juan Chicomezúchil,20191,166,195,361
2024,Oaxaca,20,San Juan Chilateca,20192,757,881,1638
2024,Oaxaca,20,San Juan Cieneguilla,20186,297,324,621
2024,Oaxaca,20,San Juan Coatzóspam,20187,1089,1073,2162
2024,Oaxaca,20,San Juan Colorado,20188,5098,5423,10521
2024,Oaxaca,20,San Juan Comaltepec,20189,1468,1535,3003
2024,Oaxaca,20,San Juan Cotzocón,20190,12169,12808,24977
2024,Oaxaca,20,San Juan Diuxi,20195,555,575,1130
2024,Oaxaca,20,San Juan Evangelista Analco,20196,218,237,455
2024,Oaxaca,20,San Juan Guelavía,20197,1704,1811,3515
2024,Oaxaca,20,San Juan Guichicovi,20198,14834,16736,31570
2024,Oaxaca,20,San Juan Ihualtepec,20199,303,353,656
2024,Oaxaca,20,San Juan Juquila Mixes,20200,1917,2144,4061
2024,Oaxaca,20,San Juan Juquila Vijanos,20201,980,1077,2057
2024,Oaxaca,20,San Juan Lachao,20202,2440,2610,5050
2024,Oaxaca,20,San Juan Lachigalla,20203,1660,1801,3461
2024,Oaxaca,20,San Juan Lajarcia,20204,311,382,693
2024,Oaxaca,20,San Juan Lalana,20205,8626,9054,17680
2024,Oaxaca,20,San Juan Mazatlán,20207,9717,9835,19552
2024,Oaxaca,20,San Juan Mixtepec Distrito 08,20208,3393,3875,7268
2024,Oaxaca,20,San Juan Mixtepec Distrito 26,20209,284,413,697
2024,Oaxaca,20,San Juan Ozolotepec,20211,1386,1366,2752
2024,Oaxaca,20,San Juan Petlapa,20212,1489,1587,3076
2024,Oaxaca,20,San Juan Quiahije,20213,1920,2188,4108
2024,Oaxaca,20,San Juan Quiotepec,20214,1052,1088,2140
2024,Oaxaca,20,San Juan Sayultepec,20215,399,469,868
2024,Oaxaca,20,San Juan Tabaá,20216,678,745,1423
2024,Oaxaca,20,San Juan Tamazola,20217,1507,1584,3091
2024,Oaxaca,20,San Juan Teita,20218,322,338,660
2024,Oaxaca,20,San Juan Teitipac,20219,1322,1451,2773
2024,Oaxaca,20,San Juan Tepeuxila,20220,1421,1343,2764
2024,Oaxaca,20,San Juan Teposcolula,20221,635,671,1306
2024,Oaxaca,20,San Juan Yaeé,20222,747,842,1589
2024,Oaxaca,20,San Juan Yatzona,20223,211,274,485
2024,Oaxaca,20,San Juan Yucuita,20224,284,337,621
2024,Oaxaca,20,San Juan de los Cués,20206,1253,1281,2534
2024,Oaxaca,20,San Juan del Estado,20193,1378,1488,2866
2024,Oaxaca,20,San Juan del Río,20194,622,739,1361
2024,Oaxaca,20,San Juan Ñumí,20210,2872,3302,6174
2024,Oaxaca,20,San Lorenzo,20225,3103,3345,6448
2024,Oaxaca,20,San Lorenzo Albarradas,20226,1504,1454,2958
2024,Oaxaca,20,San Lorenzo Cacaotepec,20227,8248,8960,17208
2024,Oaxaca,20,San Lorenzo Cuaunecuiltitla,20228,450,408,858
2024,Oaxaca,20,San Lorenzo Texmelúcan,20229,4010,4684,8694
2024,Oaxaca,20,San Lorenzo Victoria,20230,516,533,1049
2024,Oaxaca,20,San Lucas Camotlán,20231,1519,1637,3156
2024,Oaxaca,20,San Lucas Ojitlán,20232,10224,10876,21100
2024,Oaxaca,20,San Lucas Quiaviní,20233,758,1076,1834
2024,Oaxaca,20,San Lucas Zoquiápam,20234,3794,4021,7815
2024,Oaxaca,20,San Luis Amatlán,20235,1775,2090,3865
2024,Oaxaca,20,San Marcial Ozolotepec,20236,746,828,1574
2024,Oaxaca,20,San Marcos Arteaga,20237,626,723,1349
2024,Oaxaca,20,San Martín Huamelúlpam,20239,511,607,1118
2024,Oaxaca,20,San Martín Itunyoso,20240,997,1271,2268
2024,Oaxaca,20,San Martín Lachilá,20241,510,639,1149
2024,Oaxaca,20,San Martín Peras,20242,6036,6523,12559
2024,Oaxaca,20,San Martín Tilcajete,20243,860,1062,1922
2024,Oaxaca,20,San Martín Toxpalan,20244,1960,2076,4036
2024,Oaxaca,20,San Martín Zacatepec,20245,671,691,1362
2024,Oaxaca,20,San Martín de los Cansecos,20238,450,460,910
2024,Oaxaca,20,San Mateo Cajonos,20246,304,364,668
2024,Oaxaca,20,San Mateo Etlatongo,20250,586,622,1208
2024,Oaxaca,20,San Mateo Nejápam,20251,568,627,1195
2024,Oaxaca,20,San Mateo Peñasco,20252,1055,1213,2268
2024,Oaxaca,20,San Mateo Piñas,20253,966,976,1942
2024,Oaxaca,20,San Mateo Río Hondo,20254,1622,1697,3319
2024,Oaxaca,20,San Mateo Sindihui,20255,1013,1131,2144
2024,Oaxaca,20,San Mateo Tlapiltepec,20256,106,129,235
2024,Oaxaca,20,San Mateo Yoloxochitlán,20249,1813,2007,3820
2024,Oaxaca,20,San Mateo Yucutindoo,20566,1578,1615,3193
2024,Oaxaca,20,San Mateo del Mar,20248,8210,7939,16149
2024,Oaxaca,20,San Melchor Betaza,20257,508,588,1096
2024,Oaxaca,20,San Miguel Achiutla,20258,381,424,805
2024,Oaxaca,20,San Miguel Ahuehuetitlán,20259,1198,1330,2528
2024,Oaxaca,20,San Miguel Aloápam,20260,1063,1212,2275
2024,Oaxaca,20,San Miguel Amatitlán,20261,3771,4234,8005
2024,Oaxaca,20,San Miguel Amatlán,20262,501,532,1033
2024,Oaxaca,20,San Miguel Chicahua,20264,1017,1255,2272
2024,Oaxaca,20,San Miguel Chimalapa,20265,3733,3516,7249
2024,Oaxaca,20,San Miguel Coatlán,20263,1576,1863,3439
2024,Oaxaca,20,San Miguel Ejutla,20268,490,574,1064
2024,Oaxaca,20,San Miguel Huautla,20270,534,626,1160
2024,Oaxaca,20,San Miguel Mixtepec,20271,1659,1704,3363
2024,Oaxaca,20,San Miguel Panixtlahuaca,20272,2997,3707,6704
2024,Oaxaca,20,San Miguel Peras,20273,1690,1821,3511
2024,Oaxaca,20,San Miguel Piedras,20274,658,698,1356
2024,Oaxaca,20,San Miguel Quetzaltepec,20275,4435,4366,8801
2024,Oaxaca,20,San Miguel Santa Flor,20276,370,370,740
2024,Oaxaca,20,San Miguel Soyaltepec,20278,19917,21211,41128
2024,Oaxaca,20,San Miguel Suchixtepec,20279,1356,1505,2861
2024,Oaxaca,20,San Miguel Tecomatlán,20281,173,151,324
2024,Oaxaca,20,San Miguel Tenango,20282,390,374,764
2024,Oaxaca,20,San Miguel Tequixtepec,20283,518,563,1081
2024,Oaxaca,20,San Miguel Tilquiápam,20284,1413,1813,3226
2024,Oaxaca,20,San Miguel Tlacamama,20285,1908,1963,3871
2024,Oaxaca,20,San Miguel Tlacotepec,20286,1524,1751,3275
2024,Oaxaca,20,San Miguel Tulancingo,20287,131,199,330
2024,Oaxaca,20,San Miguel Yotao,20288,297,331,628
2024,Oaxaca,20,San Miguel del Puerto,20266,4308,4397,8705
2024,Oaxaca,20,San Miguel del Río,20267,147,139,286
2024,Oaxaca,20,San Miguel el Grande,20269,2149,2427,4576
2024,Oaxaca,20,San Nicolás,20289,557,674,1231
2024,Oaxaca,20,San Nicolás Hidalgo,20290,495,575,1070
2024,Oaxaca,20,San Pablo Coatlán,20291,2167,2267,4434
2024,Oaxaca,20,San Pablo Cuatro Venados,20292,688,784,1472
2024,Oaxaca,20,San Pablo Etla,20293,9418,10457,19875
2024,Oaxaca,20,San Pablo Huitzo,20294,3620,4076,7696
2024,Oaxaca,20,San Pablo Huixtepec,20295,4781,5251,10032
2024,Oaxaca,20,San Pablo Macuiltianguis,20296,465,488,953
2024,Oaxaca,20,San Pablo Tijaltepec,20297,1129,1361,2490
2024,Oaxaca,20,San Pablo Villa de Mitla,20298,6486,7059,13545
2024,Oaxaca,20,San Pablo Yaganiza,20299,527,595,1122
2024,Oaxaca,20,San Pedro Amuzgos,20300,3348,3838,7186
2024,Oaxaca,20,San Pedro Apóstol,20301,751,883,1634
2024,Oaxaca,20,San Pedro Atoyac,20302,2221,2487,4708
2024,Oaxaca,20,San Pedro Cajonos,20303,527,642,1169
2024,Oaxaca,20,San Pedro Comitancillo,20305,2177,2380,4557
2024,Oaxaca,20,San Pedro Coxcaltepec Cántaros,20304,369,413,782
2024,Oaxaca,20,San Pedro Huamelula,20307,5191,5221,10412
2024,Oaxaca,20,San Pedro Huilotepec,20308,1663,1689,3352
2024,Oaxaca,20,San Pedro Ixcatlán,20309,5835,6131,11966
2024,Oaxaca,20,San Pedro Ixtlahuaca,20310,4739,5019,9758
2024,Oaxaca,20,San Pedro Jaltepetongo,20311,280,317,597
2024,Oaxaca,20,San Pedro Jicayán,20312,6212,6834,13046
2024,Oaxaca,20,San Pedro Jocotipac,20313,372,448,820
2024,Oaxaca,20,San Pedro Juchatengo,20314,804,887,1691
2024,Oaxaca,20,San Pedro Mixtepec Distrito 22,20318,25726,26950,52676
2024,Oaxaca,20,San Pedro Mixtepec Distrito 26,20319,543,589,1132
2024,Oaxaca,20,San Pedro Molinos,20320,336,375,711
2024,Oaxaca,20,San Pedro Mártir,20315,768,967,1735
2024,Oaxaca,20,San Pedro Mártir Quiechapa,20316,345,391,736
2024,Oaxaca,20,San Pedro Mártir Yucuxaco,20317,600,706,1306
2024,Oaxaca,20,San Pedro Nopala,20321,361,394,755
2024,Oaxaca,20,San Pedro Ocopetatillo,20322,395,462,857
2024,Oaxaca,20,San Pedro Ocotepec,20323,1072,1152,2224
2024,Oaxaca,20,San Pedro Pochutla,20324,24732,25586,50318
2024,Oaxaca,20,San Pedro Quiatoni,20325,5615,5935,11550
2024,Oaxaca,20,San Pedro Sochiápam,20326,2616,2685,5301
2024,Oaxaca,20,San Pedro Tapanatepec,20327,7692,7866,15558
2024,Oaxaca,20,San Pedro Taviche,20328,626,642,1268
2024,Oaxaca,20,San Pedro Teozacoalco,20329,624,667,1291
2024,Oaxaca,20,San Pedro Teutila,20330,2194,2270,4464
2024,Oaxaca,20,San Pedro Tidaá,20331,453,525,978
2024,Oaxaca,20,San Pedro Topiltepec,20332,183,205,388
2024,Oaxaca,20,San Pedro Totolápam,20333,1328,1472,2800
2024,Oaxaca,20,San Pedro Yaneri,20335,464,497,961
2024,Oaxaca,20,San Pedro Yucunama,20341,103,138,241
2024,Oaxaca,20,San Pedro Yólox,20336,853,928,1781
2024,Oaxaca,20,San Pedro el Alto,20306,1799,1908,3707
2024,Oaxaca,20,San Pedro y San Pablo Ayutla,20337,2513,3005,5518
2024,Oaxaca,20,San Pedro y San Pablo Teposcolula,20339,2096,2326,4422
2024,Oaxaca,20,San Pedro y San Pablo Tequixtepec,20340,832,1016,1848
2024,Oaxaca,20,San Raymundo Jalpan,20342,1779,2137,3916
2024,Oaxaca,20,San Sebastián Abasolo,20343,986,1071,2057
2024,Oaxaca,20,San Sebastián Coatlán,20344,1382,1468,2850
2024,Oaxaca,20,San Sebastián Ixcapa,20345,2149,2198,4347
2024,Oaxaca,20,San Sebastián Nicananduta,20346,666,873,1539
2024,Oaxaca,20,San Sebastián Río Hondo,20347,1908,1938,3846
2024,Oaxaca,20,San Sebastián Tecomaxtlahuaca,20348,4151,4589,8740
2024,Oaxaca,20,San Sebastián Teitipac,20349,949,1125,2074
2024,Oaxaca,20,San Sebastián Tutla,20350,8890,10302,19192
2024,Oaxaca,20,San Simón Almolongas,20351,1386,1596,2982
2024,Oaxaca,20,San Simón Zahuatlán,20352,2200,2253,4453
2024,Oaxaca,20,San Vicente Coatlán,20534,1865,2226,4091
2024,Oaxaca,20,San Vicente Lachixío,20535,1337,1532,2869
2024,Oaxaca,20,San Vicente Nuñú,20536,209,246,455
2024,Oaxaca,20,Santa Ana,20353,1122,1205,2327
2024,Oaxaca,20,Santa Ana Ateixtlahuaca,20354,269,269,538
2024,Oaxaca,20,Santa Ana Cuauhtémoc,20355,360,386,746
2024,Oaxaca,20,Santa Ana Tavela,20357,411,443,854
2024,Oaxaca,20,Santa Ana Tlapacoyan,20358,1051,1131,2182
2024,Oaxaca,20,Santa Ana Yareni,20359,440,503,943
2024,Oaxaca,20,Santa Ana Zegache,20360,1894,2133,4027
2024,Oaxaca,20,Santa Ana del Valle,20356,1075,1127,2202
2024,Oaxaca,20,Santa Catalina Quierí,20361,428,538,966
2024,Oaxaca,20,Santa Catarina Cuixtla,20362,696,872,1568
2024,Oaxaca,20,Santa Catarina Ixtepeji,20363,1329,1441,2770
2024,Oaxaca,20,Santa Catarina Juquila,20364,7999,8501,16500
2024,Oaxaca,20,Santa Catarina Lachatao,20365,551,603,1154
2024,Oaxaca,20,Santa Catarina Loxicha,20366,1956,2023,3979
2024,Oaxaca,20,Santa Catarina Mechoacán,20367,2332,2384,4716
2024,Oaxaca,20,Santa Catarina Minas,20368,1022,1054,2076
2024,Oaxaca,20,Santa Catarina Quiané,20369,1009,1059,2068
2024,Oaxaca,20,Santa Catarina Quioquitani,20074,276,302,578
2024,Oaxaca,20,Santa Catarina Tayata,20370,317,381,698
2024,Oaxaca,20,Santa Catarina Ticuá,20371,509,632,1141
2024,Oaxaca,20,Santa Catarina Yosonotú,20372,800,976,1776
2024,Oaxaca,20,Santa Catarina Zapoquila,20373,182,210,392
2024,Oaxaca,20,Santa Cruz Acatepec,20374,795,871,1666
2024,Oaxaca,20,Santa Cruz Amilpas,20375,6592,7616,14208
2024,Oaxaca,20,Santa Cruz Itundujia,20377,5841,6341,12182
2024,Oaxaca,20,Santa Cruz Mixtepec,20378,1788,1962,3750
2024,Oaxaca,20,Santa Cruz Nundaco,20379,1435,1688,3123
2024,Oaxaca,20,Santa Cruz Papalutla,20380,1117,1179,2296
2024,Oaxaca,20,Santa Cruz Tacache de Mina,20381,1361,1496,2857
2024,Oaxaca,20,Santa Cruz Tacahua,20382,547,618,1165
2024,Oaxaca,20,Santa Cruz Tayata,20383,314,324,638
2024,Oaxaca,20,Santa Cruz Xitla,20384,2417,2677,5094
2024,Oaxaca,20,Santa Cruz Xoxocotlán,20385,48213,54149,102362
2024,Oaxaca,20,Santa Cruz Zenzontepec,20386,9352,9811,19163
2024,Oaxaca,20,Santa Cruz de Bravo,20376,187,202,389
2024,Oaxaca,20,Santa Gertrudis,20387,1461,1554,3015
2024,Oaxaca,20,Santa Inés Yatzeche,20389,413,549,962
2024,Oaxaca,20,Santa Inés de Zaragoza,20569,797,914,1711
2024,Oaxaca,20,Santa Inés del Monte,20388,1223,1280,2503
2024,Oaxaca,20,Santa Lucía Miahuatlán,20391,1749,1845,3594
2024,Oaxaca,20,Santa Lucía Monteverde,20392,3238,3544,6782
2024,Oaxaca,20,Santa Lucía Ocotlán,20393,1847,2196,4043
2024,Oaxaca,20,Santa Lucía del Camino,20390,25167,27452,52619
2024,Oaxaca,20,Santa Magdalena Jicotlán,20047,45,55,100
2024,Oaxaca,20,Santa María Alotepec,20394,1461,1494,2955
2024,Oaxaca,20,Santa María Apazco,20395,810,1034,1844
2024,Oaxaca,20,Santa María Atzompa,20399,18644,20021,38665
2024,Oaxaca,20,Santa María Camotlán,20400,810,938,1748
2024,Oaxaca,20,Santa María Chachoápam,20404,368,417,785
2024,Oaxaca,20,Santa María Chilchotla,20406,10359,10782,21141
2024,Oaxaca,20,Santa María Chimalapa,20407,4818,4664,9482
2024,Oaxaca,20,Santa María Colotepec,20401,12748,12942,25690
2024,Oaxaca,20,Santa María Cortijo,20402,538,578,1116
2024,Oaxaca,20,Santa María Coyotepec,20403,1592,1763,3355
2024,Oaxaca,20,Santa María Ecatepec,20410,1757,1794,3551
2024,Oaxaca,20,Santa María Guelacé,20411,391,483,874
2024,Oaxaca,20,Santa María Guienagati,20412,1641,1644,3285
2024,Oaxaca,20,Santa María Huatulco,20413,23432,24324,47756
2024,Oaxaca,20,Santa María Huazolotitlán,20414,5967,6136,12103
2024,Oaxaca,20,Santa María Ipalapa,20415,2500,2763,5263
2024,Oaxaca,20,Santa María Ixcatlán,20416,245,273,518
2024,Oaxaca,20,Santa María Jacatepec,20417,4583,5118,9701
2024,Oaxaca,20,Santa María Jalapa del Marqués,20418,6818,7195,14013
2024,Oaxaca,20,Santa María Jaltianguis,20419,249,303,552
2024,Oaxaca,20,Santa María Lachixío,20420,959,1121,2080
2024,Oaxaca,20,Santa María Mixtequilla,20421,2402,2542,4944
2024,Oaxaca,20,Santa María Nativitas,20422,286,345,631
2024,Oaxaca,20,Santa María Nduayaco,20423,260,260,520
2024,Oaxaca,20,Santa María Ozolotepec,20424,1922,2048,3970
2024,Oaxaca,20,Santa María Petapa,20427,8428,9042,17470
2024,Oaxaca,20,Santa María Peñoles,20426,4349,4583,8932
2024,Oaxaca,20,Santa María Pápalo,20425,1109,1108,2217
2024,Oaxaca,20,Santa María Quiegolani,20428,1037,1018,2055
2024,Oaxaca,20,Santa María Sola,20429,742,807,1549
2024,Oaxaca,20,Santa María Tataltepec,20430,200,217,417
2024,Oaxaca,20,Santa María Tecomavaca,20431,847,910,1757
2024,Oaxaca,20,Santa María Temaxcalapa,20432,477,499,976
2024,Oaxaca,20,Santa María Temaxcaltepec,20433,1253,1425,2678
2024,Oaxaca,20,Santa María Teopoxco,20434,2054,2349,4403
2024,Oaxaca,20,Santa María Tepantlali,20435,1968,2047,4015
2024,Oaxaca,20,Santa María Texcatitlán,20436,498,543,1041
2024,Oaxaca,20,Santa María Tlahuitoltepec,20437,4684,5027,9711
2024,Oaxaca,20,Santa María Tlalixtac,20438,865,919,1784
2024,Oaxaca,20,Santa María Tonameca,20439,13315,13518,26833
2024,Oaxaca,20,Santa María Totolapilla,20440,407,453,860
2024,Oaxaca,20,Santa María Xadani,20441,4711,4630,9341
2024,Oaxaca,20,Santa María Yalina,20442,132,157,289
2024,Oaxaca,20,Santa María Yavesía,20443,242,300,542
2024,Oaxaca,20,Santa María Yolotepec,20444,206,223,429
2024,Oaxaca,20,Santa María Yosoyúa,20445,875,859,1734
2024,Oaxaca,20,Santa María Yucuhiti,20446,3135,3436,6571
2024,Oaxaca,20,Santa María Zacatepec,20447,7956,8936,16892
2024,Oaxaca,20,Santa María Zaniza,20448,1120,1186,2306
2024,Oaxaca,20,Santa María Zoquitlán,20449,1574,1609,3183
2024,Oaxaca,20,Santa María del Rosario,20408,273,255,528
2024,Oaxaca,20,Santa María del Tule,20409,4483,5138,9621
2024,Oaxaca,20,Santa María la Asunción,20396,1514,1928,3442
2024,Oaxaca,20,Santiago Amoltepec,20450,6393,6824,13217
2024,Oaxaca,20,Santiago Apoala,20451,440,519,959
2024,Oaxaca,20,Santiago Apóstol,20452,1855,2303,4158
2024,Oaxaca,20,Santiago Astata,20453,2093,2114,4207
2024,Oaxaca,20,Santiago Atitlán,20454,1591,1539,3130
2024,Oaxaca,20,Santiago Ayuquililla,20455,1365,1497,2862
2024,Oaxaca,20,Santiago Cacaloxtepec,20456,819,891,1710
2024,Oaxaca,20,Santiago Camotlán,20457,1645,1659,3304
2024,Oaxaca,20,Santiago Chazumba,20459,2115,2652,4767
2024,Oaxaca,20,Santiago Choápam,20460,2610,2781,5391
2024,Oaxaca,20,Santiago Comaltepec,20458,470,518,988
2024,Oaxaca,20,Santiago Huajolotitlán,20462,2017,2393,4410
2024,Oaxaca,20,Santiago Huauclilla,20463,257,285,542
2024,Oaxaca,20,Santiago Ihuitlán Plumas,20464,163,205,368
2024,Oaxaca,20,Santiago Ixcuintepec,20465,839,866,1705
2024,Oaxaca,20,Santiago Ixtayutla,20466,6551,6915,13466
2024,Oaxaca,20,Santiago Jamiltepec,20467,9628,10447,20075
2024,Oaxaca,20,Santiago Jocotepec,20468,7238,7414,14652
2024,Oaxaca,20,Santiago Juxtlahuaca,20469,18084,19993,38077
2024,Oaxaca,20,Santiago Lachiguiri,20470,2422,2473,4895
2024,Oaxaca,20,Santiago Lalopa,20471,257,273,530
2024,Oaxaca,20,Santiago Laollaga,20472,1822,1835,3657
2024,Oaxaca,20,Santiago Laxopa,20473,655,731,1386
2024,Oaxaca,20,Santiago Llano Grande,20474,1725,1743,3468
2024,Oaxaca,20,Santiago Matatlán,20475,4892,5545,10437
2024,Oaxaca,20,Santiago Miltepec,20476,221,223,444
2024,Oaxaca,20,Santiago Minas,20477,709,725,1434
2024,Oaxaca,20,Santiago Nacaltepec,20478,878,983,1861
2024,Oaxaca,20,Santiago Nejapilla,20479,116,105,221
2024,Oaxaca,20,Santiago Niltepec,20066,2832,2878,5710
2024,Oaxaca,20,Santiago Nundiche,20480,461,509,970
2024,Oaxaca,20,Santiago Nuyoó,20481,849,943,1792
2024,Oaxaca,20,Santiago Pinotepa Nacional,20482,27540,28860,56400
2024,Oaxaca,20,Santiago Suchilquitongo,20483,5414,5826,11240
2024,Oaxaca,20,Santiago Tamazola,20484,2203,2518,4721
2024,Oaxaca,20,Santiago Tapextla,20485,1640,1585,3225
2024,Oaxaca,20,Santiago Tenango,20487,1086,1084,2170
2024,Oaxaca,20,Santiago Tepetlapa,20488,57,70,127
2024,Oaxaca,20,Santiago Tetepec,20489,2543,2580,5123
2024,Oaxaca,20,Santiago Texcalcingo,20490,1571,1688,3259
2024,Oaxaca,20,Santiago Textitlán,20491,2304,2313,4617
2024,Oaxaca,20,Santiago Tilantongo,20492,1392,1642,3034
2024,Oaxaca,20,Santiago Tillo,20493,267,310,577
2024,Oaxaca,20,Santiago Tlazoyaltepec,20494,2278,2709,4987
2024,Oaxaca,20,Santiago Xanica,20495,1584,1572,3156
2024,Oaxaca,20,Santiago Xiacuí,20496,1058,1163,2221
2024,Oaxaca,20,Santiago Yaitepec,20497,2074,2460,4534
2024,Oaxaca,20,Santiago Yaveo,20498,3672,3641,7313
2024,Oaxaca,20,Santiago Yolomécatl,20499,1040,1222,2262
2024,Oaxaca,20,Santiago Yosondúa,20500,4220,4736,8956
2024,Oaxaca,20,Santiago Yucuyachi,20501,472,511,983
2024,Oaxaca,20,Santiago Zacatepec,20502,2738,2830,5568
2024,Oaxaca,20,Santiago Zoochila,20503,190,212,402
2024,Oaxaca,20,Santiago del Río,20461,281,308,589
2024,Oaxaca,20,Santo Domingo Albarradas,20506,380,435,815
2024,Oaxaca,20,Santo Domingo Armenta,20507,1795,1808,3603
2024,Oaxaca,20,Santo Domingo Chihuitán,20508,796,820,1616
2024,Oaxaca,20,Santo Domingo Ingenio,20505,4260,4272,8532
2024,Oaxaca,20,Santo Domingo Ixcatlán,20510,284,344,628
2024,Oaxaca,20,Santo Domingo Nuxaá,20511,1620,1729,3349
2024,Oaxaca,20,Santo Domingo Ozolotepec,20512,396,430,826
2024,Oaxaca,20,Santo Domingo Petapa,20513,4935,4852,9787
2024,Oaxaca,20,Santo Domingo Roayaga,20514,516,563,1079
2024,Oaxaca,20,Santo Domingo Tehuantepec,20515,33850,35697,69547
2024,Oaxaca,20,Santo Domingo Teojomulco,20516,2586,2712,5298
2024,Oaxaca,20,Santo Domingo Tepuxtepec,20517,2844,3234,6078
2024,Oaxaca,20,Santo Domingo Tlatayápam,20518,68,78,146
2024,Oaxaca,20,Santo Domingo Tomaltepec,20519,1558,1604,3162
2024,Oaxaca,20,Santo Domingo Tonaltepec,20521,112,141,253
2024,Oaxaca,20,Santo Domingo Tonalá,20520,3463,3848,7311
2024,Oaxaca,20,Santo Domingo Xagacía,20522,577,660,1237
2024,Oaxaca,20,Santo Domingo Yanhuitlán,20523,781,878,1659
2024,Oaxaca,20,Santo Domingo Yodohino,20524,149,159,308
2024,Oaxaca,20,Santo Domingo Zanatepec,20525,6445,6521,12966
2024,Oaxaca,20,Santo Domingo de Morelos,20509,5506,6147,11653
2024,Oaxaca,20,Santo Tomás Jalieza,20530,1808,1993,3801
2024,Oaxaca,20,Santo Tomás Mazaltepec,20531,1367,1490,2857
2024,Oaxaca,20,Santo Tomás Ocotepec,20532,1856,2129,3985
2024,Oaxaca,20,Santo Tomás Tamazulapan,20533,1161,1236,2397
2024,Oaxaca,20,Santos Reyes Nopala,20526,9039,9646,18685
2024,Oaxaca,20,Santos Reyes Pápalo,20527,1319,1433,2752
2024,Oaxaca,20,Santos Reyes Tepejillo,20528,434,586,1020
2024,Oaxaca,20,Santos Reyes Yucuná,20529,663,670,1333
2024,Oaxaca,20,Silacayoápam,20537,3352,3795,7147
2024,Oaxaca,20,Sitio de Xitlapehua,20538,341,385,726
2024,Oaxaca,20,Soledad Etla,20539,2995,3144,6139
2024,Oaxaca,20,Tamazulápam del Espíritu Santo,20031,3541,4298,7839
2024,Oaxaca,20,Tanetze de Zaragoza,20541,833,903,1736
2024,Oaxaca,20,Taniche,20542,392,472,864
2024,Oaxaca,20,Tataltepec de Valdés,20543,2961,3109,6070
2024,Oaxaca,20,Teococuilco de Marcos Pérez,20544,433,530,963
2024,Oaxaca,20,Teotitlán de Flores Magón,20545,5011,5584,10595
2024,Oaxaca,20,Teotitlán del Valle,20546,2938,3261,6199
2024,Oaxaca,20,Teotongo,20547,468,554,1022
2024,Oaxaca,20,Tepelmeme Villa de Morelos,20548,792,949,1741
2024,Oaxaca,20,Tlacolula de Matamoros,20551,11781,13249,25030
2024,Oaxaca,20,Tlacotepec Plumas,20552,228,249,477
2024,Oaxaca,20,Tlalixtac de Cabrera,20553,5331,5900,11231
2024,Oaxaca,20,Totontepec Villa de Morelos,20554,2718,2947,5665
2024,Oaxaca,20,Trinidad Zaachila,20555,1500,1667,3167
2024,Oaxaca,20,Unión Hidalgo,20557,8069,8525,16594
2024,Oaxaca,20,Valerio Trujano,20558,669,819,1488
2024,Oaxaca,20,Villa Díaz Ordaz,20560,3301,3919,7220
2024,Oaxaca,20,Villa Hidalgo,20038,975,1077,2052
2024,Oaxaca,20,Villa Sola de Vega,20277,6340,6471,12811
2024,Oaxaca,20,Villa Talea de Castro,20280,1153,1265,2418
2024,Oaxaca,20,Villa Tejúpam de la Unión,20486,1264,1355,2619
2024,Oaxaca,20,Villa Tezoatlán de Segura y Luna,20549,5326,6254,11580
2024,Oaxaca,20,Villa de Chilapa de Díaz,20405,1017,1292,2309
2024,Oaxaca,20,Villa de Etla,20338,5627,6203,11830
2024,Oaxaca,20,Villa de Tamazulápam del Progreso,20540,3882,4345,8227
2024,Oaxaca,20,Villa de Tututepec de Melchor Ocampo,20334,23487,24456,47943
2024,Oaxaca,20,Villa de Zaachila,20565,23342,25482,48824
2024,Oaxaca,20,Yaxe,20561,1440,1558,2998
2024,Oaxaca,20,Yogana,20563,608,715,1323
2024,Oaxaca,20,Yutanduchi de Guerrero,20564,578,642,1220
2024,Oaxaca,20,Zapotitlán Lagunas,20567,1568,1754,3322
2024,Oaxaca,20,Zapotitlán Palmas,20568,682,843,1525
2024,Oaxaca,20,Zimatlán de Álvarez,20570,9977,11331,21308
2024,Oaxaca,20,Ánimas Trujano,20174,2055,2275,4330
2024,Puebla,21,Acajete,21001,34652,36855,71507
2024,Puebla,21,Acateno,21002,5066,5004,10070
2024,Puebla,21,Acatlán,21003,18038,20912,38950
2024,Puebla,21,Acatzingo,21004,31815,32966,64781
2024,Puebla,21,Acteopan,21005,1518,1701,3219
2024,Puebla,21,Ahuacatlán,21006,8242,9134,17376
2024,Puebla,21,Ahuatlán,21007,1681,1818,3499
2024,Puebla,21,Ahuazotepec,21008,6188,6365,12553
2024,Puebla,21,Ahuehuetitla,21009,897,1032,1929
2024,Puebla,21,Ajalpan,21010,35209,37102,72311
2024,Puebla,21,Albino Zertuche,21011,908,1061,1969
2024,Puebla,21,Aljojuca,21012,3432,3762,7194
2024,Puebla,21,Altepexi,21013,11450,12002,23452
2024,Puebla,21,Amixtlán,21014,2560,2829,5389
2024,Puebla,21,Amozoc,21015,64509,67124,131633
2024,Puebla,21,Aquixtla,21016,4782,4798,9580
2024,Puebla,21,Atempan,21017,14633,16392,31025
2024,Puebla,21,Atexcal,21018,1993,2146,4139
2024,Puebla,21,Atlequizayan,21080,1349,1516,2865
2024,Puebla,21,Atlixco,21019,70552,78619,149171
2024,Puebla,21,Atoyatempan,21020,3713,3931,7644
2024,Puebla,21,Atzala,21021,683,754,1437
2024,Puebla,21,Atzitzihuacán,21022,6273,7158,13431
2024,Puebla,21,Atzitzintla,21023,4968,5067,10035
2024,Puebla,21,Axutla,21024,481,555,1036
2024,Puebla,21,Ayotoxco de Guerrero,21025,4618,4764,9382
2024,Puebla,21,Calpan,21026,7562,8337,15899
2024,Puebla,21,Caltepec,21027,1980,2273,4253
2024,Puebla,21,Camocuautla,21028,1432,1460,2892
2024,Puebla,21,Caxhuacan,21029,1917,2113,4030
2024,Puebla,21,Cañada Morelos,21099,10172,10825,20997
2024,Puebla,21,Chalchicomula de Sesma,21045,25022,27127,52149
2024,Puebla,21,Chapulco,21046,4132,4420,8552
2024,Puebla,21,Chiautla,21047,10605,11259,21864
2024,Puebla,21,Chiautzingo,21048,10632,11661,22293
2024,Puebla,21,Chichiquila,21050,13625,14514,28139
2024,Puebla,21,Chiconcuautla,21049,8923,9298,18221
2024,Puebla,21,Chietla,21051,18248,19515,37763
2024,Puebla,21,Chigmecatitlán,21052,599,709,1308
2024,Puebla,21,Chignahuapan,21053,33883,35002,68885
2024,Puebla,21,Chignautla,21054,18194,19281,37475
2024,Puebla,21,Chila,21055,2366,2655,5021
2024,Puebla,21,Chila de la Sal,21056,771,820,1591
2024,Puebla,21,Chilchotla,21058,10757,10752,21509
2024,Puebla,21,Chinantla,21059,1163,1309,2472
2024,Puebla,21,Coatepec,21030,390,437,827
2024,Puebla,21,Coatzingo,21031,1518,1679,3197
2024,Puebla,21,Cohetzala,21032,746,732,1478
2024,Puebla,21,Cohuecan,21033,2551,2776,5327
2024,Puebla,21,Coronango,21034,22146,22905,45051
2024,Puebla,21,Coxcatlán,21035,10685,11784,22469
2024,Puebla,21,Coyomeapan,21036,7227,7937,15164
2024,Puebla,21,Coyotepec,21037,1178,1381,2559
2024,Puebla,21,Cuapiaxtla de Madero,21038,5553,5582,11135
2024,Puebla,21,Cuautempan,21039,4907,5268,10175
2024,Puebla,21,Cuautinchán,21040,5636,5673,11309
2024,Puebla,21,Cuautlancingo,21041,65789,69268,135057
2024,Puebla,21,Cuayuca de Andrade,21042,1655,1764,3419
2024,Puebla,21,Cuetzalan del Progreso,21043,25589,26919,52508
2024,Puebla,21,Cuyoaco,21044,8239,8937,17176
2024,Puebla,21,Domingo Arenas,21060,3915,4347,8262
2024,Puebla,21,Eloxochitlán,21061,6697,7110,13807
2024,Puebla,21,Epatlán,21062,2575,2710,5285
2024,Puebla,21,Esperanza,21063,7905,8412,16317
2024,Puebla,21,Francisco Z. Mena,21064,9449,9273,18722
2024,Puebla,21,General Felipe Ángeles,21065,10895,11779,22674
2024,Puebla,21,Guadalupe,21066,2913,3361,6274
2024,Puebla,21,Guadalupe Victoria,21067,9067,9548,18615
2024,Puebla,21,Hermenegildo Galeana,21068,4163,4239,8402
2024,Puebla,21,Honey,21057,4171,4523,8694
2024,Puebla,21,Huaquechula,21069,12662,14320,26982
2024,Puebla,21,Huatlatlauca,21070,3254,3891,7145
2024,Puebla,21,Huauchinango,21071,54759,60581,115340
2024,Puebla,21,Huehuetla,21072,10135,10421,20556
2024,Puebla,21,Huehuetlán el Chico,21073,4515,4733,9248
2024,Puebla,21,Huehuetlán el Grande,21150,3858,4091,7949
2024,Puebla,21,Huejotzingo,21074,39945,41750,81695
2024,Puebla,21,Hueyapan,21075,6734,7170,13904
2024,Puebla,21,Hueytamalco,21076,14050,14414,28464
2024,Puebla,21,Hueytlalpan,21077,2905,3052,5957
2024,Puebla,21,Huitzilan de Serdán,21078,8313,8124,16437
2024,Puebla,21,Huitziltepec,21079,2891,3107,5998
2024,Puebla,21,Ixcamilpa de Guerrero,21081,1862,2055,3917
2024,Puebla,21,Ixcaquixtla,21082,4677,5129,9806
2024,Puebla,21,Ixtacamaxtitlán,21083,13050,13363,26413
2024,Puebla,21,Ixtepec,21084,3740,3958,7698
2024,Puebla,21,Izúcar de Matamoros,21085,40463,44955,85418
2024,Puebla,21,Jalpan,21086,6304,6799,13103
2024,Puebla,21,Jolalpan,21087,6861,7381,14242
2024,Puebla,21,Jonotla,21088,2434,2534,4968
2024,Puebla,21,Jopala,21089,6939,7249,14188
2024,Puebla,21,Juan C. Bonilla,21090,11327,12310,23637
2024,Puebla,21,Juan Galindo,21091,5498,6277,11775
2024,Puebla,21,Juan N. Méndez,21092,2853,2906,5759
2024,Puebla,21,La Magdalena Tlatlauquitepec,21095,314,306,620
2024,Puebla,21,Lafragua,21093,4260,4385,8645
2024,Puebla,21,Libres,21094,18151,19100,37251
2024,Puebla,21,Los Reyes de Juárez,21118,14772,15198,29970
2024,Puebla,21,Mazapiltepec de Juárez,21096,1552,1571,3123
2024,Puebla,21,Mixtla,21097,1223,1359,2582
2024,Puebla,21,Molcaxac,21098,3151,3538,6689
2024,Puebla,21,Naupan,21100,5147,5626,10773
2024,Puebla,21,Nauzontla,21101,1781,1995,3776
2024,Puebla,21,Nealtican,21102,6511,7073,13584
2024,Puebla,21,Nicolás Bravo,21103,3331,3545,6876
2024,Puebla,21,Nopalucan,21104,16941,17341,34282
2024,Puebla,21,Ocotepec,21105,2511,2718,5229
2024,Puebla,21,Ocoyucan,21106,14598,16412,31010
2024,Puebla,21,Olintla,21107,6185,6497,12682
2024,Puebla,21,Oriental,21108,9783,10344,20127
2024,Puebla,21,Pahuatlán,21109,11514,12710,24224
2024,Puebla,21,Palmar de Bravo,21110,24986,25423,50409
2024,Puebla,21,Pantepec,21111,9770,10353,20123
2024,Puebla,21,Petlalcingo,21112,4973,5662,10635
2024,Puebla,21,Piaxtla,21113,2326,2516,4842
2024,Puebla,21,Puebla,21114,839854,913070,1752924
2024,Puebla,21,Quecholac,21115,27365,28298,55663
2024,Puebla,21,Quimixtlán,21116,11834,12151,23985
2024,Puebla,21,Rafael Lara Grajales,21117,7249,7767,15016
2024,Puebla,21,San Andrés Cholula,21119,81250,82854,164104
2024,Puebla,21,San Antonio Cañada,21120,2852,3196,6048
2024,Puebla,21,San Diego la Mesa Tochimiltzingo,21121,651,655,1306
2024,Puebla,21,San Felipe Teotlalcingo,21122,5568,5924,11492
2024,Puebla,21,San Felipe Tepatlán,21123,2085,2160,4245
2024,Puebla,21,San Gabriel Chilac,21124,8195,9081,17276
2024,Puebla,21,San Gregorio Atzompa,21125,4886,5153,10039
2024,Puebla,21,San Jerónimo Tecuanipan,21126,3278,3600,6878
2024,Puebla,21,San Jerónimo Xayacatlán,21127,1748,2006,3754
2024,Puebla,21,San José Chiapa,21128,4776,4871,9647
2024,Puebla,21,San José Miahuatlán,21129,7011,7617,14628
2024,Puebla,21,San Juan Atenco,21130,1691,1955,3646
2024,Puebla,21,San Juan Atzompa,21131,496,468,964
2024,Puebla,21,San Martín Texmelucan,21132,81204,86816,168020
2024,Puebla,21,San Martín Totoltepec,21133,318,345,663
2024,Puebla,21,San Matías Tlalancaleca,21134,11039,11396,22435
2024,Puebla,21,San Miguel Ixitlán,21135,264,293,557
2024,Puebla,21,San Miguel Xoxtla,21136,6710,7071,13781
2024,Puebla,21,San Nicolás Buenos Aires,21137,5312,5543,10855
2024,Puebla,21,San Nicolás de los Ranchos,21138,6372,6619,12991
2024,Puebla,21,San Pablo Anicano,21139,1864,2033,3897
2024,Puebla,21,San Pedro Cholula,21140,69500,75242,144742
2024,Puebla,21,San Pedro Yeloixtlahuaca,21141,1742,1882,3624
2024,Puebla,21,San Salvador Huixcolotla,21144,8130,8245,16375
2024,Puebla,21,San Salvador el Seco,21142,16325,17153,33478
2024,Puebla,21,San Salvador el Verde,21143,17154,17683,34837
2024,Puebla,21,San Sebastián Tlacotepec,21145,7488,7585,15073
2024,Puebla,21,Santa Catarina Tlaltempan,21146,442,441,883
2024,Puebla,21,Santa Inés Ahuatempan,21147,3329,3652,6981
2024,Puebla,21,Santa Isabel Cholula,21148,4608,4990,9598
2024,Puebla,21,Santiago Miahuatlán,21149,13822,14535,28357
2024,Puebla,21,Santo Tomás Hueyotlipan,21151,4538,4874,9412
2024,Puebla,21,Soltepec,21152,6631,6939,13570
2024,Puebla,21,Tecali de Herrera,21153,11916,12508,24424
2024,Puebla,21,Tecamachalco,21154,41043,43426,84469
2024,Puebla,21,Tecomatlán,21155,3037,3163,6200
2024,Puebla,21,Tehuacán,21156,166635,185132,351767
2024,Puebla,21,Tehuitzingo,21157,5834,6492,12326
2024,Puebla,21,Tenampulco,21158,3864,4010,7874
2024,Puebla,21,Teopantlán,21159,1808,2252,4060
2024,Puebla,21,Teotlalco,21160,1683,1765,3448
2024,Puebla,21,Tepanco de López,21161,10723,11841,22564
2024,Puebla,21,Tepango de Rodríguez,21162,2106,2348,4454
2024,Puebla,21,Tepatlaxco de Hidalgo,21163,9308,9773,19081
2024,Puebla,21,Tepeaca,21164,42415,45982,88397
2024,Puebla,21,Tepemaxalco,21165,566,600,1166
2024,Puebla,21,Tepeojuma,21166,4358,5041,9399
2024,Puebla,21,Tepetzintla,21167,6041,6462,12503
2024,Puebla,21,Tepexco,21168,3601,3773,7374
2024,Puebla,21,Tepexi de Rodríguez,21169,11615,11607,23222
2024,Puebla,21,Tepeyahualco,21170,9205,9355,18560
2024,Puebla,21,Tepeyahualco de Cuauhtémoc,21171,1882,2050,3932
2024,Puebla,21,Tetela de Ocampo,21172,14968,16033,31001
2024,Puebla,21,Teteles de Ávila Castillo,21173,2949,3468,6417
2024,Puebla,21,Teziutlán,21174,51207,56987,108194
2024,Puebla,21,Tianguismanalco,21175,6774,7280,14054
2024,Puebla,21,Tilapa,21176,4518,4837,9355
2024,Puebla,21,Tlachichuca,21179,15703,16286,31989
2024,Puebla,21,Tlacotepec de Benito Juárez,21177,27208,29565,56773
2024,Puebla,21,Tlacuilotepec,21178,8922,9225,18147
2024,Puebla,21,Tlahuapan,21180,21823,22042,43865
2024,Puebla,21,Tlaltenango,21181,3857,3917,7774
2024,Puebla,21,Tlanepantla,21182,2608,2811,5419
2024,Puebla,21,Tlaola,21183,10595,11244,21839
2024,Puebla,21,Tlapacoya,21184,3452,3605,7057
2024,Puebla,21,Tlapanalá,21185,4405,4801,9206
2024,Puebla,21,Tlatlauquitepec,21186,28215,31056,59271
2024,Puebla,21,Tlaxco,21187,2909,2932,5841
2024,Puebla,21,Tochimilco,21188,9387,10390,19777
2024,Puebla,21,Tochtepec,21189,11160,11994,23154
2024,Puebla,21,Totoltepec de Guerrero,21190,609,741,1350
2024,Puebla,21,Tulcingo,21191,4783,5467,10250
2024,Puebla,21,Tuzamapan de Galeana,21192,3449,3603,7052
2024,Puebla,21,Tzicatlacoyan,21193,3835,3910,7745
2024,Puebla,21,Venustiano Carranza,21194,15622,16714,32336
2024,Puebla,21,Vicente Guerrero,21195,12780,13825,26605
2024,Puebla,21,Xayacatlán de Bravo,21196,792,944,1736
2024,Puebla,21,Xicotepec,21197,42846,45991,88837
2024,Puebla,21,Xicotlán,21198,627,687,1314
2024,Puebla,21,Xiutetelco,21199,21148,22751,43899
2024,Puebla,21,Xochiapulco,21200,1746,1932,3678
2024,Puebla,21,Xochiltepec,21201,1644,1977,3621
2024,Puebla,21,Xochitlán Todos Santos,21203,3364,3719,7083
2024,Puebla,21,Xochitlán de Vicente Suárez,21202,6646,7144,13790
2024,Puebla,21,Yaonáhuac,21204,4168,4581,8749
2024,Puebla,21,Yehualtepec,21205,13298,13962,27260
2024,Puebla,21,Zacapala,21206,2302,2566,4868
2024,Puebla,21,Zacapoaxtla,21207,28805,31710,60515
2024,Puebla,21,Zacatlán,21208,43243,47720,90963
2024,Puebla,21,Zapotitlán,21209,4244,5054,9298
2024,Puebla,21,Zapotitlán de Méndez,21210,3048,3090,6138
2024,Puebla,21,Zaragoza,21211,8207,9615,17822
2024,Puebla,21,Zautla,21212,9707,11032,20739
2024,Puebla,21,Zihuateutla,21213,7053,7449,14502
2024,Puebla,21,Zinacatepec,21214,8966,9786,18752
2024,Puebla,21,Zongozotla,21215,2687,2740,5427
2024,Puebla,21,Zoquiapan,21216,1230,1401,2631
2024,Puebla,21,Zoquitlán,21217,9684,10277,19961
2024,Querétaro,22,Amealco de Bonfil,22001,35004,37081,72085
2024,Querétaro,22,Arroyo Seco,22003,7652,8202,15854
2024,Querétaro,22,Cadereyta de Montes,22004,39259,42524,81783
2024,Querétaro,22,Colón,22005,36924,36145,73069
2024,Querétaro,22,Corregidora,22006,110481,116893,227374
2024,Querétaro,22,El Marqués,22011,98184,96272,194456
2024,Querétaro,22,Ezequiel Montes,22007,23611,25126,48737
2024,Querétaro,22,Huimilpan,22008,21479,23280,44759
2024,Querétaro,22,Jalpan de Serra,22009,15057,16489,31546
2024,Querétaro,22,Landa de Matamoros,22010,10227,11113,21340
2024,Querétaro,22,Pedro Escobedo,22012,40287,40827,81114
2024,Querétaro,22,Peñamiller,22013,11599,11884,23483
2024,Querétaro,22,Pinal de Amoles,22002,14332,15230,29562
2024,Querétaro,22,Querétaro,22014,515978,523258,1039236
2024,Querétaro,22,San Joaquín,22015,5132,5825,10957
2024,Querétaro,22,San Juan del Río,22016,158130,164007,322137
2024,Querétaro,22,Tequisquiapan,22017,41329,42894,84223
2024,Querétaro,22,Tolimán,22018,16385,17015,33400
2024,Quintana Roo,23,Bacalar,23010,24929,24683,49612
2024,Quintana Roo,23,Benito Juárez,23005,460043,454455,914498
2024,Quintana Roo,23,Cozumel,23001,55408,55440,110848
2024,Quintana Roo,23,Felipe Carrillo Puerto,23002,51221,50796,102017
2024,Quintana Roo,23,Isla Mujeres,23003,13525,12436,25961
2024,Quintana Roo,23,José María Morelos,23006,24019,22648,46667
2024,Quintana Roo,23,Lázaro Cárdenas,23007,17610,16810,34420
2024,Quintana Roo,23,Othón P. Blanco,23004,141115,146903,288018
2024,Quintana Roo,23,Solidaridad,23008,136294,123777,260071
2024,Quintana Roo,23,Tulum,23009,21050,18886,39936
2024,San Luis Potosí,24,Ahualulco,24001,9102,10218,19320
2024,San Luis Potosí,24,Alaquines,24002,4401,4536,8937
2024,San Luis Potosí,24,Aquismón,24003,26110,25594,51704
2024,San Luis Potosí,24,Armadillo de los Infante,24004,2171,2247,4418
2024,San Luis Potosí,24,Axtla de Terrazas,24053,19756,20297,40053
2024,San Luis Potosí,24,Catorce,24006,5362,5182,10544
2024,San Luis Potosí,24,Cedral,24007,10067,10554,20621
2024,San Luis Potosí,24,Cerritos,24008,11354,12093,23447
2024,San Luis Potosí,24,Cerro de San Pedro,24009,2489,2423,4912
2024,San Luis Potosí,24,Charcas,24015,10980,11395,22375
2024,San Luis Potosí,24,Ciudad Fernández,24011,23638,24946,48584
2024,San Luis Potosí,24,Ciudad Valles,24013,93260,99871,193131
2024,San Luis Potosí,24,Ciudad del Maíz,24010,18757,18926,37683
2024,San Luis Potosí,24,Coxcatlán,24014,8211,8118,16329
2024,San Luis Potosí,24,Cárdenas,24005,9698,10555,20253
2024,San Luis Potosí,24,Ebano,24016,23072,23956,47028
2024,San Luis Potosí,24,El Naranjo,24058,11985,11841,23826
2024,San Luis Potosí,24,Guadalcázar,24017,14388,14121,28509
2024,San Luis Potosí,24,Huehuetlán,24018,8401,8672,17073
2024,San Luis Potosí,24,Lagunillas,24019,2923,3045,5968
2024,San Luis Potosí,24,Matehuala,24020,52161,55239,107400
2024,San Luis Potosí,24,Matlapa,24057,16200,16394,32594
2024,San Luis Potosí,24,Mexquitic de Carmona,24021,29156,31732,60888
2024,San Luis Potosí,24,Moctezuma,24022,9952,10812,20764
2024,San Luis Potosí,24,Rayón,24023,8215,8645,16860
2024,San Luis Potosí,24,Rioverde,24024,49262,52326,101588
2024,San Luis Potosí,24,Salinas,24025,16365,17637,34002
2024,San Luis Potosí,24,San Antonio,24026,5023,4848,9871
2024,San Luis Potosí,24,San Ciro de Acosta,24027,5378,5749,11127
2024,San Luis Potosí,24,San Luis Potosí,24028,430105,460656,890761
2024,San Luis Potosí,24,San Martín Chalchicuautla,24029,11156,11349,22505
2024,San Luis Potosí,24,San Nicolás Tolentino,24030,2627,2914,5541
2024,San Luis Potosí,24,San Vicente Tancuayalab,24034,7891,7927,15818
2024,San Luis Potosí,24,Santa Catarina,24031,6070,6425,12495
2024,San Luis Potosí,24,Santa María del Río,24032,20283,22272,42555
2024,San Luis Potosí,24,Santo Domingo,24033,6403,6461,12864
2024,San Luis Potosí,24,Soledad de Graciano Sánchez,24035,166743,175097,341840
2024,San Luis Potosí,24,Tamasopo,24036,16393,16074,32467
2024,San Luis Potosí,24,Tamazunchale,24037,50861,51888,102749
2024,San Luis Potosí,24,Tampacán,24038,8287,8164,16451
2024,San Luis Potosí,24,Tampamolón Corona,24039,8125,8327,16452
2024,San Luis Potosí,24,Tamuín,24040,20611,21127,41738
2024,San Luis Potosí,24,Tancanhuitz,24012,10827,11183,22010
2024,San Luis Potosí,24,Tanlajás,24041,10540,10356,20896
2024,San Luis Potosí,24,Tanquián de Escobedo,24042,7966,8356,16322
2024,San Luis Potosí,24,Tierra Nueva,24043,4566,5204,9770
2024,San Luis Potosí,24,Vanegas,24044,4138,4072,8210
2024,San Luis Potosí,24,Venado,24045,7648,7943,15591
2024,San Luis Potosí,24,Villa Hidalgo,24051,7901,8051,15952
2024,San Luis Potosí,24,Villa Juárez,24052,5410,5552,10962
2024,San Luis Potosí,24,Villa de Arista,24056,8109,8199,16308
2024,San Luis Potosí,24,Villa de Arriaga,24046,9491,9652,19143
2024,San Luis Potosí,24,Villa de Guadalupe,24047,5272,5270,10542
2024,San Luis Potosí,24,Villa de Ramos,24049,19271,20328,39599
2024,San Luis Potosí,24,Villa de Reyes,24050,26229,26440,52669
2024,San Luis Potosí,24,Villa de la Paz,24048,2891,2858,5749
2024,San Luis Potosí,24,Xilitla,24054,27039,28089,55128
2024,San Luis Potosí,24,Zaragoza,24055,13687,14068,27755
2024,Sinaloa,25,Ahome,25001,243536,252480,496016
2024,Sinaloa,25,Angostura,25002,26409,26264,52673
2024,Sinaloa,25,Badiraguato,25003,16856,15612,32468
2024,Sinaloa,25,Choix,25007,18060,17103,35163
2024,Sinaloa,25,Concordia,25004,15248,14842,30090
2024,Sinaloa,25,Cosalá,25005,8912,8480,17392
2024,Sinaloa,25,Culiacán,25006,485099,503606,988705
2024,Sinaloa,25,El Fuerte,25010,56509,55327,111836
2024,Sinaloa,25,Elota,25008,31096,28888,59984
2024,Sinaloa,25,Escuinapa,25009,32898,31922,64820
2024,Sinaloa,25,Guasave,25011,161599,164196,325795
2024,Sinaloa,25,Mazatlán,25012,273722,280542,554264
2024,Sinaloa,25,Mocorito,25013,25629,24207,49836
2024,Sinaloa,25,Navolato,25018,83957,80612,164569
2024,Sinaloa,25,Rosario,25014,30059,29051,59110
2024,Sinaloa,25,Salvador Alvarado,25015,43581,45679,89260
2024,Sinaloa,25,San Ignacio,25016,11628,10814,22442
2024,Sinaloa,25,Sinaloa,25017,49523,48212,97735
2024,Sonora,26,Aconchi,26001,1677,1519,3196
2024,Sonora,26,Agua Prieta,26002,45961,45366,91327
2024,Sonora,26,Alamos,26003,15117,14139,29256
2024,Sonora,26,Altar,26004,5360,5378,10738
2024,Sonora,26,Arivechi,26005,690,665,1355
2024,Sonora,26,Arizpe,26006,1587,1505,3092
2024,Sonora,26,Atil,26007,337,321,658
2024,Sonora,26,Bacadéhuachi,26008,672,605,1277
2024,Sonora,26,Bacanora,26009,491,441,932
2024,Sonora,26,Bacerac,26010,838,791,1629
2024,Sonora,26,Bacoachi,26011,920,918,1838
2024,Sonora,26,Banámichi,26013,967,945,1912
2024,Sonora,26,Bavispe,26015,921,825,1746
2024,Sonora,26,Baviácora,26014,1980,1881,3861
2024,Sonora,26,Benito Juárez,26071,12448,12431,24879
2024,Sonora,26,Benjamín Hill,26016,2832,2974,5806
2024,Sonora,26,Bácum,26012,13085,12910,25995
2024,Sonora,26,Caborca,26017,48522,47789,96311
2024,Sonora,26,Cajeme,26018,239742,251352,491094
2024,Sonora,26,Cananea,26019,19576,20055,39631
2024,Sonora,26,Carbó,26020,2852,2624,5476
2024,Sonora,26,Cucurpe,26022,629,508,1137
2024,Sonora,26,Cumpas,26023,3580,3555,7135
2024,Sonora,26,Divisaderos,26024,441,425,866
2024,Sonora,26,Empalme,26025,31512,31811,63323
2024,Sonora,26,Etchojoa,26026,35797,34589,70386
2024,Sonora,26,Fronteras,26027,4923,4767,9690
2024,Sonora,26,General Plutarco Elías Calles,26070,9818,9642,19460
2024,Sonora,26,Granados,26028,626,611,1237
2024,Sonora,26,Guaymas,26029,89359,90682,180041
2024,Sonora,26,Hermosillo,26030,488889,502238,991127
2024,Sonora,26,Huachinera,26031,773,725,1498
2024,Sonora,26,Huatabampo,26033,45367,45317,90684
2024,Sonora,26,Huásabas,26032,555,491,1046
2024,Sonora,26,Huépac,26034,586,564,1150
2024,Sonora,26,Imuris,26035,7250,7179,14429
2024,Sonora,26,La Colorada,26021,1258,1012,2270
2024,Sonora,26,Magdalena,26036,17640,17903,35543
2024,Sonora,26,Mazatán,26037,736,636,1372
2024,Sonora,26,Moctezuma,26038,2797,2878,5675
2024,Sonora,26,Naco,26039,3495,3476,6971
2024,Sonora,26,Nacozari de García,26041,7375,7337,14712
2024,Sonora,26,Navojoa,26042,90517,94571,185088
2024,Sonora,26,Nogales,26043,131363,131984,263347
2024,Sonora,26,Nácori Chico,26040,1205,1101,2306
2024,Sonora,26,Onavas,26044,283,243,526
2024,Sonora,26,Opodepe,26045,1651,1458,3109
2024,Sonora,26,Oquitoa,26046,213,241,454
2024,Sonora,26,Pitiquito,26047,5402,5084,10486
2024,Sonora,26,Puerto Peñasco,26048,38913,37612,76525
2024,Sonora,26,Quiriego,26049,1725,1501,3226
2024,Sonora,26,Rayón,26050,921,838,1759
2024,Sonora,26,Rosario,26051,3005,2755,5760
2024,Sonora,26,Sahuaripa,26052,3306,3098,6404
2024,Sonora,26,San Felipe de Jesús,26053,244,237,481
2024,Sonora,26,San Ignacio Río Muerto,26072,8408,7953,16361
2024,Sonora,26,San Javier,26054,422,319,741
2024,Sonora,26,San Luis Río Colorado,26055,108650,107471,216121
2024,Sonora,26,San Miguel de Horcasitas,26056,5654,4799,10453
2024,Sonora,26,San Pedro de la Cueva,26057,938,814,1752
2024,Sonora,26,Santa Ana,26058,9199,9468,18667
2024,Sonora,26,Santa Cruz,26059,1031,1069,2100
2024,Sonora,26,Soyopa,26061,865,723,1588
2024,Sonora,26,Suaqui Grande,26062,697,584,1281
2024,Sonora,26,Sáric,26060,874,840,1714
2024,Sonora,26,Tepache,26063,889,808,1697
2024,Sonora,26,Trincheras,26064,1019,832,1851
2024,Sonora,26,Tubutama,26065,684,647,1331
2024,Sonora,26,Ures,26066,5165,4939,10104
2024,Sonora,26,Villa Hidalgo,26067,925,853,1778
2024,Sonora,26,Villa Pesqueira,26068,713,599,1312
2024,Sonora,26,Yécora,26069,3304,3264,6568
2024,Tabasco,27,Balancán,27001,33493,33602,67095
2024,Tabasco,27,Centla,27003,61193,61366,122559
2024,Tabasco,27,Centro,27004,376879,394604,771483
2024,Tabasco,27,Comalcalco,27005,111493,115025,226518
2024,Tabasco,27,Cunduacán,27006,76057,78522,154579
2024,Tabasco,27,Cárdenas,27002,140325,145789,286114
2024,Tabasco,27,Emiliano Zapata,27007,16373,17976,34349
2024,Tabasco,27,Huimanguillo,27008,102669,105320,207989
2024,Tabasco,27,Jalapa,27009,21565,21499,43064
2024,Tabasco,27,Jalpa de Méndez,27010,48878,49272,98150
2024,Tabasco,27,Jonuta,27011,17025,16953,33978
2024,Tabasco,27,Macuspana,27012,90112,93844,183956
2024,Tabasco,27,Nacajuca,27013,77065,80217,157282
2024,Tabasco,27,Paraíso,27014,52999,53431,106430
2024,Tabasco,27,Tacotalpa,27015,27120,26931,54051
2024,Tabasco,27,Teapa,27016,31843,33111,64954
2024,Tabasco,27,Tenosique,27017,32056,33957,66013
2024,Tamaulipas,28,Abasolo,28001,6627,6636,13263
2024,Tamaulipas,28,Aldama,28002,16013,15732,31745
2024,Tamaulipas,28,Altamira,28003,132448,133976,266424
2024,Tamaulipas,28,Antiguo Morelos,28004,5456,5437,10893
2024,Tamaulipas,28,Burgos,28005,2564,2369,4933
2024,Tamaulipas,28,Bustamante,28006,4577,4210,8787
2024,Tamaulipas,28,Camargo,28007,8369,8173,16542
2024,Tamaulipas,28,Casas,28008,2380,2151,4531
2024,Tamaulipas,28,Ciudad Madero,28009,110131,121231,231362
2024,Tamaulipas,28,Cruillas,28010,1016,991,2007
2024,Tamaulipas,28,El Mante,28021,63197,67087,130284
2024,Tamaulipas,28,González,28012,23834,24078,47912
2024,Tamaulipas,28,Guerrero,28014,2581,2409,4990
2024,Tamaulipas,28,Gustavo Díaz Ordaz,28015,8734,8555,17289
2024,Tamaulipas,28,Gómez Farías,28011,5159,4915,10074
2024,Tamaulipas,28,Güémez,28013,8891,8230,17121
2024,Tamaulipas,28,Hidalgo,28016,13027,12395,25422
2024,Tamaulipas,28,Jaumave,28017,8623,8328,16951
2024,Tamaulipas,28,Jiménez,28018,4350,4355,8705
2024,Tamaulipas,28,Llera,28019,9462,9118,18580
2024,Tamaulipas,28,Mainero,28020,1433,1391,2824
2024,Tamaulipas,28,Matamoros,28022,274734,284175,558909
2024,Tamaulipas,28,Mier,28024,2115,2205,4320
2024,Tamaulipas,28,Miguel Alemán,28025,14850,15027,29877
2024,Tamaulipas,28,Miquihuana,28026,2073,1899,3972
2024,Tamaulipas,28,Méndez,28023,2130,1935,4065
2024,Tamaulipas,28,Nuevo Laredo,28027,214966,215510,430476
2024,Tamaulipas,28,Nuevo Morelos,28028,2035,1849,3884
2024,Tamaulipas,28,Ocampo,28029,7776,7414,15190
2024,Tamaulipas,28,Padilla,28030,7748,7645,15393
2024,Tamaulipas,28,Palmillas,28031,981,937,1918
2024,Tamaulipas,28,Reynosa,28032,353305,354598,707903
2024,Tamaulipas,28,Río Bravo,28033,68978,68837,137815
2024,Tamaulipas,28,San Carlos,28034,5129,4630,9759
2024,Tamaulipas,28,San Fernando,28035,30315,30106,60421
2024,Tamaulipas,28,San Nicolás,28036,601,528,1129
2024,Tamaulipas,28,Soto la Marina,28037,13903,13268,27171
2024,Tamaulipas,28,Tampico,28038,165380,180538,345918
2024,Tamaulipas,28,Tula,28039,16014,16145,32159
2024,Tamaulipas,28,Valle Hermoso,28040,34211,35382,69593
2024,Tamaulipas,28,Victoria,28041,185318,194171,379489
2024,Tamaulipas,28,Villagrán,28042,3509,3298,6807
2024,Tamaulipas,28,Xicoténcatl,28043,13064,13084,26148
2024,Tlaxcala,29,Acuamanala de Miguel Hidalgo,29022,3726,3701,7427
2024,Tlaxcala,29,Altzayanca,29004,9734,9673,19407
2024,Tlaxcala,29,Amaxac de Guerrero,29001,6237,6417,12654
2024,Tlaxcala,29,Apetatitlán de Antonio Carvajal,29002,8201,8765,16966
2024,Tlaxcala,29,Apizaco,29005,41790,45903,87693
2024,Tlaxcala,29,Atlangatepec,29003,3578,3719,7297
2024,Tlaxcala,29,Benito Juárez,29045,3291,3371,6662
2024,Tlaxcala,29,Calpulalpan,29006,26299,27603,53902
2024,Tlaxcala,29,Chiautempan,29010,39244,42036,81280
2024,Tlaxcala,29,Contla de Juan Cuamatzi,29018,21167,21696,42863
2024,Tlaxcala,29,Cuapiaxtla,29008,8506,8482,16988
2024,Tlaxcala,29,Cuaxomulco,29009,2954,2995,5949
2024,Tlaxcala,29,El Carmen Tequexquitla,29007,9373,9591,18964
2024,Tlaxcala,29,Emiliano Zapata,29046,2452,2556,5008
2024,Tlaxcala,29,Españita,29012,4830,4925,9755
2024,Tlaxcala,29,Huamantla,29013,51101,53050,104151
2024,Tlaxcala,29,Hueyotlipan,29014,7998,8162,16160
2024,Tlaxcala,29,Ixtacuixtla de Mariano Matamoros,29015,21435,22549,43984
2024,Tlaxcala,29,Ixtenco,29016,3908,4216,8124
2024,Tlaxcala,29,La Magdalena Tlaltelulco,29048,9977,10745,20722
2024,Tlaxcala,29,Lázaro Cárdenas,29047,1695,1716,3411
2024,Tlaxcala,29,Mazatecochco de José María Morelos,29017,5988,6073,12061
2024,Tlaxcala,29,Muñoz de Domingo Arenas,29011,2537,2514,5051
2024,Tlaxcala,29,Nanacamilpa de Mariano Arista,29021,9881,10317,20198
2024,Tlaxcala,29,Natívitas,29023,13835,14750,28585
2024,Tlaxcala,29,Panotla,29024,14550,15640,30190
2024,Tlaxcala,29,Papalotla de Xicohténcatl,29041,16441,17518,33959
2024,Tlaxcala,29,San Damián Texóloc,29049,3159,3169,6328
2024,Tlaxcala,29,San Francisco Tetlanohcan,29050,5835,6044,11879
2024,Tlaxcala,29,San Jerónimo Zacualpan,29051,2058,2265,4323
2024,Tlaxcala,29,San José Teacalco,29052,3272,3421,6693
2024,Tlaxcala,29,San Juan Huactzinco,29053,4009,4369,8378
2024,Tlaxcala,29,San Lorenzo Axocomanitla,29054,3042,3257,6299
2024,Tlaxcala,29,San Lucas Tecopilco,29055,1698,1786,3484
2024,Tlaxcala,29,San Pablo del Monte,29025,42675,42717,85392
2024,Tlaxcala,29,Sanctórum de Lázaro Cárdenas,29020,5622,5739,11361
2024,Tlaxcala,29,Santa Ana Nopalucan,29056,4300,4434,8734
2024,Tlaxcala,29,Santa Apolonia Teacalco,29057,2450,2720,5170
2024,Tlaxcala,29,Santa Catarina Ayometla,29058,4804,5164,9968
2024,Tlaxcala,29,Santa Cruz Quilehtla,29059,4021,4007,8028
2024,Tlaxcala,29,Santa Cruz Tlaxcala,29026,11425,11785,23210
2024,Tlaxcala,29,Santa Isabel Xiloxoxtla,29060,2735,2867,5602
2024,Tlaxcala,29,Tenancingo,29027,7211,7426,14637
2024,Tlaxcala,29,Teolocholco,29028,13200,13957,27157
2024,Tlaxcala,29,Tepetitla de Lardizábal,29019,11465,12312,23777
2024,Tlaxcala,29,Tepeyanco,29029,7549,8232,15781
2024,Tlaxcala,29,Terrenate,29030,8676,8556,17232
2024,Tlaxcala,29,Tetla de la Solidaridad,29031,17952,18391,36343
2024,Tlaxcala,29,Tetlatlahuca,29032,7964,8424,16388
2024,Tlaxcala,29,Tlaxcala,29033,51065,56177,107242
2024,Tlaxcala,29,Tlaxco,29034,23273,24108,47381
2024,Tlaxcala,29,Tocatlán,29035,3236,3293,6529
2024,Tlaxcala,29,Totolac,29036,12095,13169,25264
2024,Tlaxcala,29,Tzompantepec,29038,9544,10215,19759
2024,Tlaxcala,29,Xaloztoc,29039,13465,13364,26829
2024,Tlaxcala,29,Xaltocan,29040,5980,6406,12386
2024,Tlaxcala,29,Xicohtzinco,29042,7380,8125,15505
2024,Tlaxcala,29,Yauhquemehcan,29043,21263,22570,43833
2024,Tlaxcala,29,Zacatelco,29044,23930,26041,49971
2024,Tlaxcala,29,Ziltlaltépec de Trinidad Sánchez Santos,29037,4723,5129,9852
2024,Veracruz,30,Acajete,30001,4713,4539,9252
2024,Veracruz,30,Acatlán,30002,1677,1725,3402
2024,Veracruz,30,Acayucan,30003,44483,47980,92463
2024,Veracruz,30,Actopan,30004,23208,24010,47218
2024,Veracruz,30,Acula,30005,2929,2920,5849
2024,Veracruz,30,Acultzingo,30006,11964,12379,24343
2024,Veracruz,30,Agua Dulce,30204,25168,26663,51831
2024,Veracruz,30,Alpatláhuac,30008,5352,5371,10723
2024,Veracruz,30,Alto Lucero de Gutiérrez Barrios,30009,15857,15750,31607
2024,Veracruz,30,Altotonga,30010,33481,35960,69441
2024,Veracruz,30,Alvarado,30011,28647,29463,58110
2024,Veracruz,30,Amatitlán,30012,4262,4467,8729
2024,Veracruz,30,Amatlán de los Reyes,30014,23708,25488,49196
2024,Veracruz,30,Angel R. Cabada,30015,17813,18898,36711
2024,Veracruz,30,Apazapan,30017,2189,2220,4409
2024,Veracruz,30,Aquila,30018,965,1025,1990
2024,Veracruz,30,Astacinga,30019,3173,3605,6778
2024,Veracruz,30,Atlahuilco,30020,5603,5868,11471
2024,Veracruz,30,Atoyac,30021,12429,13128,25557
2024,Veracruz,30,Atzacan,30022,11209,11575,22784
2024,Veracruz,30,Atzalan,30023,26841,27059,53900
2024,Veracruz,30,Ayahualulco,30025,14120,14311,28431
2024,Veracruz,30,Banderilla,30026,11988,13364,25352
2024,Veracruz,30,Benito Juárez,30027,9125,9642,18767
2024,Veracruz,30,Boca del Río,30028,73360,83021,156381
2024,Veracruz,30,Calcahualco,30029,6751,6774,13525
2024,Veracruz,30,Camarón de Tejeda,30007,3501,3485,6986
2024,Veracruz,30,Camerino Z. Mendoza,30030,21425,24193,45618
2024,Veracruz,30,Carlos A. Carrillo,30208,12825,13999,26824
2024,Veracruz,30,Carrillo Puerto,30031,8908,9177,18085
2024,Veracruz,30,Castillo de Teayo,30157,10683,10481,21164
2024,Veracruz,30,Catemaco,30032,25490,27294,52784
2024,Veracruz,30,Cazones de Herrera,30033,12302,13090,25392
2024,Veracruz,30,Cerro Azul,30034,13873,15546,29419
2024,Veracruz,30,Chacaltianguis,30054,6544,6936,13480
2024,Veracruz,30,Chalma,30055,7107,7382,14489
2024,Veracruz,30,Chiconamel,30056,3412,3689,7101
2024,Veracruz,30,Chiconquiaco,30057,7451,7554,15005
2024,Veracruz,30,Chicontepec,30058,29117,30729,59846
2024,Veracruz,30,Chinameca,30059,8524,8928,17452
2024,Veracruz,30,Chinampa de Gorostiza,30060,8863,9112,17975
2024,Veracruz,30,Chocamán,30062,11292,11302,22594
2024,Veracruz,30,Chontla,30063,7664,7792,15456
2024,Veracruz,30,Chumatlán,30064,2013,2140,4153
2024,Veracruz,30,Citlaltépetl,30035,6217,6543,12760
2024,Veracruz,30,Coacoatzintla,30036,5465,5715,11180
2024,Veracruz,30,Coahuitlán,30037,4409,4579,8988
2024,Veracruz,30,Coatepec,30038,48113,51968,100081
2024,Veracruz,30,Coatzacoalcos,30039,167385,178186,345571
2024,Veracruz,30,Coatzintla,30040,30128,31773,61901
2024,Veracruz,30,Coetzala,30041,1195,1229,2424
2024,Veracruz,30,Colipa,30042,2908,3031,5939
2024,Veracruz,30,Comapa,30043,11046,10573,21619
2024,Veracruz,30,Cosamaloapan de Carpio,30045,29511,32238,61749
2024,Veracruz,30,Cosautlán de Carvajal,30046,8628,8735,17363
2024,Veracruz,30,Coscomatepec,30047,30517,31490,62007
2024,Veracruz,30,Cosoleacaque,30048,71418,76363,147781
2024,Veracruz,30,Cotaxtla,30049,11186,11183,22369
2024,Veracruz,30,Coxquihui,30050,8734,9160,17894
2024,Veracruz,30,Coyutla,30051,11454,12360,23814
2024,Veracruz,30,Cuichapa,30052,6232,6851,13083
2024,Veracruz,30,Cuitláhuac,30053,14535,15784,30319
2024,Veracruz,30,Córdoba,30044,109837,123897,233734
2024,Veracruz,30,El Higo,30205,10507,10623,21130
2024,Veracruz,30,Emiliano Zapata,30065,42424,45452,87876
2024,Veracruz,30,Espinal,30066,14203,14934,29137
2024,Veracruz,30,Filomeno Mata,30067,9939,9902,19841
2024,Veracruz,30,Fortín,30068,34277,38109,72386
2024,Veracruz,30,Gutiérrez Zamora,30069,12391,13998,26389
2024,Veracruz,30,Hidalgotitlán,30070,10304,9937,20241
2024,Veracruz,30,Huatusco,30071,31421,33658,65079
2024,Veracruz,30,Huayacocotla,30072,11146,11903,23049
2024,Veracruz,30,Hueyapan de Ocampo,30073,22524,23772,46296
2024,Veracruz,30,Huiloapan de Cuauhtémoc,30074,3759,4039,7798
2024,Veracruz,30,Ignacio de la Llave,30075,8914,9782,18696
2024,Veracruz,30,Ilamatlán,30076,6879,7554,14433
2024,Veracruz,30,Isla,30077,22494,23513,46007
2024,Veracruz,30,Ixcatepec,30078,7236,7243,14479
2024,Veracruz,30,Ixhuacán de los Reyes,30079,6153,6055,12208
2024,Veracruz,30,Ixhuatlancillo,30081,13586,14780,28366
2024,Veracruz,30,Ixhuatlán de Madero,30083,28176,29703,57879
2024,Veracruz,30,Ixhuatlán del Café,30080,12179,12230,24409
2024,Veracruz,30,Ixhuatlán del Sureste,30082,8427,8348,16775
2024,Veracruz,30,Ixmatlahuacan,30084,3054,3120,6174
2024,Veracruz,30,Ixtaczoquitlán,30085,35679,37867,73546
2024,Veracruz,30,Jalacingo,30086,22978,24095,47073
2024,Veracruz,30,Jalcomulco,30088,2768,2740,5508
2024,Veracruz,30,Jamapa,30090,6000,6292,12292
2024,Veracruz,30,Jesús Carranza,30091,15596,15662,31258
2024,Veracruz,30,Jilotepec,30093,8792,9220,18012
2024,Veracruz,30,José Azueta,30169,11951,12379,24330
2024,Veracruz,30,Juan Rodríguez Clara,30094,20809,21284,42093
2024,Veracruz,30,Juchique de Ferrer,30095,8350,8497,16847
2024,Veracruz,30,Jáltipan,30089,21447,23452,44899
2024,Veracruz,30,La Antigua,30016,13972,15036,29008
2024,Veracruz,30,La Perla,30127,14485,15054,29539
2024,Veracruz,30,Landero y Coss,30096,839,884,1723
2024,Veracruz,30,Las Choapas,30061,42716,44234,86950
2024,Veracruz,30,Las Minas,30107,1612,1557,3169
2024,Veracruz,30,Las Vigas de Ramírez,30132,10532,10606,21138
2024,Veracruz,30,Lerdo de Tejada,30097,10003,11484,21487
2024,Veracruz,30,Los Reyes,30137,3130,3175,6305
2024,Veracruz,30,Magdalena,30098,1628,1651,3279
2024,Veracruz,30,Maltrata,30099,9296,9897,19193
2024,Veracruz,30,Manlio Fabio Altamirano,30100,12512,12951,25463
2024,Veracruz,30,Mariano Escobedo,30101,18737,20177,38914
2024,Veracruz,30,Martínez de la Torre,30102,53713,58499,112212
2024,Veracruz,30,Mecatlán,30103,6439,6648,13087
2024,Veracruz,30,Mecayapan,30104,8747,9136,17883
2024,Veracruz,30,Medellín,30105,42061,45551,87612
2024,Veracruz,30,Miahuatlán,30106,2469,2544,5013
2024,Veracruz,30,Minatitlán,30108,81332,86666,167998
2024,Veracruz,30,Misantla,30109,33642,35381,69023
2024,Veracruz,30,Mixtla de Altamirano,30110,6275,6170,12445
2024,Veracruz,30,Moloacán,30111,8996,9502,18498
2024,Veracruz,30,Nanchital de Lázaro Cárdenas del Rio,30206,15481,16377,31858
2024,Veracruz,30,Naolinco,30112,11453,11984,23437
2024,Veracruz,30,Naranjal,30113,2349,2514,4863
2024,Veracruz,30,Naranjos Amatlán,30013,14604,16253,30857
2024,Veracruz,30,Nautla,30114,5836,6050,11886
2024,Veracruz,30,Nogales,30115,19424,21313,40737
2024,Veracruz,30,Oluta,30116,8513,9177,17690
2024,Veracruz,30,Omealca,30117,12427,13264,25691
2024,Veracruz,30,Orizaba,30118,63180,74638,137818
2024,Veracruz,30,Otatitlán,30119,2913,3184,6097
2024,Veracruz,30,Oteapan,30120,8604,8895,17499
2024,Veracruz,30,Ozuluama de Mascareñas,30121,12725,12206,24931
2024,Veracruz,30,Pajapan,30122,9284,9208,18492
2024,Veracruz,30,Papantla,30124,83357,84811,168168
2024,Veracruz,30,Paso de Ovejas,30126,18041,18204,36245
2024,Veracruz,30,Paso del Macho,30125,16823,17187,34010
2024,Veracruz,30,Perote,30128,38931,39327,78258
2024,Veracruz,30,Platón Sánchez,30129,9534,9977,19511
2024,Veracruz,30,Playa Vicente,30130,19145,20749,39894
2024,Veracruz,30,Poza Rica de Hidalgo,30131,106107,117878,223985
2024,Veracruz,30,Pueblo Viejo,30133,30981,31003,61984
2024,Veracruz,30,Puente Nacional,30134,12034,12405,24439
2024,Veracruz,30,Pánuco,30123,53771,54215,107986
2024,Veracruz,30,Rafael Delgado,30135,12304,12734,25038
2024,Veracruz,30,Rafael Lucio,30136,4252,4495,8747
2024,Veracruz,30,Río Blanco,30138,21311,24161,45472
2024,Veracruz,30,Saltabarranca,30139,3246,3471,6717
2024,Veracruz,30,San Andrés Tenejapan,30140,1539,1603,3142
2024,Veracruz,30,San Andrés Tuxtla,30141,84555,91409,175964
2024,Veracruz,30,San Juan Evangelista,30142,17841,18476,36317
2024,Veracruz,30,San Rafael,30211,15681,16310,31991
2024,Veracruz,30,Santiago Sochiapan,30212,7305,7802,15107
2024,Veracruz,30,Santiago Tuxtla,30143,29607,31902,61509
2024,Veracruz,30,Sayula de Alemán,30144,17178,17723,34901
2024,Veracruz,30,Sochiapa,30146,1943,1943,3886
2024,Veracruz,30,Soconusco,30145,8555,8996,17551
2024,Veracruz,30,Soledad Atzompa,30147,12240,12358,24598
2024,Veracruz,30,Soledad de Doblado,30148,14661,14974,29635
2024,Veracruz,30,Soteapan,30149,17966,18565,36531
2024,Veracruz,30,Tamalín,30150,6234,6206,12440
2024,Veracruz,30,Tamiahua,30151,12517,12486,25003
2024,Veracruz,30,Tampico Alto,30152,6947,6507,13454
2024,Veracruz,30,Tancoco,30153,2997,3194,6191
2024,Veracruz,30,Tantima,30154,7080,6856,13936
2024,Veracruz,30,Tantoyuca,30155,54453,55984,110437
2024,Veracruz,30,Tatahuicapan de Juárez,30209,8178,8488,16666
2024,Veracruz,30,Tatatila,30156,3279,3012,6291
2024,Veracruz,30,Tecolutla,30158,12626,13025,25651
2024,Veracruz,30,Tehuipango,30159,13428,14250,27678
2024,Veracruz,30,Tempoal,30161,18744,19402,38146
2024,Veracruz,30,Tenampa,30162,3548,3678,7226
2024,Veracruz,30,Tenochtitlán,30163,2663,2838,5501
2024,Veracruz,30,Teocelo,30164,8661,9192,17853
2024,Veracruz,30,Tepatlaxco,30165,4626,4380,9006
2024,Veracruz,30,Tepetlán,30166,5254,5094,10348
2024,Veracruz,30,Tepetzintla,30167,7748,7974,15722
2024,Veracruz,30,Tequila,30168,7967,8238,16205
2024,Veracruz,30,Texcatepec,30170,5694,5977,11671
2024,Veracruz,30,Texhuacán,30171,2693,3002,5695
2024,Veracruz,30,Texistepec,30172,11152,11089,22241
2024,Veracruz,30,Tezonapa,30173,30115,30805,60920
2024,Veracruz,30,Tierra Blanca,30174,55023,59193,114216
2024,Veracruz,30,Tihuatlán,30175,50653,52712,103365
2024,Veracruz,30,Tlachichilco,30180,6077,6288,12365
2024,Veracruz,30,Tlacojalpan,30176,2601,2712,5313
2024,Veracruz,30,Tlacolulan,30177,6111,5904,12015
2024,Veracruz,30,Tlacotalpan,30178,6877,7516,14393
2024,Veracruz,30,Tlacotepec de Mejía,30179,2095,2135,4230
2024,Veracruz,30,Tlalixcoyan,30181,20141,20816,40957
2024,Veracruz,30,Tlalnelhuayocan,30182,9938,10267,20205
2024,Veracruz,30,Tlaltetela,30024,8460,8215,16675
2024,Veracruz,30,Tlapacoyan,30183,32194,34074,66268
2024,Veracruz,30,Tlaquilpa,30184,3795,4343,8138
2024,Veracruz,30,Tlilapan,30185,2765,2910,5675
2024,Veracruz,30,Tomatlán,30186,3680,3785,7465
2024,Veracruz,30,Tonayán,30187,2922,3121,6043
2024,Veracruz,30,Totutla,30188,9299,9371,18670
2024,Veracruz,30,Tres Valles,30207,24130,25426,49556
2024,Veracruz,30,Tuxpan,30189,85011,89491,174502
2024,Veracruz,30,Tuxtilla,30190,1195,1231,2426
2024,Veracruz,30,Ursulo Galván,30191,16242,17179,33421
2024,Veracruz,30,Uxpanapa,30210,15709,15239,30948
2024,Veracruz,30,Vega de Alatorre,30192,10540,11261,21801
2024,Veracruz,30,Veracruz,30193,307214,333940,641154
2024,Veracruz,30,Villa Aldama,30194,6236,6392,12628
2024,Veracruz,30,Xalapa,30087,246020,276930,522950
2024,Veracruz,30,Xico,30092,20354,20921,41275
2024,Veracruz,30,Xoxocotla,30195,2944,2822,5766
2024,Veracruz,30,Yanga,30196,9163,10329,19492
2024,Veracruz,30,Yecuatla,30197,6322,6528,12850
2024,Veracruz,30,Zacualpan,30198,3715,4000,7715
2024,Veracruz,30,Zaragoza,30199,5880,6126,12006
2024,Veracruz,30,Zentla,30200,7254,7119,14373
2024,Veracruz,30,Zongolica,30201,22948,23458,46406
2024,Veracruz,30,Zontecomatlán de López y Fuentes,30202,7620,7841,15461
2024,Veracruz,30,Zozocolco de Hidalgo,30203,7898,8246,16144
2024,Veracruz,30,Álamo Temapache,30160,55740,56431,112171
2024,Yucatán,31,Abalá,31001,3729,3570,7299
2024,Yucatán,31,Acanceh,31002,9053,9041,18094
2024,Yucatán,31,Akil,31003,6013,6256,12269
2024,Yucatán,31,Baca,31004,3326,3409,6735
2024,Yucatán,31,Bokobá,31005,1254,1207,2461
2024,Yucatán,31,Buctzotz,31006,4980,4962,9942
2024,Yucatán,31,Cacalchén,31007,4168,3954,8122
2024,Yucatán,31,Calotmul,31008,2257,2255,4512
2024,Yucatán,31,Cansahcab,31009,2580,2631,5211
2024,Yucatán,31,Cantamayec,31010,1451,1333,2784
2024,Yucatán,31,Celestún,31011,4412,4184,8596
2024,Yucatán,31,Cenotillo,31012,2138,2280,4418
2024,Yucatán,31,Chacsinkín,31016,1669,1640,3309
2024,Yucatán,31,Chankom,31017,2578,2493,5071
2024,Yucatán,31,Chapab,31018,1768,1765,3533
2024,Yucatán,31,Chemax,31019,20311,19991,40302
2024,Yucatán,31,Chichimilá,31021,4670,4602,9272
2024,Yucatán,31,Chicxulub Pueblo,31020,2578,2452,5030
2024,Yucatán,31,Chikindzonot,31022,2306,2244,4550
2024,Yucatán,31,Chocholá,31023,2688,2599,5287
2024,Yucatán,31,Chumayel,31024,1785,1848,3633
2024,Yucatán,31,Conkal,31013,6291,6281,12572
2024,Yucatán,31,Cuncunul,31014,910,881,1791
2024,Yucatán,31,Cuzamá,31015,2913,2830,5743
2024,Yucatán,31,Dzemul,31026,2100,2095,4195
2024,Yucatán,31,Dzidzantún,31027,4667,4570,9237
2024,Yucatán,31,Dzilam González,31029,3488,3312,6800
2024,Yucatán,31,Dzilam de Bravo,31028,1555,1467,3022
2024,Yucatán,31,Dzitás,31030,2160,2062,4222
2024,Yucatán,31,Dzoncauich,31031,1453,1487,2940
2024,Yucatán,31,Dzán,31025,2895,3026,5921
2024,Yucatán,31,Espita,31032,9111,8846,17957
2024,Yucatán,31,Halachó,31033,11379,11131,22510
2024,Yucatán,31,Hocabá,31034,3439,3438,6877
2024,Yucatán,31,Hoctún,31035,3275,3343,6618
2024,Yucatán,31,Homún,31036,4363,4199,8562
2024,Yucatán,31,Huhí,31037,2969,2864,5833
2024,Yucatán,31,Hunucmá,31038,18056,18153,36209
2024,Yucatán,31,Ixil,31039,2328,2242,4570
2024,Yucatán,31,Izamal,31040,14917,15213,30130
2024,Yucatán,31,Kanasín,31041,57503,58325,115828
2024,Yucatán,31,Kantunil,31042,2924,3075,5999
2024,Yucatán,31,Kaua,31043,1752,1685,3437
2024,Yucatán,31,Kinchil,31044,4041,3947,7988
2024,Yucatán,31,Kopomá,31045,1469,1386,2855
2024,Yucatán,31,Mama,31046,1676,1845,3521
2024,Yucatán,31,Maní,31047,3063,3192,6255
2024,Yucatán,31,Maxcanú,31048,12724,12544,25268
2024,Yucatán,31,Mayapán,31049,2103,1946,4049
2024,Yucatán,31,Mocochá,31051,1864,1820,3684
2024,Yucatán,31,Motul,31052,20250,20596,40846
2024,Yucatán,31,Muna,31053,6907,7180,14087
2024,Yucatán,31,Muxupip,31054,1571,1640,3211
2024,Yucatán,31,Mérida,31050,484434,523011,1007445
2024,Yucatán,31,Opichén,31055,3841,3712,7553
2024,Yucatán,31,Oxkutzcab,31056,16475,17960,34435
2024,Yucatán,31,Panabá,31057,4256,4290,8546
2024,Yucatán,31,Peto,31058,13863,14071,27934
2024,Yucatán,31,Progreso,31059,32668,33050,65718
2024,Yucatán,31,Quintana Roo,31060,536,534,1070
2024,Yucatán,31,Río Lagartos,31061,2032,1931,3963
2024,Yucatán,31,Sacalum,31062,2747,2613,5360
2024,Yucatán,31,Samahil,31063,2884,2866,5750
2024,Yucatán,31,San Felipe,31065,1104,1043,2147
2024,Yucatán,31,Sanahcat,31064,963,955,1918
2024,Yucatán,31,Santa Elena,31066,2156,2260,4416
2024,Yucatán,31,Seyé,31067,5471,5238,10709
2024,Yucatán,31,Sinanché,31068,1842,1699,3541
2024,Yucatán,31,Sotuta,31069,5027,4851,9878
2024,Yucatán,31,Sucilá,31070,2215,2142,4357
2024,Yucatán,31,Sudzal,31071,999,896,1895
2024,Yucatán,31,Suma,31072,1048,1018,2066
2024,Yucatán,31,Tahdziú,31073,2878,2706,5584
2024,Yucatán,31,Tahmek,31074,2131,2065,4196
2024,Yucatán,31,Teabo,31075,3642,3673,7315
2024,Yucatán,31,Tecoh,31076,9819,9751,19570
2024,Yucatán,31,Tekal de Venegas,31077,1504,1461,2965
2024,Yucatán,31,Tekantó,31078,2106,2116,4222
2024,Yucatán,31,Tekax,31079,23158,23953,47111
2024,Yucatán,31,Tekit,31080,5755,5593,11348
2024,Yucatán,31,Tekom,31081,1770,1796,3566
2024,Yucatán,31,Telchac Pueblo,31082,2149,2133,4282
2024,Yucatán,31,Telchac Puerto,31083,1037,943,1980
2024,Yucatán,31,Temax,31084,4065,4048,8113
2024,Yucatán,31,Temozón,31085,8699,8456,17155
2024,Yucatán,31,Tepakán,31086,1280,1225,2505
2024,Yucatán,31,Tetiz,31087,2802,2814,5616
2024,Yucatán,31,Teya,31088,1083,1100,2183
2024,Yucatán,31,Ticul,31089,21967,22619,44586
2024,Yucatán,31,Timucuy,31090,4176,4009,8185
2024,Yucatán,31,Tinum,31091,6737,6509,13246
2024,Yucatán,31,Tixcacalcupul,31092,3969,3919,7888
2024,Yucatán,31,Tixkokob,31093,10004,10196,20200
2024,Yucatán,31,Tixmehuac,31094,2702,2693,5395
2024,Yucatán,31,Tixpéhual,31095,3036,3148,6184
2024,Yucatán,31,Tizimín,31096,42333,43529,85862
2024,Yucatán,31,Tunkás,31097,1998,1914,3912
2024,Yucatán,31,Tzucacab,31098,8192,8041,16233
2024,Yucatán,31,Uayma,31099,2335,2240,4575
2024,Yucatán,31,Ucú,31100,2084,2057,4141
2024,Yucatán,31,Umán,31101,29852,29836,59688
2024,Yucatán,31,Valladolid,31102,44332,45106,89438
2024,Yucatán,31,Xocchel,31103,1985,1910,3895
2024,Yucatán,31,Yaxcabá,31104,8697,8191,16888
2024,Yucatán,31,Yaxkukul,31105,1762,1782,3544
2024,Yucatán,31,Yobaín,31106,1301,1252,2553
2024,Zacatecas,32,Apozol,32001,3127,3344,6471
2024,Zacatecas,32,Apulco,32002,2464,2727,5191
2024,Zacatecas,32,Atolinga,32003,1311,1394,2705
2024,Zacatecas,32,Benito Juárez,32004,2230,2161,4391
2024,Zacatecas,32,Calera,32005,24215,24185,48400
2024,Zacatecas,32,Cañitas de Felipe Pescador,32006,4376,4483,8859
2024,Zacatecas,32,Chalchihuites,32009,5969,6283,12252
2024,Zacatecas,32,Concepción del Oro,32007,7260,7140,14400
2024,Zacatecas,32,Cuauhtémoc,32008,6570,6930,13500
2024,Zacatecas,32,El Plateado de Joaquín Amaro,32015,688,704,1392
2024,Zacatecas,32,El Salvador,32041,1284,1249,2533
2024,Zacatecas,32,Fresnillo,32010,122849,126209,249058
2024,Zacatecas,32,Genaro Codina,32012,4261,4473,8734
2024,Zacatecas,32,General Enrique Estrada,32013,3342,3411,6753
2024,Zacatecas,32,General Francisco R. Murguía,32014,11300,11997,23297
2024,Zacatecas,32,General Pánfilo Natera,32016,12149,12613,24762
2024,Zacatecas,32,Guadalupe,32017,101061,105949,207010
2024,Zacatecas,32,Huanusco,32018,2140,2229,4369
2024,Zacatecas,32,Jalpa,32019,12734,13303,26037
2024,Zacatecas,32,Jerez,32020,31593,33528,65121
2024,Zacatecas,32,Jiménez del Teul,32021,2210,2252,4462
2024,Zacatecas,32,Juan Aldama,32022,11360,12030,23390
2024,Zacatecas,32,Juchipila,32023,6528,7262,13790
2024,Zacatecas,32,Loreto,32024,28855,29288,58143
2024,Zacatecas,32,Luis Moya,32025,7158,7219,14377
2024,Zacatecas,32,Mazapil,32026,9968,9085,19053
2024,Zacatecas,32,Melchor Ocampo,32027,1734,1520,3254
2024,Zacatecas,32,Mezquital del Oro,32028,1277,1392,2669
2024,Zacatecas,32,Miguel Auza,32029,12458,12951,25409
2024,Zacatecas,32,Momax,32030,1249,1345,2594
2024,Zacatecas,32,Monte Escobedo,32031,4973,5078,10051
2024,Zacatecas,32,Morelos,32032,6704,6758,13462
2024,Zacatecas,32,Moyahua de Estrada,32033,2011,2281,4292
2024,Zacatecas,32,Nochistlán de Mejía,32034,14381,15803,30184
2024,Zacatecas,32,Noria de Ángeles,32035,8937,9211,18148
2024,Zacatecas,32,Ojocaliente,32036,22609,23581,46190
2024,Zacatecas,32,Pinos,32038,38375,40122,78497
2024,Zacatecas,32,Pánuco,32037,9651,9617,19268
2024,Zacatecas,32,Río Grande,32039,33532,35572,69104
2024,Zacatecas,32,Sain Alto,32040,11621,12234,23855
2024,Zacatecas,32,Santa María de la Paz,32058,1436,1463,2899
2024,Zacatecas,32,Sombrerete,32042,32863,33845,66708
2024,Zacatecas,32,Susticacán,32043,709,776,1485
2024,Zacatecas,32,Tabasco,32044,8136,8558,16694
2024,Zacatecas,32,Tepechitlán,32045,4527,4935,9462
2024,Zacatecas,32,Tepetongo,32046,3776,4009,7785
2024,Zacatecas,32,Teúl de González Ortega,32047,2526,2665,5191
2024,Zacatecas,32,Tlaltenango de Sánchez Román,32048,14176,14792,28968
2024,Zacatecas,32,Trancoso,32057,10289,10519,20808
2024,Zacatecas,32,Trinidad García de la Cadena,32011,1517,1574,3091
2024,Zacatecas,32,Valparaíso,32049,17641,18169,35810
2024,Zacatecas,32,Vetagrande,32050,5345,5481,10826
2024,Zacatecas,32,Villa García,32052,10240,10407,20647
2024,Zacatecas,32,Villa González Ortega,32053,6953,7345,14298
2024,Zacatecas,32,Villa Hidalgo,32054,10219,10352,20571
2024,Zacatecas,32,Villa de Cos,32051,19111,18850,37961
2024,Zacatecas,32,Villanueva,32055,16019,16678,32697
2024,Zacatecas,32,Zacatecas,32056,77197,81876,159073
2025,Aguascalientes,01,Aguascalientes,01001,501477,521895,1023372
2025,Aguascalientes,01,Asientos,01002,26692,26883,53575
2025,Aguascalientes,01,Calvillo,01003,31663,32862,64525
2025,Aguascalientes,01,Cosío,01004,8748,9026,17774
2025,Aguascalientes,01,El Llano,01010,11742,11431,23173
2025,Aguascalientes,01,Jesús María,01005,69879,68976,138855
2025,Aguascalientes,01,Pabellón de Arteaga,01006,25746,26913,52659
2025,Aguascalientes,01,Rincón de Romos,01007,30385,30675,61060
2025,Aguascalientes,01,San Francisco de los Romo,01011,27616,27645,55261
2025,Aguascalientes,01,San José de Gracia,01008,4982,5258,10240
2025,Aguascalientes,01,Tepezalá,01009,11924,12226,24150
2025,Baja California,02,Ensenada,02001,287743,289008,576751
2025,Baja California,02,Mexicali,02002,585570,590536,1176106
2025,Baja California,02,Playas de Rosarito,02005,58144,57949,116093
2025,Baja California,02,Tecate,02003,62549,59386,121935
2025,Baja California,02,Tijuana,02004,950629,959169,1909798
2025,Baja California Sur,03,Comondú,03001,46566,45380,91946
2025,Baja California Sur,03,La Paz,03003,164221,166443,330664
2025,Baja California Sur,03,Loreto,03009,12574,11554,24128
2025,Baja California Sur,03,Los Cabos,03008,187236,176851,364087
2025,Baja California Sur,03,Mulegé,03002,37817,35308,73125
2025,Campeche,04,Calakmul,04010,17244,16551,33795
2025,Campeche,04,Calkiní,04001,33546,34716,68262
2025,Campeche,04,Campeche,04002,165550,178165,343715
2025,Campeche,04,Candelaria,04011,26615,25785,52400
2025,Campeche,04,Carmen,04003,148158,149151,297309
2025,Campeche,04,Champotón,04004,54568,53975,108543
2025,Campeche,04,Escárcega,04009,33761,34340,68101
2025,Campeche,04,Hecelchakán,04005,18618,18711,37329
2025,Campeche,04,Hopelchén,04006,24444,23323,47767
2025,Campeche,04,Palizada,04007,5365,5248,10613
2025,Campeche,04,Tenabo,04008,6593,6267,12860
2025,Chiapas,07,Acacoyagua,07001,10677,10590,21267
2025,Chiapas,07,Acala,07002,18337,18719,37056
2025,Chiapas,07,Acapetahua,07003,16694,16656,33350
2025,Chiapas,07,Aldama,07113,3676,3987,7663
2025,Chiapas,07,Altamirano,07004,19326,19118,38444
2025,Chiapas,07,Amatenango de la Frontera,07006,17632,18628,36260
2025,Chiapas,07,Amatenango del Valle,07007,5500,5971,11471
2025,Chiapas,07,Amatán,07005,11557,11242,22799
2025,Chiapas,07,Angel Albino Corzo,07008,16289,16432,32721
2025,Chiapas,07,Arriaga,07009,22812,24513,47325
2025,Chiapas,07,Bejucal de Ocampo,07010,4448,4416,8864
2025,Chiapas,07,Bella Vista,07011,11714,11841,23555
2025,Chiapas,07,Benemérito de las Américas,07114,11798,11544,23342
2025,Chiapas,07,Berriozábal,07012,30762,31078,61840
2025,Chiapas,07,Bochil,07013,20094,20532,40626
2025,Chiapas,07,Cacahoatán,07015,26295,27662,53957
2025,Chiapas,07,Catazajá,07016,10254,10139,20393
2025,Chiapas,07,Chalchihuitán,07022,9428,9608,19036
2025,Chiapas,07,Chamula,07023,47003,55146,102149
2025,Chiapas,07,Chanal,07024,7131,7169,14300
2025,Chiapas,07,Chapultenango,07025,4361,4347,8708
2025,Chiapas,07,Chenalhó,07026,23060,23566,46626
2025,Chiapas,07,Chiapa de Corzo,07027,58956,61306,120262
2025,Chiapas,07,Chiapilla,07028,3492,3373,6865
2025,Chiapas,07,Chicoasén,07029,2943,2964,5907
2025,Chiapas,07,Chicomuselo,07030,20438,20689,41127
2025,Chiapas,07,Chilón,07031,74126,75910,150036
2025,Chiapas,07,Cintalapa,07017,49927,50626,100553
2025,Chiapas,07,Coapilla,07018,5270,5424,10694
2025,Chiapas,07,Comitán de Domínguez,07019,87165,95879,183044
2025,Chiapas,07,Copainalá,07021,12468,13081,25549
2025,Chiapas,07,El Bosque,07014,12709,13590,26299
2025,Chiapas,07,El Porvenir,07070,8220,8299,16519
2025,Chiapas,07,Escuintla,07032,18240,18773,37013
2025,Chiapas,07,Francisco León,07033,4465,4319,8784
2025,Chiapas,07,Frontera Comalapa,07034,42301,44648,86949
2025,Chiapas,07,Frontera Hidalgo,07035,8290,8736,17026
2025,Chiapas,07,Huehuetán,07037,19875,20982,40857
2025,Chiapas,07,Huitiupán,07039,13357,13185,26542
2025,Chiapas,07,Huixtla,07040,30526,32864,63390
2025,Chiapas,07,Huixtán,07038,13504,13991,27495
2025,Chiapas,07,Ixhuatán,07042,6513,6679,13192
2025,Chiapas,07,Ixtacomitán,07043,6193,6303,12496
2025,Chiapas,07,Ixtapa,07044,15762,15974,31736
2025,Chiapas,07,Ixtapangajoya,07045,3229,3144,6373
2025,Chiapas,07,Jiquipilas,07046,22901,23777,46678
2025,Chiapas,07,Jitotol,07047,12225,11922,24147
2025,Chiapas,07,Juárez,07048,12435,12797,25232
2025,Chiapas,07,La Concordia,07020,27070,26731,53801
2025,Chiapas,07,La Grandeza,07036,4107,4220,8327
2025,Chiapas,07,La Independencia,07041,26100,27047,53147
2025,Chiapas,07,La Libertad,07050,2827,2931,5758
2025,Chiapas,07,La Trinitaria,07099,45129,47235,92364
2025,Chiapas,07,Larráinzar,07049,13546,14037,27583
2025,Chiapas,07,Las Margaritas,07052,71758,73064,144822
2025,Chiapas,07,Las Rosas,07075,16225,16625,32850
2025,Chiapas,07,Mapastepec,07051,27440,28384,55824
2025,Chiapas,07,Maravilla Tenejapa,07115,7459,7224,14683
2025,Chiapas,07,Marqués de Comillas,07116,6728,6533,13261
2025,Chiapas,07,Mazapa de Madero,07053,4504,4679,9183
2025,Chiapas,07,Mazatán,07054,16875,17460,34335
2025,Chiapas,07,Metapa,07055,3189,3456,6645
2025,Chiapas,07,Mitontic,07056,7008,7071,14079
2025,Chiapas,07,Montecristo de Guerrero,07117,4454,4356,8810
2025,Chiapas,07,Motozintla,07057,41773,43416,85189
2025,Chiapas,07,Nicolás Ruíz,07058,2558,2415,4973
2025,Chiapas,07,Ocosingo,07059,127067,128061,255128
2025,Chiapas,07,Ocotepec,07060,7105,7433,14538
2025,Chiapas,07,Ocozocoautla de Espinosa,07061,52848,54343,107191
2025,Chiapas,07,Ostuacán,07062,10741,10609,21350
2025,Chiapas,07,Osumacinta,07063,2167,2174,4341
2025,Chiapas,07,Oxchuc,07064,27542,27308,54850
2025,Chiapas,07,Palenque,07065,68897,71066,139963
2025,Chiapas,07,Pantelhó,07066,12603,12815,25418
2025,Chiapas,07,Pantepec,07067,7095,7216,14311
2025,Chiapas,07,Pichucalco,07068,18097,18568,36665
2025,Chiapas,07,Pijijiapan,07069,30794,31690,62484
2025,Chiapas,07,Pueblo Nuevo Solistahuacán,07072,17688,19268,36956
2025,Chiapas,07,Rayón,07073,5564,5677,11241
2025,Chiapas,07,Reforma,07074,26412,26874,53286
2025,Chiapas,07,Sabanilla,07076,15628,15456,31084
2025,Chiapas,07,Salto de Agua,07077,36438,36859,73297
2025,Chiapas,07,San Andrés Duraznal,07118,3100,3269,6369
2025,Chiapas,07,San Cristóbal de las Casas,07078,117089,130189,247278
2025,Chiapas,07,San Fernando,07079,23429,22980,46409
2025,Chiapas,07,San Juan Cancuc,07112,19928,20821,40749
2025,Chiapas,07,San Lucas,07110,4189,4213,8402
2025,Chiapas,07,Santiago el Pinar,07119,2114,2067,4181
2025,Chiapas,07,Siltepec,07080,21081,20415,41496
2025,Chiapas,07,Simojovel,07081,25467,25917,51384
2025,Chiapas,07,Sitalá,07082,8293,8386,16679
2025,Chiapas,07,Socoltenango,07083,10686,10757,21443
2025,Chiapas,07,Solosuchiapa,07084,4649,4604,9253
2025,Chiapas,07,Soyaló,07085,6300,6254,12554
2025,Chiapas,07,Suchiapa,07086,14265,14285,28550
2025,Chiapas,07,Suchiate,07087,22031,23024,45055
2025,Chiapas,07,Sunuapa,07088,1410,1379,2789
2025,Chiapas,07,Tapachula,07089,197350,216009,413359
2025,Chiapas,07,Tapalapa,07090,2242,2360,4602
2025,Chiapas,07,Tapilula,07091,7424,7829,15253
2025,Chiapas,07,Tecpatán,07092,24002,24358,48360
2025,Chiapas,07,Tenejapa,07093,24520,25913,50433
2025,Chiapas,07,Teopisca,07094,24509,25947,50456
2025,Chiapas,07,Tila,07096,45764,45681,91445
2025,Chiapas,07,Tonalá,07097,51619,53158,104777
2025,Chiapas,07,Totolapa,07098,4234,4190,8424
2025,Chiapas,07,Tumbalá,07100,19408,20392,39800
2025,Chiapas,07,Tuxtla Chico,07102,24076,25628,49704
2025,Chiapas,07,Tuxtla Gutiérrez,07101,335942,371881,707823
2025,Chiapas,07,Tuzantán,07103,18656,19208,37864
2025,Chiapas,07,Tzimol,07104,8849,9283,18132
2025,Chiapas,07,Unión Juárez,07105,8807,9303,18110
2025,Chiapas,07,Venustiano Carranza,07106,37556,37984,75540
2025,Chiapas,07,Villa Comaltitlán,07071,16591,16991,33582
2025,Chiapas,07,Villa Corzo,07107,44816,46496,91312
2025,Chiapas,07,Villaflores,07108,60465,63322,123787
2025,Chiapas,07,Yajalón,07109,21758,22801,44559
2025,Chiapas,07,Zinacantán,07111,22320,25465,47785
2025,Chihuahua,08,Ahumada,08001,6829,6694,13523
2025,Chihuahua,08,Aldama,08002,13788,13933,27721
2025,Chihuahua,08,Allende,08003,5145,5027,10172
2025,Chihuahua,08,Aquiles Serdán,08004,10459,9999,20458
2025,Chihuahua,08,Ascensión,08005,13825,13524,27349
2025,Chihuahua,08,Bachíniva,08006,3734,3590,7324
2025,Chihuahua,08,Balleza,08007,9331,9061,18392
2025,Chihuahua,08,Batopilas,08008,6480,6516,12996
2025,Chihuahua,08,Bocoyna,08009,14954,15633,30587
2025,Chihuahua,08,Buenaventura,08010,13245,12969,26214
2025,Chihuahua,08,Camargo,08011,28681,29796,58477
2025,Chihuahua,08,Carichí,08012,5471,5363,10834
2025,Chihuahua,08,Casas Grandes,08013,6670,6366,13036
2025,Chihuahua,08,Chihuahua,08019,485826,513666,999492
2025,Chihuahua,08,Chínipas,08020,4666,4226,8892
2025,Chihuahua,08,Coronado,08014,1336,1230,2566
2025,Chihuahua,08,Coyame del Sotol,08015,1093,894,1987
2025,Chihuahua,08,Cuauhtémoc,08017,93119,99275,192394
2025,Chihuahua,08,Cusihuiriachi,08018,2814,2602,5416
2025,Chihuahua,08,Delicias,08021,82665,86989,169654
2025,Chihuahua,08,Dr. Belisario Domínguez,08022,1577,1529,3106
2025,Chihuahua,08,El Tule,08064,999,965,1964
2025,Chihuahua,08,Galeana,08023,3725,3718,7443
2025,Chihuahua,08,Gran Morelos,08026,1545,1485,3030
2025,Chihuahua,08,Guachochi,08027,25013,26284,51297
2025,Chihuahua,08,Guadalupe,08028,2392,2454,4846
2025,Chihuahua,08,Guadalupe y Calvo,08029,30366,29766,60132
2025,Chihuahua,08,Guazapares,08030,4609,4396,9005
2025,Chihuahua,08,Guerrero,08031,22663,22315,44978
2025,Chihuahua,08,Gómez Farías,08025,5200,5164,10364
2025,Chihuahua,08,Hidalgo del Parral,08032,59630,63618,123248
2025,Chihuahua,08,Huejotitán,08033,586,585,1171
2025,Chihuahua,08,Ignacio Zaragoza,08034,4072,3996,8068
2025,Chihuahua,08,Janos,08035,6548,5985,12533
2025,Chihuahua,08,Jiménez,08036,23774,24209,47983
2025,Chihuahua,08,Julimes,08038,2656,2568,5224
2025,Chihuahua,08,Juárez,08037,750846,754050,1504896
2025,Chihuahua,08,La Cruz,08016,2316,2194,4510
2025,Chihuahua,08,López,08039,2416,2243,4659
2025,Chihuahua,08,Madera,08040,16242,16066,32308
2025,Chihuahua,08,Maguarichi,08041,895,845,1740
2025,Chihuahua,08,Manuel Benavides,08042,926,783,1709
2025,Chihuahua,08,Matachí,08043,1798,1776,3574
2025,Chihuahua,08,Matamoros,08044,2656,2552,5208
2025,Chihuahua,08,Meoqui,08045,25076,25621,50697
2025,Chihuahua,08,Morelos,08046,4237,4156,8393
2025,Chihuahua,08,Moris,08047,2973,2794,5767
2025,Chihuahua,08,Namiquipa,08048,14287,13609,27896
2025,Chihuahua,08,Nonoava,08049,1544,1461,3005
2025,Chihuahua,08,Nuevo Casas Grandes,08050,34636,36222,70858
2025,Chihuahua,08,Ocampo,08051,4347,4033,8380
2025,Chihuahua,08,Ojinaga,08052,16118,15924,32042
2025,Chihuahua,08,Praxedis G. Guerrero,08053,2550,2510,5060
2025,Chihuahua,08,Riva Palacio,08054,4402,4234,8636
2025,Chihuahua,08,Rosales,08055,9790,9627,19417
2025,Chihuahua,08,Rosario,08056,1210,1146,2356
2025,Chihuahua,08,San Francisco de Borja,08057,1395,1309,2704
2025,Chihuahua,08,San Francisco de Conchos,08058,1559,1457,3016
2025,Chihuahua,08,San Francisco del Oro,08059,3050,3035,6085
2025,Chihuahua,08,Santa Bárbara,08060,6194,6299,12493
2025,Chihuahua,08,Santa Isabel,08024,2277,2331,4608
2025,Chihuahua,08,Satevó,08061,1868,1761,3629
2025,Chihuahua,08,Saucillo,08062,18186,17982,36168
2025,Chihuahua,08,Temósachic,08063,3883,3710,7593
2025,Chihuahua,08,Urique,08065,11798,11430,23228
2025,Chihuahua,08,Uruachi,08066,3372,3207,6579
2025,Chihuahua,08,Valle de Zaragoza,08067,3168,3025,6193
2025,Ciudad de México,09,Azcapotzalco,09002,190142,215354,405496
2025,Ciudad de México,09,Benito Juárez,09014,204344,240190,444534
2025,Ciudad de México,09,Coyoacán,09003,289374,328503,617877
2025,Ciudad de México,09,Cuajimalpa de Morelos,09004,94875,102132,197007
2025,Ciudad de México,09,Cuauhtémoc,09015,260981,289729,550710
2025,Ciudad de México,09,Gustavo A. Madero,09005,557852,606298,1164150
2025,Ciudad de México,09,Iztacalco,09006,185366,206555,391921
2025,Ciudad de México,09,Iztapalapa,09007,858166,912192,1770358
2025,Ciudad de México,09,La Magdalena Contreras,09008,116235,125449,241684
2025,Ciudad de México,09,Miguel Hidalgo,09016,176719,205854,382573
2025,Ciudad de México,09,Milpa Alta,09009,66953,69926,136879
2025,Ciudad de México,09,Tlalpan,09012,322877,352346,675223
2025,Ciudad de México,09,Tláhuac,09011,171933,184951,356884
2025,Ciudad de México,09,Venustiano Carranza,09017,202503,228776,431279
2025,Ciudad de México,09,Xochimilco,09013,199175,208173,407348
2025,Ciudad de México,09,Álvaro Obregón,09010,356938,391813,748751
2025,Coahuila,05,Abasolo,05001,619,612,1231
2025,Coahuila,05,Acuña,05002,85383,84729,170112
2025,Coahuila,05,Allende,05003,12909,13220,26129
2025,Coahuila,05,Arteaga,05004,13928,13283,27211
2025,Coahuila,05,Candela,05005,1101,997,2098
2025,Coahuila,05,Castaños,05006,16356,16288,32644
2025,Coahuila,05,Cuatro Ciénegas,05007,7870,7707,15577
2025,Coahuila,05,Escobedo,05008,1840,1753,3593
2025,Coahuila,05,Francisco I. Madero,05009,34562,34606,69168
2025,Coahuila,05,Frontera,05010,47024,46521,93545
2025,Coahuila,05,General Cepeda,05011,7566,6935,14501
2025,Coahuila,05,Guerrero,05012,1103,982,2085
2025,Coahuila,05,Hidalgo,05013,1008,964,1972
2025,Coahuila,05,Jiménez,05014,5875,5681,11556
2025,Coahuila,05,Juárez,05015,963,877,1840
2025,Coahuila,05,Lamadrid,05016,1107,1041,2148
2025,Coahuila,05,Matamoros,05017,63409,63152,126561
2025,Coahuila,05,Monclova,05018,132997,134882,267879
2025,Coahuila,05,Morelos,05019,5112,4979,10091
2025,Coahuila,05,Múzquiz,05020,40890,39969,80859
2025,Coahuila,05,Nadadores,05021,3840,3779,7619
2025,Coahuila,05,Nava,05022,17934,16994,34928
2025,Coahuila,05,Ocampo,05023,6212,5744,11956
2025,Coahuila,05,Parras,05024,26159,24999,51158
2025,Coahuila,05,Piedras Negras,05025,93820,92959,186779
2025,Coahuila,05,Progreso,05026,2018,1874,3892
2025,Coahuila,05,Ramos Arizpe,05027,57050,54671,111721
2025,Coahuila,05,Sabinas,05028,37202,36996,74198
2025,Coahuila,05,Sacramento,05029,1422,1377,2799
2025,Coahuila,05,Saltillo,05030,461021,464015,925036
2025,Coahuila,05,San Buenaventura,05031,13895,13875,27770
2025,Coahuila,05,San Juan de Sabinas,05032,24813,25838,50651
2025,Coahuila,05,San Pedro,05033,63022,63134,126156
2025,Coahuila,05,Sierra Mojada,05034,4461,4107,8568
2025,Coahuila,05,Torreón,05035,387725,406177,793902
2025,Coahuila,05,Viesca,05036,13018,12492,25510
2025,Coahuila,05,Villa Unión,05037,3719,3526,7245
2025,Coahuila,05,Zaragoza,05038,7523,7459,14982
2025,Colima,06,Armería,06001,17609,17236,34845
2025,Colima,06,Colima,06002,88826,93653,182479
2025,Colima,06,Comala,06003,12902,12681,25583
2025,Colima,06,Coquimatlán,06004,12039,11708,23747
2025,Colima,06,Cuauhtémoc,06005,17886,17598,35484
2025,Colima,06,Ixtlahuacán,06006,3332,3249,6581
2025,Colima,06,Manzanillo,06007,110787,107901,218688
2025,Colima,06,Minatitlán,06008,5449,4973,10422
2025,Colima,06,Tecomán,06009,72929,71238,144167
2025,Colima,06,Villa de Álvarez,06010,78878,82509,161387
2025,Durango,10,Canatlán,10001,17967,18427,36394
2025,Durango,10,Canelas,10002,2607,2378,4985
2025,Durango,10,Coneto de Comonfort,10003,2398,2421,4819
2025,Durango,10,Cuencamé,10004,19695,19357,39052
2025,Durango,10,Durango,10005,350359,374875,725234
2025,Durango,10,El Oro,10018,6473,6547,13020
2025,Durango,10,General Simón Bolívar,10006,5583,5683,11266
2025,Durango,10,Guadalupe Victoria,10008,19490,19833,39323
2025,Durango,10,Guanaceví,10009,5604,5248,10852
2025,Durango,10,Gómez Palacio,10007,189327,193598,382925
2025,Durango,10,Hidalgo,10010,2199,2142,4341
2025,Durango,10,Indé,10011,2903,2872,5775
2025,Durango,10,Lerdo,10012,85233,86134,171367
2025,Durango,10,Mapimí,10013,14781,14746,29527
2025,Durango,10,Mezquital,10014,20547,21210,41757
2025,Durango,10,Nazas,10015,7275,7288,14563
2025,Durango,10,Nombre de Dios,10016,10930,10978,21908
2025,Durango,10,Nuevo Ideal,10039,14998,15146,30144
2025,Durango,10,Ocampo,10017,5591,5368,10959
2025,Durango,10,Otáez,10019,2928,2692,5620
2025,Durango,10,Peñón Blanco,10021,6059,5974,12033
2025,Durango,10,Poanas,10022,13882,14203,28085
2025,Durango,10,Pueblo Nuevo,10023,26847,27068,53915
2025,Durango,10,Pánuco de Coronado,10020,6656,6827,13483
2025,Durango,10,Rodeo,10024,7640,7581,15221
2025,Durango,10,San Bernardo,10025,1935,1720,3655
2025,Durango,10,San Dimas,10026,10579,9936,20515
2025,Durango,10,San Juan de Guadalupe,10027,3017,3122,6139
2025,Durango,10,San Juan del Río,10028,6940,7085,14025
2025,Durango,10,San Luis del Cordero,10029,1207,1166,2373
2025,Durango,10,San Pedro del Gallo,10030,903,828,1731
2025,Durango,10,Santa Clara,10031,3929,3924,7853
2025,Durango,10,Santiago Papasquiaro,10032,26591,26597,53188
2025,Durango,10,Súchil,10033,3321,3616,6937
2025,Durango,10,Tamazula,10034,14350,13127,27477
2025,Durango,10,Tepehuanes,10035,5971,6001,11972
2025,Durango,10,Tlahualilo,10036,13372,13104,26476
2025,Durango,10,Topia,10037,5331,4966,10297
2025,Durango,10,Vicente Guerrero,10038,11682,12392,24074
2025,Estado de México,15,Acambay de Ruíz Castañeda,15001,35321,37380,72701
2025,Estado de México,15,Acolman,15002,99959,99631,199590
2025,Estado de México,15,Aculco,15003,27068,27613,54681
2025,Estado de México,15,Almoloya de Alquisiras,15004,7750,8382,16132
2025,Estado de México,15,Almoloya de Juárez,15005,98154,100025,198179
2025,Estado de México,15,Almoloya del Río,15006,6186,6609,12795
2025,Estado de México,15,Amanalco,15007,13198,13692,26890
2025,Estado de México,15,Amatepec,15008,14539,15324,29863
2025,Estado de México,15,Amecameca,15009,27476,29357,56833
2025,Estado de México,15,Apaxco,15010,16307,16692,32999
2025,Estado de México,15,Atenco,15011,36622,37415,74037
2025,Estado de México,15,Atizapán,15012,6363,6714,13077
2025,Estado de México,15,Atizapán de Zaragoza,15013,280877,297869,578746
2025,Estado de México,15,Atlacomulco,15014,53818,58393,112211
2025,Estado de México,15,Atlautla,15015,16847,17522,34369
2025,Estado de México,15,Axapusco,15016,15804,15935,31739
2025,Estado de México,15,Ayapango,15017,5789,6012,11801
2025,Estado de México,15,Calimaya,15018,31226,32649,63875
2025,Estado de México,15,Capulhuac,15019,19315,20474,39789
2025,Estado de México,15,Chalco,15025,210381,218494,428875
2025,Estado de México,15,Chapa de Mota,15026,15559,16180,31739
2025,Estado de México,15,Chapultepec,15027,6854,7040,13894
2025,Estado de México,15,Chiautla,15028,16561,17116,33677
2025,Estado de México,15,Chicoloapan,15029,116309,123405,239714
2025,Estado de México,15,Chiconcuac,15030,14386,14742,29128
2025,Estado de México,15,Chimalhuacán,15031,365421,377681,743102
2025,Estado de México,15,Coacalco de Berriozábal,15020,154176,166494,320670
2025,Estado de México,15,Coatepec Harinas,15021,21053,22515,43568
2025,Estado de México,15,Cocotitlán,15022,7936,8312,16248
2025,Estado de México,15,Coyotepec,15023,22532,22965,45497
2025,Estado de México,15,Cuautitlán,15024,91358,93365,184723
2025,Estado de México,15,Cuautitlán Izcalli,15121,292848,308181,601029
2025,Estado de México,15,Donato Guerra,15032,18359,18973,37332
2025,Estado de México,15,Ecatepec de Morelos,15033,873061,896200,1769261
2025,Estado de México,15,Ecatzingo,15034,5149,5300,10449
2025,Estado de México,15,El Oro,15064,20072,21364,41436
2025,Estado de México,15,Huehuetoca,15035,78069,79976,158045
2025,Estado de México,15,Hueypoxtla,15036,24791,24256,49047
2025,Estado de México,15,Huixquilucan,15037,147343,157790,305133
2025,Estado de México,15,Isidro Fabela,15038,6517,6608,13125
2025,Estado de México,15,Ixtapaluca,15039,280934,291074,572008
2025,Estado de México,15,Ixtapan de la Sal,15040,19385,20757,40142
2025,Estado de México,15,Ixtapan del Oro,15041,3858,3757,7615
2025,Estado de México,15,Ixtlahuaca,15042,82465,88222,170687
2025,Estado de México,15,Jaltenco,15044,14536,15440,29976
2025,Estado de México,15,Jilotepec,15045,49041,50567,99608
2025,Estado de México,15,Jilotzingo,15046,10534,11106,21640
2025,Estado de México,15,Jiquipilco,15047,40258,42749,83007
2025,Estado de México,15,Jocotitlán,15048,35690,38156,73846
2025,Estado de México,15,Joquicingo,15049,7541,7832,15373
2025,Estado de México,15,Juchitepec,15050,14066,14447,28513
2025,Estado de México,15,La Paz,15070,159687,163454,323141
2025,Estado de México,15,Lerma,15051,83282,85444,168726
2025,Estado de México,15,Luvianos,15123,15439,15614,31053
2025,Estado de México,15,Malinalco,15052,15323,15704,31027
2025,Estado de México,15,Melchor Ocampo,15053,31753,33042,64795
2025,Estado de México,15,Metepec,15054,124667,132478,257145
2025,Estado de México,15,Mexicaltzingo,15055,7006,7452,14458
2025,Estado de México,15,Morelos,15056,15998,17319,33317
2025,Estado de México,15,Naucalpan de Juárez,15057,464382,491917,956299
2025,Estado de México,15,Nextlalpan,15059,22938,23375,46313
2025,Estado de México,15,Nezahualcóyotl,15058,573249,617441,1190690
2025,Estado de México,15,Nicolás Romero,15060,227508,236695,464203
2025,Estado de México,15,Nopaltepec,15061,5063,5089,10152
2025,Estado de México,15,Ocoyoacac,15062,37064,38255,75319
2025,Estado de México,15,Ocuilan,15063,18838,19522,38360
2025,Estado de México,15,Otumba,15065,20142,19817,39959
2025,Estado de México,15,Otzoloapan,15066,2155,2101,4256
2025,Estado de México,15,Otzolotepec,15067,46822,47900,94722
2025,Estado de México,15,Ozumba,15068,15726,16927,32653
2025,Estado de México,15,Papalotla,15069,2204,2316,4520
2025,Estado de México,15,Polotitlán,15071,7804,8109,15913
2025,Estado de México,15,Rayón,15072,7575,7793,15368
2025,Estado de México,15,San Antonio la Isla,15073,16843,17215,34058
2025,Estado de México,15,San Felipe del Progreso,15074,67371,75389,142760
2025,Estado de México,15,San José del Rincón,15124,50122,51058,101180
2025,Estado de México,15,San Martín de las Pirámides,15075,15155,15484,30639
2025,Estado de México,15,San Mateo Atenco,15076,41199,42564,83763
2025,Estado de México,15,San Simón de Guerrero,15077,3307,3501,6808
2025,Estado de México,15,Santo Tomás,15078,5288,5416,10704
2025,Estado de México,15,Soyaniquilpan de Juárez,15079,7518,7650,15168
2025,Estado de México,15,Sultepec,15080,13945,15458,29403
2025,Estado de México,15,Tecámac,15081,261776,273859,535635
2025,Estado de México,15,Tejupilco,15082,39749,42878,82627
2025,Estado de México,15,Temamatla,15083,6950,7350,14300
2025,Estado de México,15,Temascalapa,15084,21768,21749,43517
2025,Estado de México,15,Temascalcingo,15085,33599,36421,70020
2025,Estado de México,15,Temascaltepec,15086,17506,18167,35673
2025,Estado de México,15,Temoaya,15087,55651,58713,114364
2025,Estado de México,15,Tenancingo,15088,53783,56711,110494
2025,Estado de México,15,Tenango del Aire,15089,6995,7147,14142
2025,Estado de México,15,Tenango del Valle,15090,47274,49081,96355
2025,Estado de México,15,Teoloyucan,15091,34700,35414,70114
2025,Estado de México,15,Teotihuacán,15092,31358,32343,63701
2025,Estado de México,15,Tepetlaoxtoc,15093,17241,17510,34751
2025,Estado de México,15,Tepetlixpa,15094,10940,11205,22145
2025,Estado de México,15,Tepotzotlán,15095,54072,55885,109957
2025,Estado de México,15,Tequixquiac,15096,20701,20873,41574
2025,Estado de México,15,Texcaltitlán,15097,10209,10818,21027
2025,Estado de México,15,Texcalyacac,15098,2944,3025,5969
2025,Estado de México,15,Texcoco,15099,132665,140878,273543
2025,Estado de México,15,Tezoyuca,15100,24706,24912,49618
2025,Estado de México,15,Tianguistenco,15101,41952,44189,86141
2025,Estado de México,15,Timilpan,15102,8449,9145,17594
2025,Estado de México,15,Tlalmanalco,15103,25905,27836,53741
2025,Estado de México,15,Tlalnepantla de Baz,15104,387857,414567,802424
2025,Estado de México,15,Tlatlaya,15105,19550,20250,39800
2025,Estado de México,15,Toluca,15106,479836,513557,993393
2025,Estado de México,15,Tonanitla,15125,5487,5625,11112
2025,Estado de México,15,Tonatico,15107,6974,7411,14385
2025,Estado de México,15,Tultepec,15108,82619,85614,168233
2025,Estado de México,15,Tultitlán,15109,281826,292406,574232
2025,Estado de México,15,Valle de Bravo,15110,35717,37048,72765
2025,Estado de México,15,Valle de Chalco Solidaridad,15122,215105,222208,437313
2025,Estado de México,15,Villa Guerrero,15113,37132,38104,75236
2025,Estado de México,15,Villa Victoria,15114,57464,58138,115602
2025,Estado de México,15,Villa de Allende,15111,27889,29038,56927
2025,Estado de México,15,Villa del Carbón,15112,26516,26201,52717
2025,Estado de México,15,Xalatlaco,15043,16518,17378,33896
2025,Estado de México,15,Xonacatlán,15115,28455,28169,56624
2025,Estado de México,15,Zacazonapan,15116,2249,2223,4472
2025,Estado de México,15,Zacualpan,15117,8053,8837,16890
2025,Estado de México,15,Zinacantepec,15118,104864,107533,212397
2025,Estado de México,15,Zumpahuacán,15119,8867,9657,18524
2025,Estado de México,15,Zumpango,15120,111700,119109,230809
2025,Guanajuato,11,Abasolo,11001,48271,51056,99327
2025,Guanajuato,11,Acámbaro,11002,60015,64692,124707
2025,Guanajuato,11,Apaseo el Alto,11004,36518,38218,74736
2025,Guanajuato,11,Apaseo el Grande,11005,50185,53154,103339
2025,Guanajuato,11,Atarjea,11006,2835,2937,5772
2025,Guanajuato,11,Celaya,11007,267824,283308,551132
2025,Guanajuato,11,Comonfort,11009,42745,47372,90117
2025,Guanajuato,11,Coroneo,11010,6402,7156,13558
2025,Guanajuato,11,Cortazar,11011,51261,54190,105451
2025,Guanajuato,11,Cuerámaro,11012,15043,16163,31206
2025,Guanajuato,11,Doctor Mora,11013,12693,13657,26350
2025,Guanajuato,11,Dolores Hidalgo Cuna de la Independencia Nacional,11014,78016,87010,165026
2025,Guanajuato,11,Guanajuato,11015,100920,105261,206181
2025,Guanajuato,11,Huanímaro,11016,11216,12372,23588
2025,Guanajuato,11,Irapuato,11017,309909,325545,635454
2025,Guanajuato,11,Jaral del Progreso,11018,21300,21848,43148
2025,Guanajuato,11,Jerécuaro,11019,24696,28219,52915
2025,Guanajuato,11,León,11020,863756,878056,1741812
2025,Guanajuato,11,Manuel Doblado,11008,20309,21987,42296
2025,Guanajuato,11,Moroleón,11021,27307,29818,57125
2025,Guanajuato,11,Ocampo,11022,12427,13215,25642
2025,Guanajuato,11,Pueblo Nuevo,11024,6330,6975,13305
2025,Guanajuato,11,Purísima del Rincón,11025,45099,44854,89953
2025,Guanajuato,11,Pénjamo,11023,79376,86465,165841
2025,Guanajuato,11,Romita,11026,31591,33141,64732
2025,Guanajuato,11,Salamanca,11027,149229,156963,306192
2025,Guanajuato,11,Salvatierra,11028,53571,58677,112248
2025,Guanajuato,11,San Diego de la Unión,11029,20075,23036,43111
2025,Guanajuato,11,San Felipe,11030,59580,63006,122586
2025,Guanajuato,11,San Francisco del Rincón,11031,63324,66413,129737
2025,Guanajuato,11,San José Iturbide,11032,42217,44643,86860
2025,Guanajuato,11,San Luis de la Paz,11033,62669,68888,131557
2025,Guanajuato,11,San Miguel de Allende,11003,91671,98864,190535
2025,Guanajuato,11,Santa Catarina,11034,2762,3038,5800
2025,Guanajuato,11,Santa Cruz de Juventino Rosas,11035,44391,47452,91843
2025,Guanajuato,11,Santiago Maravatío,11036,3746,4100,7846
2025,Guanajuato,11,Silao de la Victoria,11037,103373,105820,209193
2025,Guanajuato,11,Tarandacuao,11038,6546,7183,13729
2025,Guanajuato,11,Tarimoro,11039,18595,19451,38046
2025,Guanajuato,11,Tierra Blanca,11040,10131,10846,20977
2025,Guanajuato,11,Uriangato,11041,34005,36194,70199
2025,Guanajuato,11,Valle de Santiago,11042,76350,83622,159972
2025,Guanajuato,11,Victoria,11043,10559,11779,22338
2025,Guanajuato,11,Villagrán,11044,31956,33264,65220
2025,Guanajuato,11,Xichú,11045,6113,6689,12802
2025,Guanajuato,11,Yuriria,11046,36911,40450,77361
2025,Guerrero,12,Acapulco de Juárez,12001,410378,443234,853612
2025,Guerrero,12,Acatepec,12076,18725,19654,38379
2025,Guerrero,12,Ahuacuotzingo,12002,12958,14710,27668
2025,Guerrero,12,Ajuchitlán del Progreso,12003,18909,20074,38983
2025,Guerrero,12,Alcozauca de Guerrero,12004,9532,10859,20391
2025,Guerrero,12,Alpoyeca,12005,3340,3724,7064
2025,Guerrero,12,Apaxtla,12006,5681,6149,11830
2025,Guerrero,12,Arcelia,12007,15913,16905,32818
2025,Guerrero,12,Atenango del Río,12008,4369,4726,9095
2025,Guerrero,12,Atlamajalcingo del Monte,12009,2451,2735,5186
2025,Guerrero,12,Atlixtac,12010,13669,14585,28254
2025,Guerrero,12,Atoyac de Álvarez,12011,31089,32224,63313
2025,Guerrero,12,Ayutla de los Libres,12012,34589,36095,70684
2025,Guerrero,12,Azoyú,12013,6332,6707,13039
2025,Guerrero,12,Benito Juárez,12014,7963,8390,16353
2025,Guerrero,12,Buenavista de Cuéllar,12015,6823,7169,13992
2025,Guerrero,12,Chilapa de Álvarez,12028,64039,71158,135197
2025,Guerrero,12,Chilpancingo de los Bravo,12029,138764,151269,290033
2025,Guerrero,12,Coahuayutla de José María Izazaga,12016,6435,6110,12545
2025,Guerrero,12,Cochoapa el Grande,12078,9005,9949,18954
2025,Guerrero,12,Cocula,12017,6880,7354,14234
2025,Guerrero,12,Copala,12018,7336,7590,14926
2025,Guerrero,12,Copalillo,12019,7219,7924,15143
2025,Guerrero,12,Copanatoyac,12020,9993,10984,20977
2025,Guerrero,12,Coyuca de Benítez,12021,39295,40757,80052
2025,Guerrero,12,Coyuca de Catalán,12022,20499,19920,40419
2025,Guerrero,12,Cuajinicuilapa,12023,14247,14134,28381
2025,Guerrero,12,Cualác,12024,3827,4083,7910
2025,Guerrero,12,Cuautepec,12025,8321,8377,16698
2025,Guerrero,12,Cuetzala del Progreso,12026,4429,4656,9085
2025,Guerrero,12,Cutzamala de Pinzón,12027,10214,10555,20769
2025,Guerrero,12,Eduardo Neri,12075,26483,27614,54097
2025,Guerrero,12,Florencio Villarreal,12030,10755,11000,21755
2025,Guerrero,12,General Canuto A. Neri,12031,2903,3131,6034
2025,Guerrero,12,General Heliodoro Castillo,12032,18882,18866,37748
2025,Guerrero,12,Huamuxtitlán,12033,7551,8488,16039
2025,Guerrero,12,Huitzuco de los Figueroa,12034,18991,20500,39491
2025,Guerrero,12,Iguala de la Independencia,12035,77751,83551,161302
2025,Guerrero,12,Igualapa,12036,5729,5911,11640
2025,Guerrero,12,Iliatenco,12081,5399,5972,11371
2025,Guerrero,12,Ixcateopan de Cuauhtémoc,12037,3124,3450,6574
2025,Guerrero,12,José Joaquín de Herrera,12079,8931,9107,18038
2025,Guerrero,12,Juan R. Escudero,12039,12705,13369,26074
2025,Guerrero,12,Juchitán,12080,4057,3973,8030
2025,Guerrero,12,La Unión de Isidoro Montes de Oca,12068,13947,13306,27253
2025,Guerrero,12,Leonardo Bravo,12040,13426,13691,27117
2025,Guerrero,12,Malinaltepec,12041,13062,14770,27832
2025,Guerrero,12,Marquelia,12077,7176,7263,14439
2025,Guerrero,12,Metlatónoc,12043,8624,9953,18577
2025,Guerrero,12,Mochitlán,12044,6641,6924,13565
2025,Guerrero,12,Mártir de Cuilapan,12042,9407,10319,19726
2025,Guerrero,12,Olinalá,12045,12827,13815,26642
2025,Guerrero,12,Ometepec,12046,34528,36311,70839
2025,Guerrero,12,Pedro Ascencio Alquisiras,12047,3289,3812,7101
2025,Guerrero,12,Petatlán,12048,22541,23002,45543
2025,Guerrero,12,Pilcaya,12049,6603,6988,13591
2025,Guerrero,12,Pungarabato,12050,18775,20007,38782
2025,Guerrero,12,Quechultenango,12051,18226,19043,37269
2025,Guerrero,12,San Luis Acatlán,12052,22176,22816,44992
2025,Guerrero,12,San Marcos,12053,25397,26178,51575
2025,Guerrero,12,San Miguel Totolapan,12054,13825,14388,28213
2025,Guerrero,12,Taxco de Alarcón,12055,54671,59693,114364
2025,Guerrero,12,Tecoanapa,12056,23613,24308,47921
2025,Guerrero,12,Teloloapan,12058,28529,32017,60546
2025,Guerrero,12,Tepecoacuilco de Trujano,12059,16333,17675,34008
2025,Guerrero,12,Tetipac,12060,7409,7814,15223
2025,Guerrero,12,Tixtla de Guerrero,12061,21741,23566,45307
2025,Guerrero,12,Tlacoachistlahuaca,12062,11573,13059,24632
2025,Guerrero,12,Tlacoapa,12063,5045,5589,10634
2025,Guerrero,12,Tlalchapa,12064,6616,6603,13219
2025,Guerrero,12,Tlalixtaquilla de Maldonado,12065,3745,4040,7785
2025,Guerrero,12,Tlapa de Comonfort,12066,45173,50217,95390
2025,Guerrero,12,Tlapehuala,12067,11059,11854,22913
2025,Guerrero,12,Técpan de Galeana,12057,34011,34515,68526
2025,Guerrero,12,Xalpatláhuac,12069,5633,6611,12244
2025,Guerrero,12,Xochihuehuetlán,12070,3530,3987,7517
2025,Guerrero,12,Xochistlahuaca,12071,14763,15668,30431
2025,Guerrero,12,Zapotitlán Tablas,12072,6462,7118,13580
2025,Guerrero,12,Zihuatanejo de Azueta,12038,65271,67034,132305
2025,Guerrero,12,Zirándaro,12073,9256,8835,18091
2025,Guerrero,12,Zitlala,12074,11430,12807,24237
2025,Hidalgo,13,Acatlán,13001,11138,11941,23079
2025,Hidalgo,13,Acaxochitlán,13002,23184,25146,48330
2025,Hidalgo,13,Actopan,13003,30609,33916,64525
2025,Hidalgo,13,Agua Blanca de Iturbide,13004,4800,5341,10141
2025,Hidalgo,13,Ajacuba,13005,10295,10710,21005
2025,Hidalgo,13,Alfajayucan,13006,11451,12110,23561
2025,Hidalgo,13,Almoloya,13007,6853,6934,13787
2025,Hidalgo,13,Apan,13008,24205,26278,50483
2025,Hidalgo,13,Atitalaquia,13010,16809,17176,33985
2025,Hidalgo,13,Atlapexco,13011,10930,11840,22770
2025,Hidalgo,13,Atotonilco de Tula,13013,21213,22387,43600
2025,Hidalgo,13,Atotonilco el Grande,13012,14718,16365,31083
2025,Hidalgo,13,Calnali,13014,9497,10279,19776
2025,Hidalgo,13,Cardonal,13015,10091,10945,21036
2025,Hidalgo,13,Chapantongo,13017,7607,8020,15627
2025,Hidalgo,13,Chapulhuacán,13018,13463,13294,26757
2025,Hidalgo,13,Chilcuautla,13019,10191,10508,20699
2025,Hidalgo,13,Cuautepec de Hinojosa,13016,31322,34324,65646
2025,Hidalgo,13,El Arenal,13009,10207,11090,21297
2025,Hidalgo,13,Eloxochitlán,13020,1497,1702,3199
2025,Hidalgo,13,Emiliano Zapata,13021,7928,8803,16731
2025,Hidalgo,13,Epazoyucan,13022,8275,8756,17031
2025,Hidalgo,13,Francisco I. Madero,13023,19690,21427,41117
2025,Hidalgo,13,Huasca de Ocampo,13024,9586,10460,20046
2025,Hidalgo,13,Huautla,13025,11617,12759,24376
2025,Hidalgo,13,Huazalingo,13026,7681,8122,15803
2025,Hidalgo,13,Huehuetla,13027,13883,14822,28705
2025,Hidalgo,13,Huejutla de Reyes,13028,71509,74255,145764
2025,Hidalgo,13,Huichapan,13029,25172,27279,52451
2025,Hidalgo,13,Ixmiquilpan,13030,49632,55551,105183
2025,Hidalgo,13,Jacala de Ledezma,13031,7299,8116,15415
2025,Hidalgo,13,Jaltocán,13032,6660,6858,13518
2025,Hidalgo,13,Juárez Hidalgo,13033,1730,1899,3629
2025,Hidalgo,13,La Misión,13040,5660,5819,11479
2025,Hidalgo,13,Lolotla,13034,5197,5479,10676
2025,Hidalgo,13,Metepec,13035,6138,6958,13096
2025,Hidalgo,13,Metztitlán,13037,11095,12280,23375
2025,Hidalgo,13,Mineral de la Reforma,13051,95779,105215,200994
2025,Hidalgo,13,Mineral del Chico,13038,5012,5311,10323
2025,Hidalgo,13,Mineral del Monte,13039,7972,8721,16693
2025,Hidalgo,13,Mixquiahuala de Juárez,13041,25440,27342,52782
2025,Hidalgo,13,Molango de Escamilla,13042,6470,6759,13229
2025,Hidalgo,13,Nicolás Flores,13043,3686,4144,7830
2025,Hidalgo,13,Nopala de Villagrán,13044,9421,9753,19174
2025,Hidalgo,13,Omitlán de Juárez,13045,5356,5821,11177
2025,Hidalgo,13,Pachuca de Soto,13048,138244,152336,290580
2025,Hidalgo,13,Pacula,13047,2624,3013,5637
2025,Hidalgo,13,Pisaflores,13049,9745,9724,19469
2025,Hidalgo,13,Progreso de Obregón,13050,12701,14115,26816
2025,Hidalgo,13,San Agustín Metzquititlán,13036,5247,5701,10948
2025,Hidalgo,13,San Agustín Tlaxiaca,13052,20367,21287,41654
2025,Hidalgo,13,San Bartolo Tutotepec,13053,10358,10656,21014
2025,Hidalgo,13,San Felipe Orizatlán,13046,21233,22134,43367
2025,Hidalgo,13,San Salvador,13054,19389,20755,40144
2025,Hidalgo,13,Santiago Tulantepec de Lugo Guerrero,13056,20149,22010,42159
2025,Hidalgo,13,Santiago de Anaya,13055,9513,9945,19458
2025,Hidalgo,13,Singuilucan,13057,9087,9294,18381
2025,Hidalgo,13,Tasquillo,13058,8461,9924,18385
2025,Hidalgo,13,Tecozautla,13059,20565,22152,42717
2025,Hidalgo,13,Tenango de Doria,13060,9781,10828,20609
2025,Hidalgo,13,Tepeapulco,13061,30010,31930,61940
2025,Hidalgo,13,Tepehuacán de Guerrero,13062,17357,16854,34211
2025,Hidalgo,13,Tepeji del Río de Ocampo,13063,48481,49783,98264
2025,Hidalgo,13,Tepetitlán,13064,6113,6437,12550
2025,Hidalgo,13,Tetepango,13065,6553,6577,13130
2025,Hidalgo,13,Tezontepec de Aldama,13067,29715,30371,60086
2025,Hidalgo,13,Tianguistengo,13068,8275,8649,16924
2025,Hidalgo,13,Tizayuca,13069,72980,74904,147884
2025,Hidalgo,13,Tlahuelilpan,13070,10760,11114,21874
2025,Hidalgo,13,Tlahuiltepa,13071,5788,5809,11597
2025,Hidalgo,13,Tlanalapa,13072,5700,6074,11774
2025,Hidalgo,13,Tlanchinol,13073,21907,22268,44175
2025,Hidalgo,13,Tlaxcoapan,13074,15891,16269,32160
2025,Hidalgo,13,Tolcayuca,13075,9118,9649,18767
2025,Hidalgo,13,Tula de Allende,13076,60756,64363,125119
2025,Hidalgo,13,Tulancingo de Bravo,13077,84573,93856,178429
2025,Hidalgo,13,Villa de Tezontepec,13066,6892,7197,14089
2025,Hidalgo,13,Xochiatipan,13078,10729,11422,22151
2025,Hidalgo,13,Xochicoatlán,13079,4356,4502,8858
2025,Hidalgo,13,Yahualica,13080,13356,13978,27334
2025,Hidalgo,13,Zacualtipán de Ángeles,13081,19001,20741,39742
2025,Hidalgo,13,Zapotlán de Juárez,13082,10260,11096,21356
2025,Hidalgo,13,Zempoala,13083,26489,28027,54516
2025,Hidalgo,13,Zimapán,13084,20746,24037,44783
2025,Jalisco,14,Acatic,14001,11770,12225,23995
2025,Jalisco,14,Acatlán de Juárez,14002,12589,12119,24708
2025,Jalisco,14,Ahualulco de Mercado,14003,12736,13134,25870
2025,Jalisco,14,Amacueca,14004,2987,3120,6107
2025,Jalisco,14,Amatitán,14005,8511,8588,17099
2025,Jalisco,14,Ameca,14006,33604,34894,68498
2025,Jalisco,14,Arandas,14008,39620,42598,82218
2025,Jalisco,14,Atemajac de Brizuela,14010,3664,3706,7370
2025,Jalisco,14,Atengo,14011,3253,3018,6271
2025,Jalisco,14,Atenguillo,14012,2199,2279,4478
2025,Jalisco,14,Atotonilco el Alto,14013,33362,34376,67738
2025,Jalisco,14,Atoyac,14014,4386,4725,9111
2025,Jalisco,14,Autlán de Navarro,14015,33868,34978,68846
2025,Jalisco,14,Ayotlán,14016,20661,21498,42159
2025,Jalisco,14,Ayutla,14017,7038,6996,14034
2025,Jalisco,14,Bolaños,14019,4346,4345,8691
2025,Jalisco,14,Cabo Corrientes,14020,6066,5585,11651
2025,Jalisco,14,Casimiro Castillo,14021,12266,12232,24498
2025,Jalisco,14,Cañadas de Obregón,14117,2319,2414,4733
2025,Jalisco,14,Chapala,14030,28137,29543,57680
2025,Jalisco,14,Chimaltitán,14031,1805,1848,3653
2025,Jalisco,14,Chiquilistlán,14032,3419,3357,6776
2025,Jalisco,14,Cihuatlán,14022,23478,22868,46346
2025,Jalisco,14,Cocula,14024,14625,15303,29928
2025,Jalisco,14,Colotlán,14025,9740,10415,20155
2025,Jalisco,14,Concepción de Buenos Aires,14026,3535,3392,6927
2025,Jalisco,14,Cuautitlán de García Barragán,14027,10055,9784,19839
2025,Jalisco,14,Cuautla,14028,1191,1272,2463
2025,Jalisco,14,Cuquío,14029,9789,10622,20411
2025,Jalisco,14,Degollado,14033,11644,12300,23944
2025,Jalisco,14,Ejutla,14034,1128,1046,2174
2025,Jalisco,14,El Arenal,14009,10992,11065,22057
2025,Jalisco,14,El Grullo,14037,13419,14197,27616
2025,Jalisco,14,El Limón,14054,3144,3145,6289
2025,Jalisco,14,El Salto,14070,105073,105772,210845
2025,Jalisco,14,Encarnación de Díaz,14035,28904,30924,59828
2025,Jalisco,14,Etzatlán,14036,10853,11378,22231
2025,Jalisco,14,Guachinango,14038,2451,2361,4812
2025,Jalisco,14,Guadalajara,14039,757884,804984,1562868
2025,Jalisco,14,Gómez Farías,14079,7763,8274,16037
2025,Jalisco,14,Hostotipaquillo,14040,6194,5346,11540
2025,Jalisco,14,Huejuquilla el Alto,14042,4808,5176,9984
2025,Jalisco,14,Huejúcar,14041,3162,3466,6628
2025,Jalisco,14,Ixtlahuacán de los Membrillos,14044,31962,32481,64443
2025,Jalisco,14,Ixtlahuacán del Río,14045,10355,10961,21316
2025,Jalisco,14,Jalostotitlán,14046,18668,19061,37729
2025,Jalisco,14,Jamay,14047,13915,13878,27793
2025,Jalisco,14,Jesús María,14048,9793,11579,21372
2025,Jalisco,14,Jilotlán de los Dolores,14049,5377,5124,10501
2025,Jalisco,14,Jocotepec,14050,25752,26060,51812
2025,Jalisco,14,Juanacatlán,14051,10204,10152,20356
2025,Jalisco,14,Juchitlán,14052,3099,3260,6359
2025,Jalisco,14,La Barca,14018,35375,37509,72884
2025,Jalisco,14,La Huerta,14043,14006,13427,27433
2025,Jalisco,14,La Manzanilla de la Paz,14057,2047,2190,4237
2025,Jalisco,14,Lagos de Moreno,14053,89689,93314,183003
2025,Jalisco,14,Magdalena,14055,12620,12587,25207
2025,Jalisco,14,Mascota,14058,8146,8403,16549
2025,Jalisco,14,Mazamitla,14059,7558,8174,15732
2025,Jalisco,14,Mexticacán,14060,2582,3016,5598
2025,Jalisco,14,Mezquitic,14061,10515,11156,21671
2025,Jalisco,14,Mixtlán,14062,2001,1969,3970
2025,Jalisco,14,Ocotlán,14063,54290,56134,110424
2025,Jalisco,14,Ojuelos de Jalisco,14064,17243,18102,35345
2025,Jalisco,14,Pihuamo,14065,6374,6273,12647
2025,Jalisco,14,Poncitlán,14066,28274,28981,57255
2025,Jalisco,14,Puerto Vallarta,14067,157966,154213,312179
2025,Jalisco,14,Quitupan,14069,4399,4876,9275
2025,Jalisco,14,San Cristóbal de la Barranca,14071,1639,1634,3273
2025,Jalisco,14,San Diego de Alejandría,14072,3907,4171,8078
2025,Jalisco,14,San Gabriel,14113,9060,9380,18440
2025,Jalisco,14,San Ignacio Cerro Gordo,14125,10210,10823,21033
2025,Jalisco,14,San Juan de los Lagos,14073,38506,38917,77423
2025,Jalisco,14,San Juanito de Escobedo,14007,5275,5191,10466
2025,Jalisco,14,San Julián,14074,8511,9348,17859
2025,Jalisco,14,San Marcos,14075,2141,2094,4235
2025,Jalisco,14,San Martín Hidalgo,14077,15269,15952,31221
2025,Jalisco,14,San Martín de Bolaños,14076,1666,1669,3335
2025,Jalisco,14,San Miguel el Alto,14078,17951,18815,36766
2025,Jalisco,14,San Pedro Tlaquepaque,14098,366279,369746,736025
2025,Jalisco,14,San Sebastián del Oeste,14080,3299,2956,6255
2025,Jalisco,14,Santa María de los Ángeles,14081,1699,1866,3565
2025,Jalisco,14,Santa María del Oro,14056,1137,1128,2265
2025,Jalisco,14,Sayula,14082,19755,21240,40995
2025,Jalisco,14,Tala,14083,45121,45624,90745
2025,Jalisco,14,Talpa de Allende,14084,8474,8333,16807
2025,Jalisco,14,Tamazula de Gordiano,14085,21197,22172,43369
2025,Jalisco,14,Tapalpa,14086,10513,10925,21438
2025,Jalisco,14,Tecalitlán,14087,9070,9463,18533
2025,Jalisco,14,Techaluta de Montenegro,14089,2095,2153,4248
2025,Jalisco,14,Tecolotlán,14088,9759,9754,19513
2025,Jalisco,14,Tenamaxtlán,14090,3916,3912,7828
2025,Jalisco,14,Teocaltiche,14091,22150,24175,46325
2025,Jalisco,14,Teocuitatlán de Corona,14092,5803,5990,11793
2025,Jalisco,14,Tepatitlán de Morelos,14093,76950,79617,156567
2025,Jalisco,14,Tequila,14094,22970,23273,46243
2025,Jalisco,14,Teuchitlán,14095,5395,5565,10960
2025,Jalisco,14,Tizapán el Alto,14096,11558,12088,23646
2025,Jalisco,14,Tlajomulco de Zúñiga,14097,344165,349164,693329
2025,Jalisco,14,Tolimán,14099,5732,5784,11516
2025,Jalisco,14,Tomatlán,14100,20274,19195,39469
2025,Jalisco,14,Tonalá,14101,299117,299871,598988
2025,Jalisco,14,Tonaya,14102,3336,3475,6811
2025,Jalisco,14,Tonila,14103,4448,4460,8908
2025,Jalisco,14,Totatiche,14104,2512,2538,5050
2025,Jalisco,14,Tototlán,14105,12828,13095,25923
2025,Jalisco,14,Tuxcacuesco,14106,2521,2397,4918
2025,Jalisco,14,Tuxcueca,14107,3374,3591,6965
2025,Jalisco,14,Tuxpan,14108,18951,20119,39070
2025,Jalisco,14,Unión de San Antonio,14109,9777,10408,20185
2025,Jalisco,14,Unión de Tula,14110,7347,7805,15152
2025,Jalisco,14,Valle de Guadalupe,14111,3921,3939,7860
2025,Jalisco,14,Valle de Juárez,14112,3016,3179,6195
2025,Jalisco,14,Villa Corona,14114,9990,10215,20205
2025,Jalisco,14,Villa Guerrero,14115,3059,3150,6209
2025,Jalisco,14,Villa Hidalgo,14116,11039,11774,22813
2025,Jalisco,14,Villa Purificación,14068,6333,5859,12192
2025,Jalisco,14,Yahualica de González Gallo,14118,11909,13010,24919
2025,Jalisco,14,Zacoalco de Torres,14119,15870,16084,31954
2025,Jalisco,14,Zapopan,14120,732795,758386,1491181
2025,Jalisco,14,Zapotiltic,14121,16085,16689,32774
2025,Jalisco,14,Zapotitlán de Vadillo,14122,3949,3905,7854
2025,Jalisco,14,Zapotlanejo,14124,37288,38111,75399
2025,Jalisco,14,Zapotlán del Rey,14123,10102,10119,20221
2025,Jalisco,14,Zapotlán el Grande,14023,57984,60997,118981
2025,Michoacán,16,Acuitzio,16001,5986,6428,12414
2025,Michoacán,16,Aguililla,16002,7749,7562,15311
2025,Michoacán,16,Angamacutiro,16004,7936,8677,16613
2025,Michoacán,16,Angangueo,16005,5897,6246,12143
2025,Michoacán,16,Apatzingán,16006,67975,68868,136843
2025,Michoacán,16,Aporo,16007,1714,1826,3540
2025,Michoacán,16,Aquila,16008,13677,13281,26958
2025,Michoacán,16,Ario,16009,19476,20502,39978
2025,Michoacán,16,Arteaga,16010,11627,11736,23363
2025,Michoacán,16,Briseñas,16011,6070,6359,12429
2025,Michoacán,16,Buenavista,16012,26322,24959,51281
2025,Michoacán,16,Carácuaro,16013,4948,4901,9849
2025,Michoacán,16,Charapan,16021,6314,7111,13425
2025,Michoacán,16,Charo,16022,12278,11615,23893
2025,Michoacán,16,Chavinda,16023,5506,5753,11259
2025,Michoacán,16,Cherán,16024,9951,10698,20649
2025,Michoacán,16,Chilchota,16025,20518,22107,42625
2025,Michoacán,16,Chinicuila,16026,2644,2410,5054
2025,Michoacán,16,Chucándiro,16027,2142,2479,4621
2025,Michoacán,16,Churintzio,16028,2676,2992,5668
2025,Michoacán,16,Churumuco,16029,8228,8179,16407
2025,Michoacán,16,Coahuayana,16014,8183,7537,15720
2025,Michoacán,16,Coalcomán de Vázquez Pallares,16015,9256,9405,18661
2025,Michoacán,16,Coeneo,16016,10621,12202,22823
2025,Michoacán,16,Cojumatlán de Régules,16074,5569,5772,11341
2025,Michoacán,16,Contepec,16017,17931,18824,36755
2025,Michoacán,16,Copándaro,16018,4656,5140,9796
2025,Michoacán,16,Cotija,16019,9577,10512,20089
2025,Michoacán,16,Cuitzeo,16020,15473,16994,32467
2025,Michoacán,16,Ecuandureo,16030,6290,7365,13655
2025,Michoacán,16,Epitacio Huerta,16031,8849,9198,18047
2025,Michoacán,16,Erongarícuaro,16032,8049,8642,16691
2025,Michoacán,16,Gabriel Zamora,16033,12325,12357,24682
2025,Michoacán,16,Hidalgo,16034,64626,67745,132371
2025,Michoacán,16,Huandacareo,16036,6108,6949,13057
2025,Michoacán,16,Huaniqueo,16037,4143,4797,8940
2025,Michoacán,16,Huetamo,16038,21333,22317,43650
2025,Michoacán,16,Huiramba,16039,4702,4856,9558
2025,Michoacán,16,Indaparapeo,16040,8813,9232,18045
2025,Michoacán,16,Irimbo,16041,7853,8543,16396
2025,Michoacán,16,Ixtlán,16042,6901,7036,13937
2025,Michoacán,16,Jacona,16043,36200,38218,74418
2025,Michoacán,16,Jiménez,16044,6715,7247,13962
2025,Michoacán,16,Jiquilpan,16045,17066,18723,35789
2025,Michoacán,16,José Sixto Verduzco,16113,13714,14999,28713
2025,Michoacán,16,Jungapeo,16047,11395,11498,22893
2025,Michoacán,16,Juárez,16046,7741,8088,15829
2025,Michoacán,16,La Huacana,16035,18308,18419,36727
2025,Michoacán,16,La Piedad,16069,54740,59569,114309
2025,Michoacán,16,Lagunillas,16048,3001,3073,6074
2025,Michoacán,16,Los Reyes,16075,37228,38898,76126
2025,Michoacán,16,Lázaro Cárdenas,16052,98234,97405,195639
2025,Michoacán,16,Madero,16049,9772,9502,19274
2025,Michoacán,16,Maravatío,16050,46298,49730,96028
2025,Michoacán,16,Marcos Castellanos,16051,7311,7807,15118
2025,Michoacán,16,Morelia,16053,409240,441850,851090
2025,Michoacán,16,Morelos,16054,3699,4381,8080
2025,Michoacán,16,Múgica,16055,24301,24804,49105
2025,Michoacán,16,Nahuatzen,16056,14955,15810,30765
2025,Michoacán,16,Nocupétaro,16057,4356,4391,8747
2025,Michoacán,16,Nuevo Parangaricutiro,16058,10587,10902,21489
2025,Michoacán,16,Nuevo Urecho,16059,4366,4360,8726
2025,Michoacán,16,Numarán,16060,5067,5562,10629
2025,Michoacán,16,Ocampo,16061,12915,12925,25840
2025,Michoacán,16,Pajacuarán,16062,10112,10773,20885
2025,Michoacán,16,Panindícuaro,16063,8132,9069,17201
2025,Michoacán,16,Paracho,16065,19471,21232,40703
2025,Michoacán,16,Parácuaro,16064,14624,14195,28819
2025,Michoacán,16,Penjamillo,16067,8696,9864,18560
2025,Michoacán,16,Peribán,16068,15325,15081,30406
2025,Michoacán,16,Puruándiro,16071,34311,37952,72263
2025,Michoacán,16,Purépero,16070,8090,8432,16522
2025,Michoacán,16,Pátzcuaro,16066,48542,52572,101114
2025,Michoacán,16,Queréndaro,16072,7224,7532,14756
2025,Michoacán,16,Quiroga,16073,14428,15772,30200
2025,Michoacán,16,Sahuayo,16076,41249,43065,84314
2025,Michoacán,16,Salvador Escalante,16079,25982,27339,53321
2025,Michoacán,16,San Lucas,16077,9720,9845,19565
2025,Michoacán,16,Santa Ana Maya,16078,6392,7233,13625
2025,Michoacán,16,Senguio,16080,9994,10607,20601
2025,Michoacán,16,Susupuato,16081,4704,4698,9402
2025,Michoacán,16,Tacámbaro,16082,41262,42981,84243
2025,Michoacán,16,Tancítaro,16083,17039,16506,33545
2025,Michoacán,16,Tangamandapio,16084,15373,16417,31790
2025,Michoacán,16,Tangancícuaro,16085,17801,18841,36642
2025,Michoacán,16,Tanhuato,16086,8212,8580,16792
2025,Michoacán,16,Taretan,16087,7960,8103,16063
2025,Michoacán,16,Tarímbaro,16088,61000,65727,126727
2025,Michoacán,16,Tepalcatepec,16089,13027,12719,25746
2025,Michoacán,16,Tingambato,16090,7969,8406,16375
2025,Michoacán,16,Tingüindín,16091,7692,8279,15971
2025,Michoacán,16,Tiquicheo de Nicolás Romero,16092,7116,7211,14327
2025,Michoacán,16,Tlalpujahua,16093,14773,16387,31160
2025,Michoacán,16,Tlazazalca,16094,3413,3610,7023
2025,Michoacán,16,Tocumbo,16095,6555,6638,13193
2025,Michoacán,16,Tumbiscatío,16096,3511,3373,6884
2025,Michoacán,16,Turicato,16097,16196,16919,33115
2025,Michoacán,16,Tuxpan,16098,14053,15031,29084
2025,Michoacán,16,Tuzantla,16099,8103,8136,16239
2025,Michoacán,16,Tzintzuntzan,16100,7471,8217,15688
2025,Michoacán,16,Tzitzio,16101,4622,4474,9096
2025,Michoacán,16,Uruapan,16102,177294,188603,365897
2025,Michoacán,16,Venustiano Carranza,16103,13352,13851,27203
2025,Michoacán,16,Villamar,16104,8738,9357,18095
2025,Michoacán,16,Vista Hermosa,16105,11094,11503,22597
2025,Michoacán,16,Yurécuaro,16106,16732,17547,34279
2025,Michoacán,16,Zacapu,16107,39549,42597,82146
2025,Michoacán,16,Zamora,16108,104348,110252,214600
2025,Michoacán,16,Zinapécuaro,16110,24547,26451,50998
2025,Michoacán,16,Zináparo,16109,1643,1895,3538
2025,Michoacán,16,Ziracuaretiro,16111,9382,9531,18913
2025,Michoacán,16,Zitácuaro,16112,84454,92265,176719
2025,Michoacán,16,Álvaro Obregón,16003,11549,12229,23778
2025,Morelos,17,Amacuzac,17001,9678,10088,19766
2025,Morelos,17,Atlatlahucan,17002,12645,13041,25686
2025,Morelos,17,Axochiapan,17003,19900,20217,40117
2025,Morelos,17,Ayala,17004,46286,49195,95481
2025,Morelos,17,Coatlán del Río,17005,5510,5618,11128
2025,Morelos,17,Cuautla,17006,105978,113255,219233
2025,Morelos,17,Cuernavaca,17007,196486,221748,418234
2025,Morelos,17,Emiliano Zapata,17008,55594,57120,112714
2025,Morelos,17,Huitzilac,17009,10649,10688,21337
2025,Morelos,17,Jantetelco,17010,9500,9852,19352
2025,Morelos,17,Jiutepec,17011,114570,121553,236123
2025,Morelos,17,Jojutla,17012,31206,33301,64507
2025,Morelos,17,Jonacatepec,17013,8491,9094,17585
2025,Morelos,17,Mazatepec,17014,5507,5715,11222
2025,Morelos,17,Miacatlán,17015,14491,15113,29604
2025,Morelos,17,Ocuituco,17016,10249,10436,20685
2025,Morelos,17,Puente de Ixtla,17017,36463,37793,74256
2025,Morelos,17,Temixco,17018,63329,65768,129097
2025,Morelos,17,Temoac,17033,8725,9149,17874
2025,Morelos,17,Tepalcingo,17019,14925,15437,30362
2025,Morelos,17,Tepoztlán,17020,26930,27761,54691
2025,Morelos,17,Tetecala,17021,4390,4396,8786
2025,Morelos,17,Tetela del Volcán,17022,11268,11798,23066
2025,Morelos,17,Tlalnepantla,17023,4110,3978,8088
2025,Morelos,17,Tlaltizapán de Zapata,17024,28523,29769,58292
2025,Morelos,17,Tlaquiltenango,17025,18865,19293,38158
2025,Morelos,17,Tlayacapan,17026,9958,10108,20066
2025,Morelos,17,Totolapan,17027,6613,6766,13379
2025,Morelos,17,Xochitepec,17028,39522,38732,78254
2025,Morelos,17,Yautepec,17029,56034,58909,114943
2025,Morelos,17,Yecapixtla,17030,29393,29934,59327
2025,Morelos,17,Zacatepec,17031,19825,21375,41200
2025,Morelos,17,Zacualpan,17032,5284,5470,10754
2025,Nayarit,18,Acaponeta,18001,21476,21349,42825
2025,Nayarit,18,Ahuacatlán,18002,9274,9137,18411
2025,Nayarit,18,Amatlán de Cañas,18003,6991,6706,13697
2025,Nayarit,18,Bahía de Banderas,18020,96413,92443,188856
2025,Nayarit,18,Compostela,18004,43819,43360,87179
2025,Nayarit,18,Del Nayar,18009,23925,23820,47745
2025,Nayarit,18,Huajicori,18005,7277,7018,14295
2025,Nayarit,18,Ixtlán del Río,18006,16370,17401,33771
2025,Nayarit,18,Jala,18007,10509,10657,21166
2025,Nayarit,18,La Yesca,18019,8035,7530,15565
2025,Nayarit,18,Rosamorada,18010,20143,19182,39325
2025,Nayarit,18,Ruíz,18011,14529,14104,28633
2025,Nayarit,18,San Blas,18012,27138,24176,51314
2025,Nayarit,18,San Pedro Lagunillas,18013,4471,4325,8796
2025,Nayarit,18,Santa María del Oro,18014,13692,13236,26928
2025,Nayarit,18,Santiago Ixcuintla,18015,57847,55660,113507
2025,Nayarit,18,Tecuala,18016,23364,22589,45953
2025,Nayarit,18,Tepic,18017,231206,242510,473716
2025,Nayarit,18,Tuxpan,18018,17775,17864,35639
2025,Nayarit,18,Xalisco,18008,32376,33610,65986
2025,Nuevo León,19,Abasolo,19001,1495,1498,2993
2025,Nuevo León,19,Agualeguas,19002,1338,1273,2611
2025,Nuevo León,19,Allende,19004,20551,20293,40844
2025,Nuevo León,19,Anáhuac,19005,10491,10589,21080
2025,Nuevo León,19,Apodaca,19006,355639,349187,704826
2025,Nuevo León,19,Aramberri,19007,9707,9497,19204
2025,Nuevo León,19,Bustamante,19008,2364,2348,4712
2025,Nuevo León,19,Cadereyta Jiménez,19009,57087,54699,111786
2025,Nuevo León,19,Cerralvo,19011,4491,4202,8693
2025,Nuevo León,19,China,19013,6565,6250,12815
2025,Nuevo León,19,Ciénega de Flores,19012,28136,27014,55150
2025,Nuevo León,19,Doctor Arroyo,19014,20498,20005,40503
2025,Nuevo León,19,Doctor Coss,19015,1039,1003,2042
2025,Nuevo León,19,Doctor González,19016,1779,1693,3472
2025,Nuevo León,19,El Carmen,19010,26357,25749,52106
2025,Nuevo León,19,Galeana,19017,24361,23783,48144
2025,Nuevo León,19,García,19018,166520,163970,330490
2025,Nuevo León,19,General Bravo,19020,3386,3234,6620
2025,Nuevo León,19,General Escobedo,19021,246398,245316,491714
2025,Nuevo León,19,General Terán,19022,8777,8825,17602
2025,Nuevo León,19,General Treviño,19023,613,640,1253
2025,Nuevo León,19,General Zaragoza,19024,3634,3393,7027
2025,Nuevo León,19,General Zuazua,19025,50873,49854,100727
2025,Nuevo León,19,Guadalupe,19026,377211,369194,746405
2025,Nuevo León,19,Hidalgo,19047,8266,8193,16459
2025,Nuevo León,19,Higueras,19028,943,874,1817
2025,Nuevo León,19,Hualahuises,19029,4128,4176,8304
2025,Nuevo León,19,Iturbide,19030,2216,2045,4261
2025,Nuevo León,19,Juárez,19031,218268,212348,430616
2025,Nuevo León,19,Lampazos de Naranjo,19032,3148,3062,6210
2025,Nuevo León,19,Linares,19033,47226,47231,94457
2025,Nuevo León,19,Los Aldamas,19003,874,855,1729
2025,Nuevo León,19,Los Herreras,19027,1086,1111,2197
2025,Nuevo León,19,Los Ramones,19042,2744,2692,5436
2025,Nuevo León,19,Marín,19034,3340,3139,6479
2025,Nuevo León,19,Melchor Ocampo,19035,603,580,1183
2025,Nuevo León,19,Mier y Noriega,19036,4065,3973,8038
2025,Nuevo León,19,Mina,19037,3160,3012,6172
2025,Nuevo León,19,Montemorelos,19038,36269,36103,72372
2025,Nuevo León,19,Monterrey,19039,587669,614469,1202138
2025,Nuevo León,19,Parás,19040,587,571,1158
2025,Nuevo León,19,Pesquería,19041,62587,61804,124391
2025,Nuevo León,19,Rayones,19043,1685,1569,3254
2025,Nuevo León,19,Sabinas Hidalgo,19044,20436,21187,41623
2025,Nuevo León,19,Salinas Victoria,19045,34215,32631,66846
2025,Nuevo León,19,San Nicolás de los Garza,19046,242895,252792,495687
2025,Nuevo León,19,San Pedro Garza García,19019,69187,77242,146429
2025,Nuevo León,19,Santa Catarina,19048,170472,168457,338929
2025,Nuevo León,19,Santiago,19049,25132,24915,50047
2025,Nuevo León,19,Vallecillo,19050,1139,968,2107
2025,Nuevo León,19,Villaldama,19051,2459,2451,4910
2025,Oaxaca,20,Abejones,20001,429,587,1016
2025,Oaxaca,20,Acatlán de Pérez Figueroa,20002,23866,24902,48768
2025,Oaxaca,20,Asunción Cacalotepec,20003,1067,1142,2209
2025,Oaxaca,20,Asunción Cuyotepeji,20004,494,567,1061
2025,Oaxaca,20,Asunción Ixtaltepec,20005,8127,8239,16366
2025,Oaxaca,20,Asunción Nochixtlán,20006,9541,10724,20265
2025,Oaxaca,20,Asunción Ocotlán,20007,1110,1379,2489
2025,Oaxaca,20,Asunción Tlacolulita,20008,407,432,839
2025,Oaxaca,20,Ayoquezco de Aldama,20398,2140,2400,4540
2025,Oaxaca,20,Ayotzintepec,20009,3786,3841,7627
2025,Oaxaca,20,Calihualá,20011,594,628,1222
2025,Oaxaca,20,Candelaria Loxicha,20012,5393,5688,11081
2025,Oaxaca,20,Capulálpam de Méndez,20247,759,928,1687
2025,Oaxaca,20,Chahuites,20025,6154,6234,12388
2025,Oaxaca,20,Chalcatongo de Hidalgo,20026,4583,5230,9813
2025,Oaxaca,20,Chiquihuitlán de Benito Juárez,20027,1135,1360,2495
2025,Oaxaca,20,Ciudad Ixtepec,20014,15121,16462,31583
2025,Oaxaca,20,Ciénega de Zimatlán,20013,1560,1699,3259
2025,Oaxaca,20,Coatecas Altas,20015,2169,2505,4674
2025,Oaxaca,20,Coicoyán de las Flores,20016,4991,5657,10648
2025,Oaxaca,20,Concepción Buenavista,20018,412,439,851
2025,Oaxaca,20,Concepción Pápalo,20019,1575,1585,3160
2025,Oaxaca,20,Constancia del Rosario,20020,1906,2208,4114
2025,Oaxaca,20,Cosolapa,20021,7983,8639,16622
2025,Oaxaca,20,Cosoltepec,20022,369,436,805
2025,Oaxaca,20,Cuilápam de Guerrero,20023,11533,12201,23734
2025,Oaxaca,20,Cuyamecalco Villa de Zaragoza,20024,1955,1926,3881
2025,Oaxaca,20,El Barrio de la Soledad,20010,7335,7950,15285
2025,Oaxaca,20,El Espinal,20030,4609,4823,9432
2025,Oaxaca,20,Eloxochitlán de Flores Magón,20029,2140,2415,4555
2025,Oaxaca,20,Fresnillo de Trujano,20032,537,575,1112
2025,Oaxaca,20,Guadalupe Etla,20033,1386,1538,2924
2025,Oaxaca,20,Guadalupe de Ramírez,20034,676,688,1364
2025,Oaxaca,20,Guelatao de Juárez,20035,278,291,569
2025,Oaxaca,20,Guevea de Humboldt,20036,2705,2832,5537
2025,Oaxaca,20,Heroica Ciudad de Ejutla de Crespo,20028,10795,12063,22858
2025,Oaxaca,20,Heroica Ciudad de Huajuapan de León,20039,39735,44246,83981
2025,Oaxaca,20,Heroica Ciudad de Juchitán de Zaragoza,20043,51592,54339,105931
2025,Oaxaca,20,Heroica Ciudad de Tlaxiaco,20397,20489,23260,43749
2025,Oaxaca,20,Huautepec,20040,3022,3496,6518
2025,Oaxaca,20,Huautla de Jiménez,20041,15216,17601,32817
2025,Oaxaca,20,Ixpantepec Nieves,20065,541,679,1220
2025,Oaxaca,20,Ixtlán de Juárez,20042,4285,4433,8718
2025,Oaxaca,20,La Compañía,20017,1655,1828,3483
2025,Oaxaca,20,La Pe,20069,1362,1456,2818
2025,Oaxaca,20,La Reforma,20076,1608,1758,3366
2025,Oaxaca,20,La Trinidad Vista Hermosa,20556,123,148,271
2025,Oaxaca,20,Loma Bonita,20044,21913,23994,45907
2025,Oaxaca,20,Magdalena Apasco,20045,4606,5134,9740
2025,Oaxaca,20,Magdalena Jaltepec,20046,1567,1845,3412
2025,Oaxaca,20,Magdalena Mixtepec,20048,687,717,1404
2025,Oaxaca,20,Magdalena Ocotlán,20049,596,641,1237
2025,Oaxaca,20,Magdalena Peñasco,20050,1704,1986,3690
2025,Oaxaca,20,Magdalena Teitipac,20051,2346,2510,4856
2025,Oaxaca,20,Magdalena Tequisistlán,20052,3195,3357,6552
2025,Oaxaca,20,Magdalena Tlacotepec,20053,650,705,1355
2025,Oaxaca,20,Magdalena Yodocono de Porfirio Díaz,20562,807,857,1664
2025,Oaxaca,20,Magdalena Zahuatlán,20054,208,234,442
2025,Oaxaca,20,Mariscala de Juárez,20055,1838,1994,3832
2025,Oaxaca,20,Matías Romero Avendaño,20057,20019,21440,41459
2025,Oaxaca,20,Mazatlán Villa de Flores,20058,6778,6931,13709
2025,Oaxaca,20,Mesones Hidalgo,20037,2134,2525,4659
2025,Oaxaca,20,Miahuatlán de Porfirio Díaz,20059,22472,24710,47182
2025,Oaxaca,20,Mixistlán de la Reforma,20060,1302,1450,2752
2025,Oaxaca,20,Monjas,20061,1359,1602,2961
2025,Oaxaca,20,Mártires de Tacubaya,20056,741,805,1546
2025,Oaxaca,20,Natividad,20062,326,369,695
2025,Oaxaca,20,Nazareno Etla,20063,2079,2289,4368
2025,Oaxaca,20,Nejapa de Madero,20064,3907,4058,7965
2025,Oaxaca,20,Nuevo Zoquiápam,20504,828,893,1721
2025,Oaxaca,20,Oaxaca de Juárez,20067,121946,140198,262144
2025,Oaxaca,20,Ocotlán de Morelos,20068,11262,12251,23513
2025,Oaxaca,20,Pinotepa de Don Luis,20070,3628,3726,7354
2025,Oaxaca,20,Pluma Hidalgo,20071,1493,1559,3052
2025,Oaxaca,20,Putla Villa de Guerrero,20073,16711,18833,35544
2025,Oaxaca,20,Reforma de Pineda,20075,1454,1560,3014
2025,Oaxaca,20,Reyes Etla,20077,2066,2194,4260
2025,Oaxaca,20,Rojas de Cuauhtémoc,20078,563,640,1203
2025,Oaxaca,20,Salina Cruz,20079,45676,49485,95161
2025,Oaxaca,20,San Agustín Amatengo,20080,730,827,1557
2025,Oaxaca,20,San Agustín Atenango,20081,860,980,1840
2025,Oaxaca,20,San Agustín Chayuco,20082,1943,2150,4093
2025,Oaxaca,20,San Agustín Etla,20084,2111,2332,4443
2025,Oaxaca,20,San Agustín Loxicha,20085,12927,13437,26364
2025,Oaxaca,20,San Agustín Tlacotepec,20086,431,583,1014
2025,Oaxaca,20,San Agustín Yatareni,20087,2235,2529,4764
2025,Oaxaca,20,San Agustín de las Juntas,20083,5170,5380,10550
2025,Oaxaca,20,San Andrés Cabecera Nueva,20088,1451,1483,2934
2025,Oaxaca,20,San Andrés Dinicuiti,20089,1090,1150,2240
2025,Oaxaca,20,San Andrés Huaxpaltepec,20090,3162,3345,6507
2025,Oaxaca,20,San Andrés Huayápam,20091,2764,3032,5796
2025,Oaxaca,20,San Andrés Ixtlahuaca,20092,818,924,1742
2025,Oaxaca,20,San Andrés Lagunas,20093,240,283,523
2025,Oaxaca,20,San Andrés Nuxiño,20094,867,953,1820
2025,Oaxaca,20,San Andrés Paxtlán,20095,2290,2294,4584
2025,Oaxaca,20,San Andrés Sinaxtla,20096,374,434,808
2025,Oaxaca,20,San Andrés Solaga,20097,898,955,1853
2025,Oaxaca,20,San Andrés Teotilálpam,20098,2227,2434,4661
2025,Oaxaca,20,San Andrés Tepetlapa,20099,252,289,541
2025,Oaxaca,20,San Andrés Yaá,20100,225,267,492
2025,Oaxaca,20,San Andrés Zabache,20101,335,422,757
2025,Oaxaca,20,San Andrés Zautla,20102,2417,2577,4994
2025,Oaxaca,20,San Antonino Castillo Velasco,20103,3126,3433,6559
2025,Oaxaca,20,San Antonino Monte Verde,20105,3502,4095,7597
2025,Oaxaca,20,San Antonino el Alto,20104,1418,1458,2876
2025,Oaxaca,20,San Antonio Acutla,20106,119,146,265
2025,Oaxaca,20,San Antonio Huitepec,20108,2157,2531,4688
2025,Oaxaca,20,San Antonio Nanahuatípam,20109,652,655,1307
2025,Oaxaca,20,San Antonio Sinicahua,20110,772,894,1666
2025,Oaxaca,20,San Antonio Tepetlapa,20111,2185,2356,4541
2025,Oaxaca,20,San Antonio de la Cal,20107,12461,13898,26359
2025,Oaxaca,20,San Baltazar Chichicápam,20112,1263,1443,2706
2025,Oaxaca,20,San Baltazar Loxicha,20113,1529,1594,3123
2025,Oaxaca,20,San Baltazar Yatzachi el Bajo,20114,330,375,705
2025,Oaxaca,20,San Bartolo Coyotepec,20115,4994,5563,10557
2025,Oaxaca,20,San Bartolo Soyaltepec,20121,313,389,702
2025,Oaxaca,20,San Bartolo Yautepec,20122,347,355,702
2025,Oaxaca,20,San Bartolomé Ayautla,20116,2304,2469,4773
2025,Oaxaca,20,San Bartolomé Loxicha,20117,1185,1232,2417
2025,Oaxaca,20,San Bartolomé Quialana,20118,1065,1516,2581
2025,Oaxaca,20,San Bartolomé Yucuañe,20119,167,241,408
2025,Oaxaca,20,San Bartolomé Zoogocho,20120,134,186,320
2025,Oaxaca,20,San Bernardo Mixtepec,20123,1383,1483,2866
2025,Oaxaca,20,San Blas Atempa,20124,9610,9531,19141
2025,Oaxaca,20,San Carlos Yautepec,20125,6551,6419,12970
2025,Oaxaca,20,San Cristóbal Amatlán,20126,2605,2963,5568
2025,Oaxaca,20,San Cristóbal Amoltepec,20127,524,627,1151
2025,Oaxaca,20,San Cristóbal Lachirioag,20128,659,710,1369
2025,Oaxaca,20,San Cristóbal Suchixtlahuaca,20129,193,205,398
2025,Oaxaca,20,San Dionisio Ocotepec,20131,5333,6038,11371
2025,Oaxaca,20,San Dionisio Ocotlán,20132,611,624,1235
2025,Oaxaca,20,San Dionisio del Mar,20130,2783,2665,5448
2025,Oaxaca,20,San Esteban Atatlahuca,20133,1944,2044,3988
2025,Oaxaca,20,San Felipe Jalapa de Díaz,20134,14144,15158,29302
2025,Oaxaca,20,San Felipe Tejalápam,20135,4043,4425,8468
2025,Oaxaca,20,San Felipe Usila,20136,5839,6339,12178
2025,Oaxaca,20,San Francisco Cahuacuá,20137,1767,1802,3569
2025,Oaxaca,20,San Francisco Cajonos,20138,225,251,476
2025,Oaxaca,20,San Francisco Chapulapa,20139,1045,1126,2171
2025,Oaxaca,20,San Francisco Chindúa,20140,420,447,867
2025,Oaxaca,20,San Francisco Huehuetlán,20142,511,642,1153
2025,Oaxaca,20,San Francisco Ixhuatán,20143,4713,4770,9483
2025,Oaxaca,20,San Francisco Jaltepetongo,20144,524,547,1071
2025,Oaxaca,20,San Francisco Lachigoló,20145,2357,2443,4800
2025,Oaxaca,20,San Francisco Logueche,20146,1445,1667,3112
2025,Oaxaca,20,San Francisco Nuxaño,20147,207,195,402
2025,Oaxaca,20,San Francisco Ozolotepec,20148,961,1025,1986
2025,Oaxaca,20,San Francisco Sola,20149,869,960,1829
2025,Oaxaca,20,San Francisco Telixtlahuaca,20150,6689,7194,13883
2025,Oaxaca,20,San Francisco Teopan,20151,183,166,349
2025,Oaxaca,20,San Francisco Tlapancingo,20152,1067,1350,2417
2025,Oaxaca,20,San Francisco del Mar,20141,4190,4085,8275
2025,Oaxaca,20,San Gabriel Mixtepec,20153,2526,2682,5208
2025,Oaxaca,20,San Ildefonso Amatlán,20154,1243,1424,2667
2025,Oaxaca,20,San Ildefonso Sola,20155,519,512,1031
2025,Oaxaca,20,San Ildefonso Villa Alta,20156,1771,1875,3646
2025,Oaxaca,20,San Jacinto Amilpas,20157,9003,9940,18943
2025,Oaxaca,20,San Jacinto Tlacotepec,20158,1097,1154,2251
2025,Oaxaca,20,San Jerónimo Coatlán,20159,2680,2835,5515
2025,Oaxaca,20,San Jerónimo Silacayoapilla,20160,697,722,1419
2025,Oaxaca,20,San Jerónimo Sosola,20161,1317,1487,2804
2025,Oaxaca,20,San Jerónimo Taviche,20162,974,1053,2027
2025,Oaxaca,20,San Jerónimo Tecóatl,20163,805,907,1712
2025,Oaxaca,20,San Jerónimo Tlacochahuaya,20550,2806,3145,5951
2025,Oaxaca,20,San Jorge Nuchita,20164,1361,1626,2987
2025,Oaxaca,20,San José Ayuquila,20165,760,884,1644
2025,Oaxaca,20,San José Chiltepec,20166,6324,6662,12986
2025,Oaxaca,20,San José Estancia Grande,20168,556,563,1119
2025,Oaxaca,20,San José Independencia,20169,1858,1995,3853
2025,Oaxaca,20,San José Lachiguiri,20170,1629,2029,3658
2025,Oaxaca,20,San José Tenango,20171,9195,10003,19198
2025,Oaxaca,20,San José del Peñasco,20167,1104,1151,2255
2025,Oaxaca,20,San José del Progreso,20072,3494,3698,7192
2025,Oaxaca,20,San Juan Achiutla,20172,216,228,444
2025,Oaxaca,20,San Juan Atepec,20173,759,854,1613
2025,Oaxaca,20,San Juan Bautista Atatlahuca,20175,820,876,1696
2025,Oaxaca,20,San Juan Bautista Coixtlahuaca,20176,1334,1490,2824
2025,Oaxaca,20,San Juan Bautista Cuicatlán,20177,5177,5497,10674
2025,Oaxaca,20,San Juan Bautista Guelache,20178,3907,4375,8282
2025,Oaxaca,20,San Juan Bautista Jayacatlán,20179,821,807,1628
2025,Oaxaca,20,San Juan Bautista Lo de Soto,20180,1375,1404,2779
2025,Oaxaca,20,San Juan Bautista Suchitepec,20181,221,262,483
2025,Oaxaca,20,San Juan Bautista Tlachichilco,20183,679,783,1462
2025,Oaxaca,20,San Juan Bautista Tlacoatzintepec,20182,1064,1185,2249
2025,Oaxaca,20,San Juan Bautista Tuxtepec,20184,83642,90667,174309
2025,Oaxaca,20,San Juan Bautista Valle Nacional,20559,11443,12395,23838
2025,Oaxaca,20,San Juan Cacahuatepec,20185,4643,4859,9502
2025,Oaxaca,20,San Juan Chicomezúchil,20191,168,198,366
2025,Oaxaca,20,San Juan Chilateca,20192,763,888,1651
2025,Oaxaca,20,San Juan Cieneguilla,20186,298,329,627
2025,Oaxaca,20,San Juan Coatzóspam,20187,1095,1079,2174
2025,Oaxaca,20,San Juan Colorado,20188,5111,5444,10555
2025,Oaxaca,20,San Juan Comaltepec,20189,1475,1538,3013
2025,Oaxaca,20,San Juan Cotzocón,20190,12234,12873,25107
2025,Oaxaca,20,San Juan Diuxi,20195,559,581,1140
2025,Oaxaca,20,San Juan Evangelista Analco,20196,220,241,461
2025,Oaxaca,20,San Juan Guelavía,20197,1714,1829,3543
2025,Oaxaca,20,San Juan Guichicovi,20198,14937,16844,31781
2025,Oaxaca,20,San Juan Ihualtepec,20199,305,358,663
2025,Oaxaca,20,San Juan Juquila Mixes,20200,1927,2159,4086
2025,Oaxaca,20,San Juan Juquila Vijanos,20201,985,1082,2067
2025,Oaxaca,20,San Juan Lachao,20202,2445,2618,5063
2025,Oaxaca,20,San Juan Lachigalla,20203,1663,1807,3470
2025,Oaxaca,20,San Juan Lajarcia,20204,314,385,699
2025,Oaxaca,20,San Juan Lalana,20205,8651,9078,17729
2025,Oaxaca,20,San Juan Mazatlán,20207,9757,9857,19614
2025,Oaxaca,20,San Juan Mixtepec Distrito 08,20208,3432,3922,7354
2025,Oaxaca,20,San Juan Mixtepec Distrito 26,20209,285,417,702
2025,Oaxaca,20,San Juan Ozolotepec,20211,1385,1367,2752
2025,Oaxaca,20,San Juan Petlapa,20212,1493,1587,3080
2025,Oaxaca,20,San Juan Quiahije,20213,1917,2186,4103
2025,Oaxaca,20,San Juan Quiotepec,20214,1060,1098,2158
2025,Oaxaca,20,San Juan Sayultepec,20215,404,476,880
2025,Oaxaca,20,San Juan Tabaá,20216,686,750,1436
2025,Oaxaca,20,San Juan Tamazola,20217,1514,1597,3111
2025,Oaxaca,20,San Juan Teita,20218,327,341,668
2025,Oaxaca,20,San Juan Teitipac,20219,1337,1467,2804
2025,Oaxaca,20,San Juan Tepeuxila,20220,1430,1351,2781
2025,Oaxaca,20,San Juan Teposcolula,20221,639,675,1314
2025,Oaxaca,20,San Juan Yaeé,20222,751,848,1599
2025,Oaxaca,20,San Juan Yatzona,20223,212,273,485
2025,Oaxaca,20,San Juan Yucuita,20224,286,341,627
2025,Oaxaca,20,San Juan de los Cués,20206,1261,1288,2549
2025,Oaxaca,20,San Juan del Estado,20193,1384,1502,2886
2025,Oaxaca,20,San Juan del Río,20194,630,751,1381
2025,Oaxaca,20,San Juan Ñumí,20210,2887,3317,6204
2025,Oaxaca,20,San Lorenzo,20225,3110,3354,6464
2025,Oaxaca,20,San Lorenzo Albarradas,20226,1515,1464,2979
2025,Oaxaca,20,San Lorenzo Cacaotepec,20227,8281,8996,17277
2025,Oaxaca,20,San Lorenzo Cuaunecuiltitla,20228,451,409,860
2025,Oaxaca,20,San Lorenzo Texmelúcan,20229,4009,4685,8694
2025,Oaxaca,20,San Lorenzo Victoria,20230,520,540,1060
2025,Oaxaca,20,San Lucas Camotlán,20231,1522,1639,3161
2025,Oaxaca,20,San Lucas Ojitlán,20232,10246,10901,21147
2025,Oaxaca,20,San Lucas Quiaviní,20233,764,1087,1851
2025,Oaxaca,20,San Lucas Zoquiápam,20234,3808,4040,7848
2025,Oaxaca,20,San Luis Amatlán,20235,1785,2108,3893
2025,Oaxaca,20,San Marcial Ozolotepec,20236,752,827,1579
2025,Oaxaca,20,San Marcos Arteaga,20237,631,729,1360
2025,Oaxaca,20,San Martín Huamelúlpam,20239,517,610,1127
2025,Oaxaca,20,San Martín Itunyoso,20240,994,1271,2265
2025,Oaxaca,20,San Martín Lachilá,20241,517,645,1162
2025,Oaxaca,20,San Martín Peras,20242,6022,6517,12539
2025,Oaxaca,20,San Martín Tilcajete,20243,867,1068,1935
2025,Oaxaca,20,San Martín Toxpalan,20244,1966,2083,4049
2025,Oaxaca,20,San Martín Zacatepec,20245,677,697,1374
2025,Oaxaca,20,San Martín de los Cansecos,20238,452,463,915
2025,Oaxaca,20,San Mateo Cajonos,20246,308,368,676
2025,Oaxaca,20,San Mateo Etlatongo,20250,588,626,1214
2025,Oaxaca,20,San Mateo Nejápam,20251,573,628,1201
2025,Oaxaca,20,San Mateo Peñasco,20252,1062,1217,2279
2025,Oaxaca,20,San Mateo Piñas,20253,981,988,1969
2025,Oaxaca,20,San Mateo Río Hondo,20254,1635,1711,3346
2025,Oaxaca,20,San Mateo Sindihui,20255,1019,1136,2155
2025,Oaxaca,20,San Mateo Tlapiltepec,20256,107,130,237
2025,Oaxaca,20,San Mateo Yoloxochitlán,20249,1818,2015,3833
2025,Oaxaca,20,San Mateo Yucutindoo,20566,1586,1622,3208
2025,Oaxaca,20,San Mateo del Mar,20248,8232,7957,16189
2025,Oaxaca,20,San Melchor Betaza,20257,515,596,1111
2025,Oaxaca,20,San Miguel Achiutla,20258,386,433,819
2025,Oaxaca,20,San Miguel Ahuehuetitlán,20259,1206,1336,2542
2025,Oaxaca,20,San Miguel Aloápam,20260,1071,1216,2287
2025,Oaxaca,20,San Miguel Amatitlán,20261,3787,4253,8040
2025,Oaxaca,20,San Miguel Amatlán,20262,505,536,1041
2025,Oaxaca,20,San Miguel Chicahua,20264,1026,1262,2288
2025,Oaxaca,20,San Miguel Chimalapa,20265,3748,3535,7283
2025,Oaxaca,20,San Miguel Coatlán,20263,1582,1864,3446
2025,Oaxaca,20,San Miguel Ejutla,20268,492,577,1069
2025,Oaxaca,20,San Miguel Huautla,20270,540,632,1172
2025,Oaxaca,20,San Miguel Mixtepec,20271,1661,1706,3367
2025,Oaxaca,20,San Miguel Panixtlahuaca,20272,2992,3702,6694
2025,Oaxaca,20,San Miguel Peras,20273,1695,1825,3520
2025,Oaxaca,20,San Miguel Piedras,20274,660,704,1364
2025,Oaxaca,20,San Miguel Quetzaltepec,20275,4453,4385,8838
2025,Oaxaca,20,San Miguel Santa Flor,20276,377,373,750
2025,Oaxaca,20,San Miguel Soyaltepec,20278,19992,21297,41289
2025,Oaxaca,20,San Miguel Suchixtepec,20279,1363,1511,2874
2025,Oaxaca,20,San Miguel Tecomatlán,20281,175,156,331
2025,Oaxaca,20,San Miguel Tenango,20282,393,378,771
2025,Oaxaca,20,San Miguel Tequixtepec,20283,519,568,1087
2025,Oaxaca,20,San Miguel Tilquiápam,20284,1419,1821,3240
2025,Oaxaca,20,San Miguel Tlacamama,20285,1913,1971,3884
2025,Oaxaca,20,San Miguel Tlacotepec,20286,1534,1764,3298
2025,Oaxaca,20,San Miguel Tulancingo,20287,134,203,337
2025,Oaxaca,20,San Miguel Yotao,20288,296,334,630
2025,Oaxaca,20,San Miguel del Puerto,20266,4325,4414,8739
2025,Oaxaca,20,San Miguel del Río,20267,148,139,287
2025,Oaxaca,20,San Miguel el Grande,20269,2165,2451,4616
2025,Oaxaca,20,San Nicolás,20289,562,682,1244
2025,Oaxaca,20,San Nicolás Hidalgo,20290,497,577,1074
2025,Oaxaca,20,San Pablo Coatlán,20291,2174,2275,4449
2025,Oaxaca,20,San Pablo Cuatro Venados,20292,691,784,1475
2025,Oaxaca,20,San Pablo Etla,20293,9438,10482,19920
2025,Oaxaca,20,San Pablo Huitzo,20294,3642,4107,7749
2025,Oaxaca,20,San Pablo Huixtepec,20295,4814,5286,10100
2025,Oaxaca,20,San Pablo Macuiltianguis,20296,472,496,968
2025,Oaxaca,20,San Pablo Tijaltepec,20297,1133,1363,2496
2025,Oaxaca,20,San Pablo Villa de Mitla,20298,6523,7104,13627
2025,Oaxaca,20,San Pablo Yaganiza,20299,530,599,1129
2025,Oaxaca,20,San Pedro Amuzgos,20300,3363,3850,7213
2025,Oaxaca,20,San Pedro Apóstol,20301,759,892,1651
2025,Oaxaca,20,San Pedro Atoyac,20302,2225,2497,4722
2025,Oaxaca,20,San Pedro Cajonos,20303,530,651,1181
2025,Oaxaca,20,San Pedro Comitancillo,20305,2196,2402,4598
2025,Oaxaca,20,San Pedro Coxcaltepec Cántaros,20304,375,418,793
2025,Oaxaca,20,San Pedro Huamelula,20307,5216,5249,10465
2025,Oaxaca,20,San Pedro Huilotepec,20308,1670,1696,3366
2025,Oaxaca,20,San Pedro Ixcatlán,20309,5853,6160,12013
2025,Oaxaca,20,San Pedro Ixtlahuaca,20310,4756,5034,9790
2025,Oaxaca,20,San Pedro Jaltepetongo,20311,285,325,610
2025,Oaxaca,20,San Pedro Jicayán,20312,6227,6857,13084
2025,Oaxaca,20,San Pedro Jocotipac,20313,377,454,831
2025,Oaxaca,20,San Pedro Juchatengo,20314,807,890,1697
2025,Oaxaca,20,San Pedro Mixtepec Distrito 22,20318,25793,27015,52808
2025,Oaxaca,20,San Pedro Mixtepec Distrito 26,20319,552,592,1144
2025,Oaxaca,20,San Pedro Molinos,20320,341,378,719
2025,Oaxaca,20,San Pedro Mártir,20315,772,972,1744
2025,Oaxaca,20,San Pedro Mártir Quiechapa,20316,348,394,742
2025,Oaxaca,20,San Pedro Mártir Yucuxaco,20317,605,712,1317
2025,Oaxaca,20,San Pedro Nopala,20321,365,398,763
2025,Oaxaca,20,San Pedro Ocopetatillo,20322,395,467,862
2025,Oaxaca,20,San Pedro Ocotepec,20323,1074,1156,2230
2025,Oaxaca,20,San Pedro Pochutla,20324,24797,25645,50442
2025,Oaxaca,20,San Pedro Quiatoni,20325,5633,5953,11586
2025,Oaxaca,20,San Pedro Sochiápam,20326,2620,2691,5311
2025,Oaxaca,20,San Pedro Tapanatepec,20327,7728,7902,15630
2025,Oaxaca,20,San Pedro Taviche,20328,627,642,1269
2025,Oaxaca,20,San Pedro Teozacoalco,20329,627,672,1299
2025,Oaxaca,20,San Pedro Teutila,20330,2203,2280,4483
2025,Oaxaca,20,San Pedro Tidaá,20331,456,531,987
2025,Oaxaca,20,San Pedro Topiltepec,20332,185,206,391
2025,Oaxaca,20,San Pedro Totolápam,20333,1340,1486,2826
2025,Oaxaca,20,San Pedro Yaneri,20335,467,500,967
2025,Oaxaca,20,San Pedro Yucunama,20341,103,137,240
2025,Oaxaca,20,San Pedro Yólox,20336,857,932,1789
2025,Oaxaca,20,San Pedro el Alto,20306,1795,1907,3702
2025,Oaxaca,20,San Pedro y San Pablo Ayutla,20337,2525,3025,5550
2025,Oaxaca,20,San Pedro y San Pablo Teposcolula,20339,2108,2344,4452
2025,Oaxaca,20,San Pedro y San Pablo Tequixtepec,20340,845,1033,1878
2025,Oaxaca,20,San Raymundo Jalpan,20342,1790,2148,3938
2025,Oaxaca,20,San Sebastián Abasolo,20343,995,1080,2075
2025,Oaxaca,20,San Sebastián Coatlán,20344,1388,1474,2862
2025,Oaxaca,20,San Sebastián Ixcapa,20345,2166,2215,4381
2025,Oaxaca,20,San Sebastián Nicananduta,20346,671,880,1551
2025,Oaxaca,20,San Sebastián Río Hondo,20347,1912,1945,3857
2025,Oaxaca,20,San Sebastián Tecomaxtlahuaca,20348,4176,4625,8801
2025,Oaxaca,20,San Sebastián Teitipac,20349,956,1135,2091
2025,Oaxaca,20,San Sebastián Tutla,20350,8886,10313,19199
2025,Oaxaca,20,San Simón Almolongas,20351,1399,1609,3008
2025,Oaxaca,20,San Simón Zahuatlán,20352,2196,2248,4444
2025,Oaxaca,20,San Vicente Coatlán,20534,1873,2228,4101
2025,Oaxaca,20,San Vicente Lachixío,20535,1334,1533,2867
2025,Oaxaca,20,San Vicente Nuñú,20536,211,248,459
2025,Oaxaca,20,Santa Ana,20353,1130,1207,2337
2025,Oaxaca,20,Santa Ana Ateixtlahuaca,20354,271,270,541
2025,Oaxaca,20,Santa Ana Cuauhtémoc,20355,367,390,757
2025,Oaxaca,20,Santa Ana Tavela,20357,416,453,869
2025,Oaxaca,20,Santa Ana Tlapacoyan,20358,1063,1147,2210
2025,Oaxaca,20,Santa Ana Yareni,20359,448,510,958
2025,Oaxaca,20,Santa Ana Zegache,20360,1908,2147,4055
2025,Oaxaca,20,Santa Ana del Valle,20356,1086,1139,2225
2025,Oaxaca,20,Santa Catalina Quierí,20361,432,541,973
2025,Oaxaca,20,Santa Catarina Cuixtla,20362,705,884,1589
2025,Oaxaca,20,Santa Catarina Ixtepeji,20363,1339,1446,2785
2025,Oaxaca,20,Santa Catarina Juquila,20364,8014,8528,16542
2025,Oaxaca,20,Santa Catarina Lachatao,20365,561,608,1169
2025,Oaxaca,20,Santa Catarina Loxicha,20366,1963,2033,3996
2025,Oaxaca,20,Santa Catarina Mechoacán,20367,2337,2391,4728
2025,Oaxaca,20,Santa Catarina Minas,20368,1026,1060,2086
2025,Oaxaca,20,Santa Catarina Quiané,20369,1020,1064,2084
2025,Oaxaca,20,Santa Catarina Quioquitani,20074,277,306,583
2025,Oaxaca,20,Santa Catarina Tayata,20370,320,383,703
2025,Oaxaca,20,Santa Catarina Ticuá,20371,514,637,1151
2025,Oaxaca,20,Santa Catarina Yosonotú,20372,809,986,1795
2025,Oaxaca,20,Santa Catarina Zapoquila,20373,183,215,398
2025,Oaxaca,20,Santa Cruz Acatepec,20374,799,874,1673
2025,Oaxaca,20,Santa Cruz Amilpas,20375,6608,7644,14252
2025,Oaxaca,20,Santa Cruz Itundujia,20377,5861,6369,12230
2025,Oaxaca,20,Santa Cruz Mixtepec,20378,1803,1973,3776
2025,Oaxaca,20,Santa Cruz Nundaco,20379,1439,1696,3135
2025,Oaxaca,20,Santa Cruz Papalutla,20380,1124,1187,2311
2025,Oaxaca,20,Santa Cruz Tacache de Mina,20381,1373,1506,2879
2025,Oaxaca,20,Santa Cruz Tacahua,20382,553,623,1176
2025,Oaxaca,20,Santa Cruz Tayata,20383,318,326,644
2025,Oaxaca,20,Santa Cruz Xitla,20384,2432,2686,5118
2025,Oaxaca,20,Santa Cruz Xoxocotlán,20385,48338,54318,102656
2025,Oaxaca,20,Santa Cruz Zenzontepec,20386,9356,9813,19169
2025,Oaxaca,20,Santa Cruz de Bravo,20376,189,204,393
2025,Oaxaca,20,Santa Gertrudis,20387,1474,1570,3044
2025,Oaxaca,20,Santa Inés Yatzeche,20389,419,555,974
2025,Oaxaca,20,Santa Inés de Zaragoza,20569,804,924,1728
2025,Oaxaca,20,Santa Inés del Monte,20388,1225,1280,2505
2025,Oaxaca,20,Santa Lucía Miahuatlán,20391,1751,1852,3603
2025,Oaxaca,20,Santa Lucía Monteverde,20392,3256,3571,6827
2025,Oaxaca,20,Santa Lucía Ocotlán,20393,1858,2205,4063
2025,Oaxaca,20,Santa Lucía del Camino,20390,25223,27559,52782
2025,Oaxaca,20,Santa Magdalena Jicotlán,20047,45,58,103
2025,Oaxaca,20,Santa María Alotepec,20394,1470,1506,2976
2025,Oaxaca,20,Santa María Apazco,20395,819,1049,1868
2025,Oaxaca,20,Santa María Atzompa,20399,18680,20061,38741
2025,Oaxaca,20,Santa María Camotlán,20400,818,949,1767
2025,Oaxaca,20,Santa María Chachoápam,20404,371,420,791
2025,Oaxaca,20,Santa María Chilchotla,20406,10392,10819,21211
2025,Oaxaca,20,Santa María Chimalapa,20407,4828,4669,9497
2025,Oaxaca,20,Santa María Colotepec,20401,12772,12967,25739
2025,Oaxaca,20,Santa María Cortijo,20402,544,579,1123
2025,Oaxaca,20,Santa María Coyotepec,20403,1594,1770,3364
2025,Oaxaca,20,Santa María Ecatepec,20410,1767,1804,3571
2025,Oaxaca,20,Santa María Guelacé,20411,393,484,877
2025,Oaxaca,20,Santa María Guienagati,20412,1643,1646,3289
2025,Oaxaca,20,Santa María Huatulco,20413,23461,24328,47789
2025,Oaxaca,20,Santa María Huazolotitlán,20414,6008,6162,12170
2025,Oaxaca,20,Santa María Ipalapa,20415,2514,2773,5287
2025,Oaxaca,20,Santa María Ixcatlán,20416,248,279,527
2025,Oaxaca,20,Santa María Jacatepec,20417,4608,5137,9745
2025,Oaxaca,20,Santa María Jalapa del Marqués,20418,6862,7239,14101
2025,Oaxaca,20,Santa María Jaltianguis,20419,253,304,557
2025,Oaxaca,20,Santa María Lachixío,20420,961,1126,2087
2025,Oaxaca,20,Santa María Mixtequilla,20421,2415,2558,4973
2025,Oaxaca,20,Santa María Nativitas,20422,288,350,638
2025,Oaxaca,20,Santa María Nduayaco,20423,264,264,528
2025,Oaxaca,20,Santa María Ozolotepec,20424,1925,2053,3978
2025,Oaxaca,20,Santa María Petapa,20427,8460,9079,17539
2025,Oaxaca,20,Santa María Peñoles,20426,4354,4599,8953
2025,Oaxaca,20,Santa María Pápalo,20425,1115,1112,2227
2025,Oaxaca,20,Santa María Quiegolani,20428,1040,1021,2061
2025,Oaxaca,20,Santa María Sola,20429,751,812,1563
2025,Oaxaca,20,Santa María Tataltepec,20430,204,220,424
2025,Oaxaca,20,Santa María Tecomavaca,20431,853,916,1769
2025,Oaxaca,20,Santa María Temaxcalapa,20432,479,499,978
2025,Oaxaca,20,Santa María Temaxcaltepec,20433,1249,1426,2675
2025,Oaxaca,20,Santa María Teopoxco,20434,2055,2359,4414
2025,Oaxaca,20,Santa María Tepantlali,20435,1976,2054,4030
2025,Oaxaca,20,Santa María Texcatitlán,20436,501,546,1047
2025,Oaxaca,20,Santa María Tlahuitoltepec,20437,4694,5049,9743
2025,Oaxaca,20,Santa María Tlalixtac,20438,868,921,1789
2025,Oaxaca,20,Santa María Tonameca,20439,13350,13532,26882
2025,Oaxaca,20,Santa María Totolapilla,20440,412,457,869
2025,Oaxaca,20,Santa María Xadani,20441,4724,4640,9364
2025,Oaxaca,20,Santa María Yalina,20442,134,160,294
2025,Oaxaca,20,Santa María Yavesía,20443,244,305,549
2025,Oaxaca,20,Santa María Yolotepec,20444,207,226,433
2025,Oaxaca,20,Santa María Yosoyúa,20445,877,865,1742
2025,Oaxaca,20,Santa María Yucuhiti,20446,3154,3463,6617
2025,Oaxaca,20,Santa María Zacatepec,20447,8002,8973,16975
2025,Oaxaca,20,Santa María Zaniza,20448,1121,1187,2308
2025,Oaxaca,20,Santa María Zoquitlán,20449,1588,1627,3215
2025,Oaxaca,20,Santa María del Rosario,20408,275,257,532
2025,Oaxaca,20,Santa María del Tule,20409,4500,5169,9669
2025,Oaxaca,20,Santa María la Asunción,20396,1522,1942,3464
2025,Oaxaca,20,Santiago Amoltepec,20450,6383,6817,13200
2025,Oaxaca,20,Santiago Apoala,20451,446,528,974
2025,Oaxaca,20,Santiago Apóstol,20452,1869,2318,4187
2025,Oaxaca,20,Santiago Astata,20453,2106,2124,4230
2025,Oaxaca,20,Santiago Atitlán,20454,1593,1542,3135
2025,Oaxaca,20,Santiago Ayuquililla,20455,1371,1505,2876
2025,Oaxaca,20,Santiago Cacaloxtepec,20456,826,897,1723
2025,Oaxaca,20,Santiago Camotlán,20457,1651,1664,3315
2025,Oaxaca,20,Santiago Chazumba,20459,2138,2682,4820
2025,Oaxaca,20,Santiago Choápam,20460,2617,2790,5407
2025,Oaxaca,20,Santiago Comaltepec,20458,477,526,1003
2025,Oaxaca,20,Santiago Huajolotitlán,20462,2033,2406,4439
2025,Oaxaca,20,Santiago Huauclilla,20463,262,292,554
2025,Oaxaca,20,Santiago Ihuitlán Plumas,20464,164,208,372
2025,Oaxaca,20,Santiago Ixcuintepec,20465,843,867,1710
2025,Oaxaca,20,Santiago Ixtayutla,20466,6554,6917,13471
2025,Oaxaca,20,Santiago Jamiltepec,20467,9672,10500,20172
2025,Oaxaca,20,Santiago Jocotepec,20468,7255,7427,14682
2025,Oaxaca,20,Santiago Juxtlahuaca,20469,18143,20059,38202
2025,Oaxaca,20,Santiago Lachiguiri,20470,2439,2488,4927
2025,Oaxaca,20,Santiago Lalopa,20471,260,274,534
2025,Oaxaca,20,Santiago Laollaga,20472,1836,1852,3688
2025,Oaxaca,20,Santiago Laxopa,20473,659,739,1398
2025,Oaxaca,20,Santiago Llano Grande,20474,1737,1755,3492
2025,Oaxaca,20,Santiago Matatlán,20475,4916,5571,10487
2025,Oaxaca,20,Santiago Miltepec,20476,223,225,448
2025,Oaxaca,20,Santiago Minas,20477,713,731,1444
2025,Oaxaca,20,Santiago Nacaltepec,20478,890,994,1884
2025,Oaxaca,20,Santiago Nejapilla,20479,120,107,227
2025,Oaxaca,20,Santiago Niltepec,20066,2856,2903,5759
2025,Oaxaca,20,Santiago Nundiche,20480,466,515,981
2025,Oaxaca,20,Santiago Nuyoó,20481,857,953,1810
2025,Oaxaca,20,Santiago Pinotepa Nacional,20482,27638,28973,56611
2025,Oaxaca,20,Santiago Suchilquitongo,20483,5438,5848,11286
2025,Oaxaca,20,Santiago Tamazola,20484,2217,2527,4744
2025,Oaxaca,20,Santiago Tapextla,20485,1650,1591,3241
2025,Oaxaca,20,Santiago Tenango,20487,1093,1093,2186
2025,Oaxaca,20,Santiago Tepetlapa,20488,58,70,128
2025,Oaxaca,20,Santiago Tetepec,20489,2555,2586,5141
2025,Oaxaca,20,Santiago Texcalcingo,20490,1571,1691,3262
2025,Oaxaca,20,Santiago Textitlán,20491,2305,2310,4615
2025,Oaxaca,20,Santiago Tilantongo,20492,1402,1657,3059
2025,Oaxaca,20,Santiago Tillo,20493,271,314,585
2025,Oaxaca,20,Santiago Tlazoyaltepec,20494,2289,2718,5007
2025,Oaxaca,20,Santiago Xanica,20495,1593,1578,3171
2025,Oaxaca,20,Santiago Xiacuí,20496,1069,1171,2240
2025,Oaxaca,20,Santiago Yaitepec,20497,2075,2466,4541
2025,Oaxaca,20,Santiago Yaveo,20498,3698,3662,7360
2025,Oaxaca,20,Santiago Yolomécatl,20499,1048,1231,2279
2025,Oaxaca,20,Santiago Yosondúa,20500,4249,4771,9020
2025,Oaxaca,20,Santiago Yucuyachi,20501,480,521,1001
2025,Oaxaca,20,Santiago Zacatepec,20502,2751,2846,5597
2025,Oaxaca,20,Santiago Zoochila,20503,194,214,408
2025,Oaxaca,20,Santiago del Río,20461,285,314,599
2025,Oaxaca,20,Santo Domingo Albarradas,20506,382,442,824
2025,Oaxaca,20,Santo Domingo Armenta,20507,1808,1817,3625
2025,Oaxaca,20,Santo Domingo Chihuitán,20508,799,828,1627
2025,Oaxaca,20,Santo Domingo Ingenio,20505,4294,4314,8608
2025,Oaxaca,20,Santo Domingo Ixcatlán,20510,289,347,636
2025,Oaxaca,20,Santo Domingo Nuxaá,20511,1629,1736,3365
2025,Oaxaca,20,Santo Domingo Ozolotepec,20512,397,430,827
2025,Oaxaca,20,Santo Domingo Petapa,20513,4964,4880,9844
2025,Oaxaca,20,Santo Domingo Roayaga,20514,519,563,1082
2025,Oaxaca,20,Santo Domingo Tehuantepec,20515,34001,35872,69873
2025,Oaxaca,20,Santo Domingo Teojomulco,20516,2599,2719,5318
2025,Oaxaca,20,Santo Domingo Tepuxtepec,20517,2856,3253,6109
2025,Oaxaca,20,Santo Domingo Tlatayápam,20518,70,80,150
2025,Oaxaca,20,Santo Domingo Tomaltepec,20519,1568,1614,3182
2025,Oaxaca,20,Santo Domingo Tonaltepec,20521,114,143,257
2025,Oaxaca,20,Santo Domingo Tonalá,20520,3478,3873,7351
2025,Oaxaca,20,Santo Domingo Xagacía,20522,582,669,1251
2025,Oaxaca,20,Santo Domingo Yanhuitlán,20523,790,887,1677
2025,Oaxaca,20,Santo Domingo Yodohino,20524,151,160,311
2025,Oaxaca,20,Santo Domingo Zanatepec,20525,6483,6559,13042
2025,Oaxaca,20,Santo Domingo de Morelos,20509,5513,6144,11657
2025,Oaxaca,20,Santo Tomás Jalieza,20530,1816,2001,3817
2025,Oaxaca,20,Santo Tomás Mazaltepec,20531,1376,1498,2874
2025,Oaxaca,20,Santo Tomás Ocotepec,20532,1869,2146,4015
2025,Oaxaca,20,Santo Tomás Tamazulapan,20533,1167,1240,2407
2025,Oaxaca,20,Santos Reyes Nopala,20526,9062,9673,18735
2025,Oaxaca,20,Santos Reyes Pápalo,20527,1319,1433,2752
2025,Oaxaca,20,Santos Reyes Tepejillo,20528,443,593,1036
2025,Oaxaca,20,Santos Reyes Yucuná,20529,663,670,1333
2025,Oaxaca,20,Silacayoápam,20537,3391,3843,7234
2025,Oaxaca,20,Sitio de Xitlapehua,20538,342,387,729
2025,Oaxaca,20,Soledad Etla,20539,3011,3159,6170
2025,Oaxaca,20,Tamazulápam del Espíritu Santo,20031,3553,4326,7879
2025,Oaxaca,20,Tanetze de Zaragoza,20541,839,912,1751
2025,Oaxaca,20,Taniche,20542,397,478,875
2025,Oaxaca,20,Tataltepec de Valdés,20543,2966,3120,6086
2025,Oaxaca,20,Teococuilco de Marcos Pérez,20544,441,534,975
2025,Oaxaca,20,Teotitlán de Flores Magón,20545,5028,5614,10642
2025,Oaxaca,20,Teotitlán del Valle,20546,2960,3283,6243
2025,Oaxaca,20,Teotongo,20547,473,561,1034
2025,Oaxaca,20,Tepelmeme Villa de Morelos,20548,797,957,1754
2025,Oaxaca,20,Tlacolula de Matamoros,20551,11835,13326,25161
2025,Oaxaca,20,Tlacotepec Plumas,20552,229,252,481
2025,Oaxaca,20,Tlalixtac de Cabrera,20553,5352,5926,11278
2025,Oaxaca,20,Totontepec Villa de Morelos,20554,2734,2963,5697
2025,Oaxaca,20,Trinidad Zaachila,20555,1511,1682,3193
2025,Oaxaca,20,Unión Hidalgo,20557,8130,8583,16713
2025,Oaxaca,20,Valerio Trujano,20558,676,826,1502
2025,Oaxaca,20,Villa Díaz Ordaz,20560,3329,3949,7278
2025,Oaxaca,20,Villa Hidalgo,20038,980,1087,2067
2025,Oaxaca,20,Villa Sola de Vega,20277,6366,6498,12864
2025,Oaxaca,20,Villa Talea de Castro,20280,1163,1276,2439
2025,Oaxaca,20,Villa Tejúpam de la Unión,20486,1270,1367,2637
2025,Oaxaca,20,Villa Tezoatlán de Segura y Luna,20549,5366,6307,11673
2025,Oaxaca,20,Villa de Chilapa de Díaz,20405,1028,1304,2332
2025,Oaxaca,20,Villa de Etla,20338,5648,6236,11884
2025,Oaxaca,20,Villa de Tamazulápam del Progreso,20540,3894,4373,8267
2025,Oaxaca,20,Villa de Tututepec de Melchor Ocampo,20334,23584,24534,48118
2025,Oaxaca,20,Villa de Zaachila,20565,23395,25564,48959
2025,Oaxaca,20,Yaxe,20561,1446,1564,3010
2025,Oaxaca,20,Yogana,20563,616,724,1340
2025,Oaxaca,20,Yutanduchi de Guerrero,20564,583,647,1230
2025,Oaxaca,20,Zapotitlán Lagunas,20567,1578,1768,3346
2025,Oaxaca,20,Zapotitlán Palmas,20568,688,845,1533
2025,Oaxaca,20,Zimatlán de Álvarez,20570,10023,11386,21409
2025,Oaxaca,20,Ánimas Trujano,20174,2063,2285,4348
2025,Puebla,21,Acajete,21001,34868,37093,71961
2025,Puebla,21,Acateno,21002,5127,5059,10186
2025,Puebla,21,Acatlán,21003,18219,21115,39334
2025,Puebla,21,Acatzingo,21004,31992,33132,65124
2025,Puebla,21,Acteopan,21005,1539,1720,3259
2025,Puebla,21,Ahuacatlán,21006,8302,9218,17520
2025,Puebla,21,Ahuatlán,21007,1700,1837,3537
2025,Puebla,21,Ahuazotepec,21008,6235,6414,12649
2025,Puebla,21,Ahuehuetitla,21009,912,1045,1957
2025,Puebla,21,Ajalpan,21010,35388,37281,72669
2025,Puebla,21,Albino Zertuche,21011,918,1072,1990
2025,Puebla,21,Aljojuca,21012,3477,3801,7278
2025,Puebla,21,Altepexi,21013,11532,12085,23617
2025,Puebla,21,Amixtlán,21014,2583,2854,5437
2025,Puebla,21,Amozoc,21015,64849,67462,132311
2025,Puebla,21,Aquixtla,21016,4827,4851,9678
2025,Puebla,21,Atempan,21017,14686,16481,31167
2025,Puebla,21,Atexcal,21018,2015,2170,4185
2025,Puebla,21,Atlequizayan,21080,1361,1529,2890
2025,Puebla,21,Atlixco,21019,71219,79344,150563
2025,Puebla,21,Atoyatempan,21020,3737,3950,7687
2025,Puebla,21,Atzala,21021,689,760,1449
2025,Puebla,21,Atzitzihuacán,21022,6347,7224,13571
2025,Puebla,21,Atzitzintla,21023,5011,5097,10108
2025,Puebla,21,Axutla,21024,492,568,1060
2025,Puebla,21,Ayotoxco de Guerrero,21025,4660,4802,9462
2025,Puebla,21,Calpan,21026,7643,8417,16060
2025,Puebla,21,Caltepec,21027,2009,2309,4318
2025,Puebla,21,Camocuautla,21028,1445,1469,2914
2025,Puebla,21,Caxhuacan,21029,1934,2134,4068
2025,Puebla,21,Cañada Morelos,21099,10252,10902,21154
2025,Puebla,21,Chalchicomula de Sesma,21045,25253,27367,52620
2025,Puebla,21,Chapulco,21046,4156,4448,8604
2025,Puebla,21,Chiautla,21047,10724,11384,22108
2025,Puebla,21,Chiautzingo,21048,10725,11760,22485
2025,Puebla,21,Chichiquila,21050,13685,14589,28274
2025,Puebla,21,Chiconcuautla,21049,8966,9354,18320
2025,Puebla,21,Chietla,21051,18463,19731,38194
2025,Puebla,21,Chigmecatitlán,21052,607,719,1326
2025,Puebla,21,Chignahuapan,21053,34168,35256,69424
2025,Puebla,21,Chignautla,21054,18271,19355,37626
2025,Puebla,21,Chila,21055,2394,2681,5075
2025,Puebla,21,Chila de la Sal,21056,781,837,1618
2025,Puebla,21,Chilchotla,21058,10826,10820,21646
2025,Puebla,21,Chinantla,21059,1176,1323,2499
2025,Puebla,21,Coatepec,21030,397,443,840
2025,Puebla,21,Coatzingo,21031,1537,1702,3239
2025,Puebla,21,Cohetzala,21032,757,746,1503
2025,Puebla,21,Cohuecan,21033,2577,2796,5373
2025,Puebla,21,Coronango,21034,22311,23053,45364
2025,Puebla,21,Coxcatlán,21035,10774,11883,22657
2025,Puebla,21,Coyomeapan,21036,7265,7986,15251
2025,Puebla,21,Coyotepec,21037,1195,1406,2601
2025,Puebla,21,Cuapiaxtla de Madero,21038,5586,5612,11198
2025,Puebla,21,Cuautempan,21039,4950,5314,10264
2025,Puebla,21,Cuautinchán,21040,5667,5701,11368
2025,Puebla,21,Cuautlancingo,21041,66289,69746,136035
2025,Puebla,21,Cuayuca de Andrade,21042,1678,1789,3467
2025,Puebla,21,Cuetzalan del Progreso,21043,25776,27127,52903
2025,Puebla,21,Cuyoaco,21044,8309,9008,17317
2025,Puebla,21,Domingo Arenas,21060,3943,4374,8317
2025,Puebla,21,Eloxochitlán,21061,6724,7154,13878
2025,Puebla,21,Epatlán,21062,2603,2739,5342
2025,Puebla,21,Esperanza,21063,7974,8479,16453
2025,Puebla,21,Francisco Z. Mena,21064,9561,9382,18943
2025,Puebla,21,General Felipe Ángeles,21065,10964,11863,22827
2025,Puebla,21,Guadalupe,21066,2951,3405,6356
2025,Puebla,21,Guadalupe Victoria,21067,9138,9618,18756
2025,Puebla,21,Hermenegildo Galeana,21068,4204,4281,8485
2025,Puebla,21,Honey,21057,4216,4558,8774
2025,Puebla,21,Huaquechula,21069,12802,14465,27267
2025,Puebla,21,Huatlatlauca,21070,3299,3954,7253
2025,Puebla,21,Huauchinango,21071,55152,61050,116202
2025,Puebla,21,Huehuetla,21072,10235,10528,20763
2025,Puebla,21,Huehuetlán el Chico,21073,4569,4780,9349
2025,Puebla,21,Huehuetlán el Grande,21150,3900,4136,8036
2025,Puebla,21,Huejotzingo,21074,40246,42038,82284
2025,Puebla,21,Hueyapan,21075,6766,7204,13970
2025,Puebla,21,Hueytamalco,21076,14182,14537,28719
2025,Puebla,21,Hueytlalpan,21077,2932,3074,6006
2025,Puebla,21,Huitzilan de Serdán,21078,8361,8172,16533
2025,Puebla,21,Huitziltepec,21079,2920,3131,6051
2025,Puebla,21,Ixcamilpa de Guerrero,21081,1887,2081,3968
2025,Puebla,21,Ixcaquixtla,21082,4720,5172,9892
2025,Puebla,21,Ixtacamaxtitlán,21083,13204,13495,26699
2025,Puebla,21,Ixtepec,21084,3765,3988,7753
2025,Puebla,21,Izúcar de Matamoros,21085,40835,45379,86214
2025,Puebla,21,Jalpan,21086,6367,6853,13220
2025,Puebla,21,Jolalpan,21087,6934,7440,14374
2025,Puebla,21,Jonotla,21088,2461,2560,5021
2025,Puebla,21,Jopala,21089,7008,7309,14317
2025,Puebla,21,Juan C. Bonilla,21090,11422,12401,23823
2025,Puebla,21,Juan Galindo,21091,5540,6333,11873
2025,Puebla,21,Juan N. Méndez,21092,2879,2932,5811
2025,Puebla,21,La Magdalena Tlatlauquitepec,21095,316,310,626
2025,Puebla,21,Lafragua,21093,4326,4452,8778
2025,Puebla,21,Libres,21094,18271,19220,37491
2025,Puebla,21,Los Reyes de Juárez,21118,14854,15263,30117
2025,Puebla,21,Mazapiltepec de Juárez,21096,1568,1585,3153
2025,Puebla,21,Mixtla,21097,1232,1372,2604
2025,Puebla,21,Molcaxac,21098,3176,3564,6740
2025,Puebla,21,Naupan,21100,5187,5674,10861
2025,Puebla,21,Nauzontla,21101,1803,2018,3821
2025,Puebla,21,Nealtican,21102,6554,7118,13672
2025,Puebla,21,Nicolás Bravo,21103,3356,3571,6927
2025,Puebla,21,Nopalucan,21104,17027,17421,34448
2025,Puebla,21,Ocotepec,21105,2544,2744,5288
2025,Puebla,21,Ocoyucan,21106,14703,16499,31202
2025,Puebla,21,Olintla,21107,6244,6559,12803
2025,Puebla,21,Oriental,21108,9854,10423,20277
2025,Puebla,21,Pahuatlán,21109,11624,12812,24436
2025,Puebla,21,Palmar de Bravo,21110,25136,25546,50682
2025,Puebla,21,Pantepec,21111,9877,10461,20338
2025,Puebla,21,Petlalcingo,21112,5032,5729,10761
2025,Puebla,21,Piaxtla,21113,2362,2561,4923
2025,Puebla,21,Puebla,21114,846631,921339,1767970
2025,Puebla,21,Quecholac,21115,27519,28438,55957
2025,Puebla,21,Quimixtlán,21116,11910,12228,24138
2025,Puebla,21,Rafael Lara Grajales,21117,7302,7818,15120
2025,Puebla,21,San Andrés Cholula,21119,81888,83458,165346
2025,Puebla,21,San Antonio Cañada,21120,2866,3214,6080
2025,Puebla,21,San Diego la Mesa Tochimiltzingo,21121,657,660,1317
2025,Puebla,21,San Felipe Teotlalcingo,21122,5620,5974,11594
2025,Puebla,21,San Felipe Tepatlán,21123,2108,2182,4290
2025,Puebla,21,San Gabriel Chilac,21124,8258,9158,17416
2025,Puebla,21,San Gregorio Atzompa,21125,4936,5196,10132
2025,Puebla,21,San Jerónimo Tecuanipan,21126,3305,3627,6932
2025,Puebla,21,San Jerónimo Xayacatlán,21127,1772,2037,3809
2025,Puebla,21,San José Chiapa,21128,4813,4902,9715
2025,Puebla,21,San José Miahuatlán,21129,7078,7678,14756
2025,Puebla,21,San Juan Atenco,21130,1711,1975,3686
2025,Puebla,21,San Juan Atzompa,21131,502,471,973
2025,Puebla,21,San Martín Texmelucan,21132,81809,87459,169268
2025,Puebla,21,San Martín Totoltepec,21133,322,349,671
2025,Puebla,21,San Matías Tlalancaleca,21134,11133,11484,22617
2025,Puebla,21,San Miguel Ixitlán,21135,268,297,565
2025,Puebla,21,San Miguel Xoxtla,21136,6755,7120,13875
2025,Puebla,21,San Nicolás Buenos Aires,21137,5353,5580,10933
2025,Puebla,21,San Nicolás de los Ranchos,21138,6446,6682,13128
2025,Puebla,21,San Pablo Anicano,21139,1886,2056,3942
2025,Puebla,21,San Pedro Cholula,21140,70029,75840,145869
2025,Puebla,21,San Pedro Yeloixtlahuaca,21141,1763,1906,3669
2025,Puebla,21,San Salvador Huixcolotla,21144,8173,8283,16456
2025,Puebla,21,San Salvador el Seco,21142,16454,17291,33745
2025,Puebla,21,San Salvador el Verde,21143,17286,17803,35089
2025,Puebla,21,San Sebastián Tlacotepec,21145,7536,7635,15171
2025,Puebla,21,Santa Catarina Tlaltempan,21146,447,447,894
2025,Puebla,21,Santa Inés Ahuatempan,21147,3368,3695,7063
2025,Puebla,21,Santa Isabel Cholula,21148,4637,5020,9657
2025,Puebla,21,Santiago Miahuatlán,21149,13892,14611,28503
2025,Puebla,21,Santo Tomás Hueyotlipan,21151,4574,4912,9486
2025,Puebla,21,Soltepec,21152,6704,7005,13709
2025,Puebla,21,Tecali de Herrera,21153,12011,12595,24606
2025,Puebla,21,Tecamachalco,21154,41288,43662,84950
2025,Puebla,21,Tecomatlán,21155,3064,3197,6261
2025,Puebla,21,Tehuacán,21156,167704,186350,354054
2025,Puebla,21,Tehuitzingo,21157,5908,6582,12490
2025,Puebla,21,Tenampulco,21158,3918,4067,7985
2025,Puebla,21,Teopantlán,21159,1838,2288,4126
2025,Puebla,21,Teotlalco,21160,1707,1781,3488
2025,Puebla,21,Tepanco de López,21161,10795,11914,22709
2025,Puebla,21,Tepango de Rodríguez,21162,2125,2367,4492
2025,Puebla,21,Tepatlaxco de Hidalgo,21163,9374,9843,19217
2025,Puebla,21,Tepeaca,21164,42671,46263,88934
2025,Puebla,21,Tepemaxalco,21165,570,601,1171
2025,Puebla,21,Tepeojuma,21166,4413,5101,9514
2025,Puebla,21,Tepetzintla,21167,6088,6513,12601
2025,Puebla,21,Tepexco,21168,3629,3798,7427
2025,Puebla,21,Tepexi de Rodríguez,21169,11707,11729,23436
2025,Puebla,21,Tepeyahualco,21170,9284,9431,18715
2025,Puebla,21,Tepeyahualco de Cuauhtémoc,21171,1902,2066,3968
2025,Puebla,21,Tetela de Ocampo,21172,15125,16192,31317
2025,Puebla,21,Teteles de Ávila Castillo,21173,2963,3495,6458
2025,Puebla,21,Teziutlán,21174,51572,57425,108997
2025,Puebla,21,Tianguismanalco,21175,6842,7345,14187
2025,Puebla,21,Tilapa,21176,4560,4880,9440
2025,Puebla,21,Tlachichuca,21179,15841,16417,32258
2025,Puebla,21,Tlacotepec de Benito Juárez,21177,27360,29709,57069
2025,Puebla,21,Tlacuilotepec,21178,9012,9311,18323
2025,Puebla,21,Tlahuapan,21180,21991,22184,44175
2025,Puebla,21,Tlaltenango,21181,3883,3945,7828
2025,Puebla,21,Tlanepantla,21182,2620,2828,5448
2025,Puebla,21,Tlaola,21183,10658,11312,21970
2025,Puebla,21,Tlapacoya,21184,3486,3630,7116
2025,Puebla,21,Tlapanalá,21185,4454,4837,9291
2025,Puebla,21,Tlatlauquitepec,21186,28450,31340,59790
2025,Puebla,21,Tlaxco,21187,2946,2963,5909
2025,Puebla,21,Tochimilco,21188,9497,10482,19979
2025,Puebla,21,Tochtepec,21189,11245,12068,23313
2025,Puebla,21,Totoltepec de Guerrero,21190,621,751,1372
2025,Puebla,21,Tulcingo,21191,4829,5524,10353
2025,Puebla,21,Tuzamapan de Galeana,21192,3491,3646,7137
2025,Puebla,21,Tzicatlacoyan,21193,3875,3949,7824
2025,Puebla,21,Venustiano Carranza,21194,15773,16862,32635
2025,Puebla,21,Vicente Guerrero,21195,12871,13897,26768
2025,Puebla,21,Xayacatlán de Bravo,21196,803,960,1763
2025,Puebla,21,Xicotepec,21197,43168,46352,89520
2025,Puebla,21,Xicotlán,21198,632,698,1330
2025,Puebla,21,Xiutetelco,21199,21249,22869,44118
2025,Puebla,21,Xochiapulco,21200,1765,1952,3717
2025,Puebla,21,Xochiltepec,21201,1665,1994,3659
2025,Puebla,21,Xochitlán Todos Santos,21203,3392,3746,7138
2025,Puebla,21,Xochitlán de Vicente Suárez,21202,6696,7206,13902
2025,Puebla,21,Yaonáhuac,21204,4199,4618,8817
2025,Puebla,21,Yehualtepec,21205,13380,14030,27410
2025,Puebla,21,Zacapala,21206,2325,2596,4921
2025,Puebla,21,Zacapoaxtla,21207,29013,31949,60962
2025,Puebla,21,Zacatlán,21208,43590,48114,91704
2025,Puebla,21,Zapotitlán,21209,4295,5106,9401
2025,Puebla,21,Zapotitlán de Méndez,21210,3080,3116,6196
2025,Puebla,21,Zaragoza,21211,8273,9685,17958
2025,Puebla,21,Zautla,21212,9782,11134,20916
2025,Puebla,21,Zihuateutla,21213,7115,7503,14618
2025,Puebla,21,Zinacatepec,21214,9038,9857,18895
2025,Puebla,21,Zongozotla,21215,2709,2766,5475
2025,Puebla,21,Zoquiapan,21216,1245,1416,2661
2025,Puebla,21,Zoquitlán,21217,9745,10353,20098
2025,Querétaro,22,Amealco de Bonfil,22001,35525,37636,73161
2025,Querétaro,22,Arroyo Seco,22003,7827,8364,16191
2025,Querétaro,22,Cadereyta de Montes,22004,39888,43154,83042
2025,Querétaro,22,Colón,22005,37420,36629,74049
2025,Querétaro,22,Corregidora,22006,112286,118758,231044
2025,Querétaro,22,El Marqués,22011,99657,97596,197253
2025,Querétaro,22,Ezequiel Montes,22007,23944,25485,49429
2025,Querétaro,22,Huimilpan,22008,21777,23601,45378
2025,Querétaro,22,Jalpan de Serra,22009,15313,16763,32076
2025,Querétaro,22,Landa de Matamoros,22010,10428,11301,21729
2025,Querétaro,22,Pedro Escobedo,22012,40867,41404,82271
2025,Querétaro,22,Peñamiller,22013,11817,12088,23905
2025,Querétaro,22,Pinal de Amoles,22002,14580,15471,30051
2025,Querétaro,22,Querétaro,22014,523688,531408,1055096
2025,Querétaro,22,San Joaquín,22015,5219,5911,11130
2025,Querétaro,22,San Juan del Río,22016,160472,166483,326955
2025,Querétaro,22,Tequisquiapan,22017,41978,43580,85558
2025,Querétaro,22,Tolimán,22018,16623,17266,33889
2025,Quintana Roo,23,Bacalar,23010,25493,25220,50713
2025,Quintana Roo,23,Benito Juárez,23005,467981,462275,930256
2025,Quintana Roo,23,Cozumel,23001,56642,56683,113325
2025,Quintana Roo,23,Felipe Carrillo Puerto,23002,52395,51981,104376
2025,Quintana Roo,23,Isla Mujeres,23003,13877,12746,26623
2025,Quintana Roo,23,José María Morelos,23006,24611,23169,47780
2025,Quintana Roo,23,Lázaro Cárdenas,23007,18028,17199,35227
2025,Quintana Roo,23,Othón P. Blanco,23004,144629,150581,295210
2025,Quintana Roo,23,Solidaridad,23008,138191,125341,263532
2025,Quintana Roo,23,Tulum,23009,21416,19198,40614
2025,San Luis Potosí,24,Ahualulco,24001,9160,10278,19438
2025,San Luis Potosí,24,Alaquines,24002,4448,4575,9023
2025,San Luis Potosí,24,Aquismón,24003,26202,25680,51882
2025,San Luis Potosí,24,Armadillo de los Infante,24004,2199,2273,4472
2025,San Luis Potosí,24,Axtla de Terrazas,24053,19880,20445,40325
2025,San Luis Potosí,24,Catorce,24006,5416,5232,10648
2025,San Luis Potosí,24,Cedral,24007,10128,10614,20742
2025,San Luis Potosí,24,Cerritos,24008,11449,12214,23663
2025,San Luis Potosí,24,Cerro de San Pedro,24009,2503,2436,4939
2025,San Luis Potosí,24,Charcas,24015,11064,11477,22541
2025,San Luis Potosí,24,Ciudad Fernández,24011,23768,25083,48851
2025,San Luis Potosí,24,Ciudad Valles,24013,93837,100546,194383
2025,San Luis Potosí,24,Ciudad del Maíz,24010,18974,19133,38107
2025,San Luis Potosí,24,Coxcatlán,24014,8267,8174,16441
2025,San Luis Potosí,24,Cárdenas,24005,9782,10648,20430
2025,San Luis Potosí,24,Ebano,24016,23241,24120,47361
2025,San Luis Potosí,24,El Naranjo,24058,12060,11915,23975
2025,San Luis Potosí,24,Guadalcázar,24017,14511,14243,28754
2025,San Luis Potosí,24,Huehuetlán,24018,8438,8722,17160
2025,San Luis Potosí,24,Lagunillas,24019,2966,3083,6049
2025,San Luis Potosí,24,Matehuala,24020,52442,55566,108008
2025,San Luis Potosí,24,Matlapa,24057,16271,16472,32743
2025,San Luis Potosí,24,Mexquitic de Carmona,24021,29321,31878,61199
2025,San Luis Potosí,24,Moctezuma,24022,10023,10884,20907
2025,San Luis Potosí,24,Rayón,24023,8305,8735,17040
2025,San Luis Potosí,24,Rioverde,24024,49634,52697,102331
2025,San Luis Potosí,24,Salinas,24025,16440,17709,34149
2025,San Luis Potosí,24,San Antonio,24026,5041,4874,9915
2025,San Luis Potosí,24,San Ciro de Acosta,24027,5435,5806,11241
2025,San Luis Potosí,24,San Luis Potosí,24028,432000,463325,895325
2025,San Luis Potosí,24,San Martín Chalchicuautla,24029,11247,11447,22694
2025,San Luis Potosí,24,San Nicolás Tolentino,24030,2668,2952,5620
2025,San Luis Potosí,24,San Vicente Tancuayalab,24034,7944,7973,15917
2025,San Luis Potosí,24,Santa Catarina,24031,6100,6451,12551
2025,San Luis Potosí,24,Santa María del Río,24032,20404,22395,42799
2025,San Luis Potosí,24,Santo Domingo,24033,6460,6509,12969
2025,San Luis Potosí,24,Soledad de Graciano Sánchez,24035,167425,175876,343301
2025,San Luis Potosí,24,Tamasopo,24036,16515,16183,32698
2025,San Luis Potosí,24,Tamazunchale,24037,51185,52248,103433
2025,San Luis Potosí,24,Tampacán,24038,8355,8225,16580
2025,San Luis Potosí,24,Tampamolón Corona,24039,8171,8381,16552
2025,San Luis Potosí,24,Tamuín,24040,20745,21265,42010
2025,San Luis Potosí,24,Tancanhuitz,24012,10883,11253,22136
2025,San Luis Potosí,24,Tanlajás,24041,10587,10405,20992
2025,San Luis Potosí,24,Tanquián de Escobedo,24042,8021,8417,16438
2025,San Luis Potosí,24,Tierra Nueva,24043,4596,5242,9838
2025,San Luis Potosí,24,Vanegas,24044,4170,4099,8269
2025,San Luis Potosí,24,Venado,24045,7713,8007,15720
2025,San Luis Potosí,24,Villa Hidalgo,24051,7973,8117,16090
2025,San Luis Potosí,24,Villa Juárez,24052,5474,5614,11088
2025,San Luis Potosí,24,Villa de Arista,24056,8150,8230,16380
2025,San Luis Potosí,24,Villa de Arriaga,24046,9544,9703,19247
2025,San Luis Potosí,24,Villa de Guadalupe,24047,5327,5324,10651
2025,San Luis Potosí,24,Villa de Ramos,24049,19366,20399,39765
2025,San Luis Potosí,24,Villa de Reyes,24050,26334,26538,52872
2025,San Luis Potosí,24,Villa de la Paz,24048,2912,2882,5794
2025,San Luis Potosí,24,Xilitla,24054,27174,28232,55406
2025,San Luis Potosí,24,Zaragoza,24055,13741,14121,27862
2025,Sinaloa,25,Ahome,25001,245036,254218,499254
2025,Sinaloa,25,Angostura,25002,26693,26552,53245
2025,Sinaloa,25,Badiraguato,25003,17003,15742,32745
2025,Sinaloa,25,Choix,25007,18189,17217,35406
2025,Sinaloa,25,Concordia,25004,15374,14974,30348
2025,Sinaloa,25,Cosalá,25005,8965,8532,17497
2025,Sinaloa,25,Culiacán,25006,487537,506567,994104
2025,Sinaloa,25,El Fuerte,25010,56966,55805,112771
2025,Sinaloa,25,Elota,25008,31195,28974,60169
2025,Sinaloa,25,Escuinapa,25009,33134,32149,65283
2025,Sinaloa,25,Guasave,25011,162832,165535,328367
2025,Sinaloa,25,Mazatlán,25012,275554,282620,558174
2025,Sinaloa,25,Mocorito,25013,25915,24481,50396
2025,Sinaloa,25,Navolato,25018,84550,81128,165678
2025,Sinaloa,25,Rosario,25014,30327,29320,59647
2025,Sinaloa,25,Salvador Alvarado,25015,43887,46018,89905
2025,Sinaloa,25,San Ignacio,25016,11742,10903,22645
2025,Sinaloa,25,Sinaloa,25017,49947,48628,98575
2025,Sonora,26,Aconchi,26001,1700,1545,3245
2025,Sonora,26,Agua Prieta,26002,46278,45686,91964
2025,Sonora,26,Alamos,26003,15333,14348,29681
2025,Sonora,26,Altar,26004,5416,5426,10842
2025,Sonora,26,Arivechi,26005,704,674,1378
2025,Sonora,26,Arizpe,26006,1617,1536,3153
2025,Sonora,26,Atil,26007,346,328,674
2025,Sonora,26,Bacadéhuachi,26008,683,616,1299
2025,Sonora,26,Bacanora,26009,506,450,956
2025,Sonora,26,Bacerac,26010,851,805,1656
2025,Sonora,26,Bacoachi,26011,936,934,1870
2025,Sonora,26,Banámichi,26013,983,960,1943
2025,Sonora,26,Bavispe,26015,939,837,1776
2025,Sonora,26,Baviácora,26014,2015,1912,3927
2025,Sonora,26,Benito Juárez,26071,12600,12585,25185
2025,Sonora,26,Benjamín Hill,26016,2874,3019,5893
2025,Sonora,26,Bácum,26012,13251,13069,26320
2025,Sonora,26,Caborca,26017,49013,48264,97277
2025,Sonora,26,Cajeme,26018,242440,254380,496820
2025,Sonora,26,Cananea,26019,19784,20281,40065
2025,Sonora,26,Carbó,26020,2888,2655,5543
2025,Sonora,26,Cucurpe,26022,641,516,1157
2025,Sonora,26,Cumpas,26023,3641,3615,7256
2025,Sonora,26,Divisaderos,26024,448,432,880
2025,Sonora,26,Empalme,26025,31893,32185,64078
2025,Sonora,26,Etchojoa,26026,36359,35137,71496
2025,Sonora,26,Fronteras,26027,4968,4808,9776
2025,Sonora,26,General Plutarco Elías Calles,26070,9907,9735,19642
2025,Sonora,26,Granados,26028,638,623,1261
2025,Sonora,26,Guaymas,26029,90492,91839,182331
2025,Sonora,26,Hermosillo,26030,493332,507150,1000482
2025,Sonora,26,Huachinera,26031,788,738,1526
2025,Sonora,26,Huatabampo,26033,45942,45916,91858
2025,Sonora,26,Huásabas,26032,566,501,1067
2025,Sonora,26,Huépac,26034,598,577,1175
2025,Sonora,26,Imuris,26035,7323,7246,14569
2025,Sonora,26,La Colorada,26021,1286,1030,2316
2025,Sonora,26,Magdalena,26036,17833,18100,35933
2025,Sonora,26,Mazatán,26037,752,646,1398
2025,Sonora,26,Moctezuma,26038,2833,2916,5749
2025,Sonora,26,Naco,26039,3524,3506,7030
2025,Sonora,26,Nacozari de García,26041,7460,7410,14870
2025,Sonora,26,Navojoa,26042,91554,95726,187280
2025,Sonora,26,Nogales,26043,132299,132933,265232
2025,Sonora,26,Nácori Chico,26040,1227,1121,2348
2025,Sonora,26,Onavas,26044,287,248,535
2025,Sonora,26,Opodepe,26045,1682,1486,3168
2025,Sonora,26,Oquitoa,26046,217,246,463
2025,Sonora,26,Pitiquito,26047,5462,5143,10605
2025,Sonora,26,Puerto Peñasco,26048,39240,37956,77196
2025,Sonora,26,Quiriego,26049,1754,1519,3273
2025,Sonora,26,Rayón,26050,939,858,1797
2025,Sonora,26,Rosario,26051,3054,2802,5856
2025,Sonora,26,Sahuaripa,26052,3369,3150,6519
2025,Sonora,26,San Felipe de Jesús,26053,253,243,496
2025,Sonora,26,San Ignacio Río Muerto,26072,8510,8045,16555
2025,Sonora,26,San Javier,26054,428,324,752
2025,Sonora,26,San Luis Río Colorado,26055,109684,108502,218186
2025,Sonora,26,San Miguel de Horcasitas,26056,5688,4821,10509
2025,Sonora,26,San Pedro de la Cueva,26057,960,831,1791
2025,Sonora,26,Santa Ana,26058,9309,9585,18894
2025,Sonora,26,Santa Cruz,26059,1043,1078,2121
2025,Sonora,26,Soyopa,26061,885,739,1624
2025,Sonora,26,Suaqui Grande,26062,709,595,1304
2025,Sonora,26,Sáric,26060,881,848,1729
2025,Sonora,26,Tepache,26063,914,831,1745
2025,Sonora,26,Trincheras,26064,1039,844,1883
2025,Sonora,26,Tubutama,26065,693,657,1350
2025,Sonora,26,Ures,26066,5260,5029,10289
2025,Sonora,26,Villa Hidalgo,26067,943,868,1811
2025,Sonora,26,Villa Pesqueira,26068,726,610,1336
2025,Sonora,26,Yécora,26069,3344,3301,6645
2025,Tabasco,27,Balancán,27001,33892,33985,67877
2025,Tabasco,27,Centla,27003,61706,61932,123638
2025,Tabasco,27,Centro,27004,380227,398614,778841
2025,Tabasco,27,Comalcalco,27005,112545,116201,228746
2025,Tabasco,27,Cunduacán,27006,76738,79245,155983
2025,Tabasco,27,Cárdenas,27002,141557,147113,288670
2025,Tabasco,27,Emiliano Zapata,27007,16543,18191,34734
2025,Tabasco,27,Huimanguillo,27008,103608,106253,209861
2025,Tabasco,27,Jalapa,27009,21806,21751,43557
2025,Tabasco,27,Jalpa de Méndez,27010,49313,49746,99059
2025,Tabasco,27,Jonuta,27011,17192,17134,34326
2025,Tabasco,27,Macuspana,27012,90923,94776,185699
2025,Tabasco,27,Nacajuca,27013,77658,80876,158534
2025,Tabasco,27,Paraíso,27014,53491,53957,107448
2025,Tabasco,27,Tacotalpa,27015,27388,27176,54564
2025,Tabasco,27,Teapa,27016,32132,33431,65563
2025,Tabasco,27,Tenosique,27017,32390,34326,66716
2025,Tamaulipas,28,Abasolo,28001,6721,6720,13441
2025,Tamaulipas,28,Aldama,28002,16182,15866,32048
2025,Tamaulipas,28,Altamira,28003,133138,134675,267813
2025,Tamaulipas,28,Antiguo Morelos,28004,5533,5502,11035
2025,Tamaulipas,28,Burgos,28005,2603,2405,5008
2025,Tamaulipas,28,Bustamante,28006,4633,4256,8889
2025,Tamaulipas,28,Camargo,28007,8434,8244,16678
2025,Tamaulipas,28,Casas,28008,2407,2174,4581
2025,Tamaulipas,28,Ciudad Madero,28009,111101,122500,233601
2025,Tamaulipas,28,Cruillas,28010,1025,1001,2026
2025,Tamaulipas,28,El Mante,28021,63893,67864,131757
2025,Tamaulipas,28,González,28012,24080,24297,48377
2025,Tamaulipas,28,Guerrero,28014,2614,2433,5047
2025,Tamaulipas,28,Gustavo Díaz Ordaz,28015,8837,8664,17501
2025,Tamaulipas,28,Gómez Farías,28011,5221,4971,10192
2025,Tamaulipas,28,Güémez,28013,8995,8317,17312
2025,Tamaulipas,28,Hidalgo,28016,13213,12564,25777
2025,Tamaulipas,28,Jaumave,28017,8713,8409,17122
2025,Tamaulipas,28,Jiménez,28018,4393,4399,8792
2025,Tamaulipas,28,Llera,28019,9609,9236,18845
2025,Tamaulipas,28,Mainero,28020,1457,1410,2867
2025,Tamaulipas,28,Matamoros,28022,276016,285895,561911
2025,Tamaulipas,28,Mier,28024,2142,2222,4364
2025,Tamaulipas,28,Miguel Alemán,28025,14969,15147,30116
2025,Tamaulipas,28,Miquihuana,28026,2100,1921,4021
2025,Tamaulipas,28,Méndez,28023,2147,1951,4098
2025,Tamaulipas,28,Nuevo Laredo,28027,215889,216664,432553
2025,Tamaulipas,28,Nuevo Morelos,28028,2058,1870,3928
2025,Tamaulipas,28,Ocampo,28029,7891,7506,15397
2025,Tamaulipas,28,Padilla,28030,7841,7732,15573
2025,Tamaulipas,28,Palmillas,28031,995,951,1946
2025,Tamaulipas,28,Reynosa,28032,354638,356274,710912
2025,Tamaulipas,28,Río Bravo,28033,69490,69405,138895
2025,Tamaulipas,28,San Carlos,28034,5202,4696,9898
2025,Tamaulipas,28,San Fernando,28035,30576,30366,60942
2025,Tamaulipas,28,San Nicolás,28036,610,532,1142
2025,Tamaulipas,28,Soto la Marina,28037,14034,13371,27405
2025,Tamaulipas,28,Tampico,28038,166943,182591,349534
2025,Tamaulipas,28,Tula,28039,16201,16322,32523
2025,Tamaulipas,28,Valle Hermoso,28040,34461,35660,70121
2025,Tamaulipas,28,Victoria,28041,186554,195653,382207
2025,Tamaulipas,28,Villagrán,28042,3561,3348,6909
2025,Tamaulipas,28,Xicoténcatl,28043,13216,13237,26453
2025,Tlaxcala,29,Acuamanala de Miguel Hidalgo,29022,3779,3751,7530
2025,Tlaxcala,29,Altzayanca,29004,9835,9767,19602
2025,Tlaxcala,29,Amaxac de Guerrero,29001,6302,6484,12786
2025,Tlaxcala,29,Apetatitlán de Antonio Carvajal,29002,8283,8856,17139
2025,Tlaxcala,29,Apizaco,29005,42155,46333,88488
2025,Tlaxcala,29,Atlangatepec,29003,3612,3751,7363
2025,Tlaxcala,29,Benito Juárez,29045,3328,3401,6729
2025,Tlaxcala,29,Calpulalpan,29006,26535,27846,54381
2025,Tlaxcala,29,Chiautempan,29010,39689,42545,82234
2025,Tlaxcala,29,Contla de Juan Cuamatzi,29018,21361,21891,43252
2025,Tlaxcala,29,Cuapiaxtla,29008,8573,8551,17124
2025,Tlaxcala,29,Cuaxomulco,29009,2984,3026,6010
2025,Tlaxcala,29,El Carmen Tequexquitla,29007,9448,9663,19111
2025,Tlaxcala,29,Emiliano Zapata,29046,2474,2574,5048
2025,Tlaxcala,29,Españita,29012,4879,4976,9855
2025,Tlaxcala,29,Huamantla,29013,51512,53491,105003
2025,Tlaxcala,29,Hueyotlipan,29014,8082,8242,16324
2025,Tlaxcala,29,Ixtacuixtla de Mariano Matamoros,29015,21701,22805,44506
2025,Tlaxcala,29,Ixtenco,29016,3952,4272,8224
2025,Tlaxcala,29,La Magdalena Tlaltelulco,29048,10056,10839,20895
2025,Tlaxcala,29,Lázaro Cárdenas,29047,1712,1729,3441
2025,Tlaxcala,29,Mazatecochco de José María Morelos,29017,6040,6127,12167
2025,Tlaxcala,29,Muñoz de Domingo Arenas,29011,2558,2536,5094
2025,Tlaxcala,29,Nanacamilpa de Mariano Arista,29021,9988,10422,20410
2025,Tlaxcala,29,Natívitas,29023,13995,14918,28913
2025,Tlaxcala,29,Panotla,29024,14703,15810,30513
2025,Tlaxcala,29,Papalotla de Xicohténcatl,29041,16591,17680,34271
2025,Tlaxcala,29,San Damián Texóloc,29049,3202,3212,6414
2025,Tlaxcala,29,San Francisco Tetlanohcan,29050,5895,6106,12001
2025,Tlaxcala,29,San Jerónimo Zacualpan,29051,2088,2293,4381
2025,Tlaxcala,29,San José Teacalco,29052,3306,3461,6767
2025,Tlaxcala,29,San Juan Huactzinco,29053,4052,4417,8469
2025,Tlaxcala,29,San Lorenzo Axocomanitla,29054,3077,3297,6374
2025,Tlaxcala,29,San Lucas Tecopilco,29055,1721,1809,3530
2025,Tlaxcala,29,San Pablo del Monte,29025,42969,43007,85976
2025,Tlaxcala,29,Sanctórum de Lázaro Cárdenas,29020,5701,5820,11521
2025,Tlaxcala,29,Santa Ana Nopalucan,29056,4343,4482,8825
2025,Tlaxcala,29,Santa Apolonia Teacalco,29057,2481,2750,5231
2025,Tlaxcala,29,Santa Catarina Ayometla,29058,4859,5229,10088
2025,Tlaxcala,29,Santa Cruz Quilehtla,29059,4054,4045,8099
2025,Tlaxcala,29,Santa Cruz Tlaxcala,29026,11537,11902,23439
2025,Tlaxcala,29,Santa Isabel Xiloxoxtla,29060,2760,2894,5654
2025,Tlaxcala,29,Tenancingo,29027,7295,7509,14804
2025,Tlaxcala,29,Teolocholco,29028,13317,14075,27392
2025,Tlaxcala,29,Tepetitla de Lardizábal,29019,11569,12423,23992
2025,Tlaxcala,29,Tepeyanco,29029,7678,8386,16064
2025,Tlaxcala,29,Terrenate,29030,8775,8650,17425
2025,Tlaxcala,29,Tetla de la Solidaridad,29031,18100,18538,36638
2025,Tlaxcala,29,Tetlatlahuca,29032,8089,8559,16648
2025,Tlaxcala,29,Tlaxcala,29033,51515,56718,108233
2025,Tlaxcala,29,Tlaxco,29034,23479,24316,47795
2025,Tlaxcala,29,Tocatlán,29035,3263,3322,6585
2025,Tlaxcala,29,Totolac,29036,12217,13317,25534
2025,Tlaxcala,29,Tzompantepec,29038,9645,10325,19970
2025,Tlaxcala,29,Xaloztoc,29039,13578,13472,27050
2025,Tlaxcala,29,Xaltocan,29040,6059,6490,12549
2025,Tlaxcala,29,Xicohtzinco,29042,7458,8223,15681
2025,Tlaxcala,29,Yauhquemehcan,29043,21444,22751,44195
2025,Tlaxcala,29,Zacatelco,29044,24222,26384,50606
2025,Tlaxcala,29,Ziltlaltépec de Trinidad Sánchez Santos,29037,4772,5187,9959
2025,Veracruz,30,Acajete,30001,4719,4553,9272
2025,Veracruz,30,Acatlán,30002,1681,1731,3412
2025,Veracruz,30,Acayucan,30003,44639,48151,92790
2025,Veracruz,30,Actopan,30004,23404,24185,47589
2025,Veracruz,30,Acula,30005,2950,2939,5889
2025,Veracruz,30,Acultzingo,30006,11982,12398,24380
2025,Veracruz,30,Agua Dulce,30204,25305,26819,52124
2025,Veracruz,30,Alpatláhuac,30008,5363,5383,10746
2025,Veracruz,30,Alto Lucero de Gutiérrez Barrios,30009,15988,15864,31852
2025,Veracruz,30,Altotonga,30010,33524,36024,69548
2025,Veracruz,30,Alvarado,30011,28826,29688,58514
2025,Veracruz,30,Amatitlán,30012,4294,4504,8798
2025,Veracruz,30,Amatlán de los Reyes,30014,23799,25615,49414
2025,Veracruz,30,Angel R. Cabada,30015,17933,19042,36975
2025,Veracruz,30,Apazapan,30017,2204,2237,4441
2025,Veracruz,30,Aquila,30018,967,1027,1994
2025,Veracruz,30,Astacinga,30019,3177,3608,6785
2025,Veracruz,30,Atlahuilco,30020,5603,5863,11466
2025,Veracruz,30,Atoyac,30021,12505,13201,25706
2025,Veracruz,30,Atzacan,30022,11228,11594,22822
2025,Veracruz,30,Atzalan,30023,26966,27171,54137
2025,Veracruz,30,Ayahualulco,30025,14133,14329,28462
2025,Veracruz,30,Banderilla,30026,12056,13445,25501
2025,Veracruz,30,Benito Juárez,30027,9159,9698,18857
2025,Veracruz,30,Boca del Río,30028,73797,83697,157494
2025,Veracruz,30,Calcahualco,30029,6744,6779,13523
2025,Veracruz,30,Camarón de Tejeda,30007,3520,3504,7024
2025,Veracruz,30,Camerino Z. Mendoza,30030,21498,24326,45824
2025,Veracruz,30,Carlos A. Carrillo,30208,12933,14137,27070
2025,Veracruz,30,Carrillo Puerto,30031,8948,9188,18136
2025,Veracruz,30,Castillo de Teayo,30157,10751,10542,21293
2025,Veracruz,30,Catemaco,30032,25577,27388,52965
2025,Veracruz,30,Cazones de Herrera,30033,12367,13167,25534
2025,Veracruz,30,Cerro Azul,30034,13965,15695,29660
2025,Veracruz,30,Chacaltianguis,30054,6598,6988,13586
2025,Veracruz,30,Chalma,30055,7153,7438,14591
2025,Veracruz,30,Chiconamel,30056,3425,3707,7132
2025,Veracruz,30,Chiconquiaco,30057,7468,7569,15037
2025,Veracruz,30,Chicontepec,30058,29336,31002,60338
2025,Veracruz,30,Chinameca,30059,8567,8965,17532
2025,Veracruz,30,Chinampa de Gorostiza,30060,8906,9164,18070
2025,Veracruz,30,Chocamán,30062,11322,11324,22646
2025,Veracruz,30,Chontla,30063,7715,7849,15564
2025,Veracruz,30,Chumatlán,30064,2021,2149,4170
2025,Veracruz,30,Citlaltépetl,30035,6256,6588,12844
2025,Veracruz,30,Coacoatzintla,30036,5470,5718,11188
2025,Veracruz,30,Coahuitlán,30037,4416,4589,9005
2025,Veracruz,30,Coatepec,30038,48254,52227,100481
2025,Veracruz,30,Coatzacoalcos,30039,167939,178907,346846
2025,Veracruz,30,Coatzintla,30040,30242,31929,62171
2025,Veracruz,30,Coetzala,30041,1202,1234,2436
2025,Veracruz,30,Colipa,30042,2926,3048,5974
2025,Veracruz,30,Comapa,30043,11088,10606,21694
2025,Veracruz,30,Cosamaloapan de Carpio,30045,29788,32578,62366
2025,Veracruz,30,Cosautlán de Carvajal,30046,8661,8766,17427
2025,Veracruz,30,Coscomatepec,30047,30537,31508,62045
2025,Veracruz,30,Cosoleacaque,30048,71470,76398,147868
2025,Veracruz,30,Cotaxtla,30049,11242,11229,22471
2025,Veracruz,30,Coxquihui,30050,8770,9202,17972
2025,Veracruz,30,Coyutla,30051,11492,12405,23897
2025,Veracruz,30,Cuichapa,30052,6265,6878,13143
2025,Veracruz,30,Cuitláhuac,30053,14597,15860,30457
2025,Veracruz,30,Córdoba,30044,110216,124473,234689
2025,Veracruz,30,El Higo,30205,10580,10705,21285
2025,Veracruz,30,Emiliano Zapata,30065,42593,45650,88243
2025,Veracruz,30,Espinal,30066,14272,15001,29273
2025,Veracruz,30,Filomeno Mata,30067,9923,9894,19817
2025,Veracruz,30,Fortín,30068,34377,38276,72653
2025,Veracruz,30,Gutiérrez Zamora,30069,12487,14118,26605
2025,Veracruz,30,Hidalgotitlán,30070,10386,10000,20386
2025,Veracruz,30,Huatusco,30071,31475,33757,65232
2025,Veracruz,30,Huayacocotla,30072,11186,11954,23140
2025,Veracruz,30,Hueyapan de Ocampo,30073,22646,23893,46539
2025,Veracruz,30,Huiloapan de Cuauhtémoc,30074,3772,4057,7829
2025,Veracruz,30,Ignacio de la Llave,30075,8979,9868,18847
2025,Veracruz,30,Ilamatlán,30076,6901,7592,14493
2025,Veracruz,30,Isla,30077,22564,23576,46140
2025,Veracruz,30,Ixcatepec,30078,7280,7301,14581
2025,Veracruz,30,Ixhuacán de los Reyes,30079,6167,6073,12240
2025,Veracruz,30,Ixhuatlancillo,30081,13600,14811,28411
2025,Veracruz,30,Ixhuatlán de Madero,30083,28321,29897,58218
2025,Veracruz,30,Ixhuatlán del Café,30080,12214,12263,24477
2025,Veracruz,30,Ixhuatlán del Sureste,30082,8456,8370,16826
2025,Veracruz,30,Ixmatlahuacan,30084,3076,3140,6216
2025,Veracruz,30,Ixtaczoquitlán,30085,35750,37962,73712
2025,Veracruz,30,Jalacingo,30086,22966,24110,47076
2025,Veracruz,30,Jalcomulco,30088,2785,2760,5545
2025,Veracruz,30,Jamapa,30090,6030,6329,12359
2025,Veracruz,30,Jesús Carranza,30091,15689,15746,31435
2025,Veracruz,30,Jilotepec,30093,8827,9253,18080
2025,Veracruz,30,José Azueta,30169,12022,12438,24460
2025,Veracruz,30,Juan Rodríguez Clara,30094,20920,21387,42307
2025,Veracruz,30,Juchique de Ferrer,30095,8416,8539,16955
2025,Veracruz,30,Jáltipan,30089,21572,23597,45169
2025,Veracruz,30,La Antigua,30016,14029,15119,29148
2025,Veracruz,30,La Perla,30127,14467,15033,29500
2025,Veracruz,30,Landero y Coss,30096,846,891,1737
2025,Veracruz,30,Las Choapas,30061,42875,44390,87265
2025,Veracruz,30,Las Minas,30107,1615,1561,3176
2025,Veracruz,30,Las Vigas de Ramírez,30132,10542,10627,21169
2025,Veracruz,30,Lerdo de Tejada,30097,10076,11590,21666
2025,Veracruz,30,Los Reyes,30137,3132,3175,6307
2025,Veracruz,30,Magdalena,30098,1631,1651,3282
2025,Veracruz,30,Maltrata,30099,9318,9917,19235
2025,Veracruz,30,Manlio Fabio Altamirano,30100,12579,13031,25610
2025,Veracruz,30,Mariano Escobedo,30101,18734,20187,38921
2025,Veracruz,30,Martínez de la Torre,30102,53939,58791,112730
2025,Veracruz,30,Mecatlán,30103,6443,6658,13101
2025,Veracruz,30,Mecayapan,30104,8794,9173,17967
2025,Veracruz,30,Medellín,30105,42213,45746,87959
2025,Veracruz,30,Miahuatlán,30106,2473,2549,5022
2025,Veracruz,30,Minatitlán,30108,81921,87318,169239
2025,Veracruz,30,Misantla,30109,33822,35574,69396
2025,Veracruz,30,Mixtla de Altamirano,30110,6278,6174,12452
2025,Veracruz,30,Moloacán,30111,9042,9553,18595
2025,Veracruz,30,Nanchital de Lázaro Cárdenas del Rio,30206,15556,16454,32010
2025,Veracruz,30,Naolinco,30112,11498,12034,23532
2025,Veracruz,30,Naranjal,30113,2356,2523,4879
2025,Veracruz,30,Naranjos Amatlán,30013,14694,16381,31075
2025,Veracruz,30,Nautla,30114,5884,6100,11984
2025,Veracruz,30,Nogales,30115,19495,21427,40922
2025,Veracruz,30,Oluta,30116,8542,9216,17758
2025,Veracruz,30,Omealca,30117,12493,13327,25820
2025,Veracruz,30,Orizaba,30118,63539,75280,138819
2025,Veracruz,30,Otatitlán,30119,2931,3205,6136
2025,Veracruz,30,Oteapan,30120,8628,8920,17548
2025,Veracruz,30,Ozuluama de Mascareñas,30121,12820,12299,25119
2025,Veracruz,30,Pajapan,30122,9305,9224,18529
2025,Veracruz,30,Papantla,30124,83767,85238,169005
2025,Veracruz,30,Paso de Ovejas,30126,18148,18316,36464
2025,Veracruz,30,Paso del Macho,30125,16886,17240,34126
2025,Veracruz,30,Perote,30128,38947,39399,78346
2025,Veracruz,30,Platón Sánchez,30129,9593,10041,19634
2025,Veracruz,30,Playa Vicente,30130,19291,20860,40151
2025,Veracruz,30,Poza Rica de Hidalgo,30131,106577,118655,225232
2025,Veracruz,30,Pueblo Viejo,30133,31068,31136,62204
2025,Veracruz,30,Puente Nacional,30134,12100,12467,24567
2025,Veracruz,30,Pánuco,30123,54027,54490,108517
2025,Veracruz,30,Rafael Delgado,30135,12300,12747,25047
2025,Veracruz,30,Rafael Lucio,30136,4257,4504,8761
2025,Veracruz,30,Río Blanco,30138,21422,24332,45754
2025,Veracruz,30,Saltabarranca,30139,3272,3502,6774
2025,Veracruz,30,San Andrés Tenejapan,30140,1540,1607,3147
2025,Veracruz,30,San Andrés Tuxtla,30141,84843,91726,176569
2025,Veracruz,30,San Juan Evangelista,30142,17944,18571,36515
2025,Veracruz,30,San Rafael,30211,15754,16400,32154
2025,Veracruz,30,Santiago Sochiapan,30212,7266,7766,15032
2025,Veracruz,30,Santiago Tuxtla,30143,29759,32063,61822
2025,Veracruz,30,Sayula de Alemán,30144,17244,17775,35019
2025,Veracruz,30,Sochiapa,30146,1943,1950,3893
2025,Veracruz,30,Soconusco,30145,8583,9023,17606
2025,Veracruz,30,Soledad Atzompa,30147,12230,12352,24582
2025,Veracruz,30,Soledad de Doblado,30148,14742,15057,29799
2025,Veracruz,30,Soteapan,30149,17973,18571,36544
2025,Veracruz,30,Tamalín,30150,6267,6242,12509
2025,Veracruz,30,Tamiahua,30151,12632,12609,25241
2025,Veracruz,30,Tampico Alto,30152,7008,6566,13574
2025,Veracruz,30,Tancoco,30153,3023,3221,6244
2025,Veracruz,30,Tantima,30154,7135,6915,14050
2025,Veracruz,30,Tantoyuca,30155,54590,56214,110804
2025,Veracruz,30,Tatahuicapan de Juárez,30209,8229,8527,16756
2025,Veracruz,30,Tatatila,30156,3282,3021,6303
2025,Veracruz,30,Tecolutla,30158,12706,13098,25804
2025,Veracruz,30,Tehuipango,30159,13406,14230,27636
2025,Veracruz,30,Tempoal,30161,18862,19530,38392
2025,Veracruz,30,Tenampa,30162,3562,3684,7246
2025,Veracruz,30,Tenochtitlán,30163,2677,2849,5526
2025,Veracruz,30,Teocelo,30164,8695,9232,17927
2025,Veracruz,30,Tepatlaxco,30165,4643,4391,9034
2025,Veracruz,30,Tepetlán,30166,5280,5117,10397
2025,Veracruz,30,Tepetzintla,30167,7788,8022,15810
2025,Veracruz,30,Tequila,30168,7965,8242,16207
2025,Veracruz,30,Texcatepec,30170,5703,5980,11683
2025,Veracruz,30,Texhuacán,30171,2701,3005,5706
2025,Veracruz,30,Texistepec,30172,11210,11143,22353
2025,Veracruz,30,Tezonapa,30173,30261,30951,61212
2025,Veracruz,30,Tierra Blanca,30174,55356,59558,114914
2025,Veracruz,30,Tihuatlán,30175,50861,52956,103817
2025,Veracruz,30,Tlachichilco,30180,6107,6311,12418
2025,Veracruz,30,Tlacojalpan,30176,2619,2732,5351
2025,Veracruz,30,Tlacolulan,30177,6113,5908,12021
2025,Veracruz,30,Tlacotalpan,30178,6929,7594,14523
2025,Veracruz,30,Tlacotepec de Mejía,30179,2102,2144,4246
2025,Veracruz,30,Tlalixcoyan,30181,20276,20960,41236
2025,Veracruz,30,Tlalnelhuayocan,30182,9936,10272,20208
2025,Veracruz,30,Tlaltetela,30024,8474,8226,16700
2025,Veracruz,30,Tlapacoyan,30183,32288,34189,66477
2025,Veracruz,30,Tlaquilpa,30184,3796,4344,8140
2025,Veracruz,30,Tlilapan,30185,2764,2912,5676
2025,Veracruz,30,Tomatlán,30186,3698,3801,7499
2025,Veracruz,30,Tonayán,30187,2923,3122,6045
2025,Veracruz,30,Totutla,30188,9336,9401,18737
2025,Veracruz,30,Tres Valles,30207,24263,25551,49814
2025,Veracruz,30,Tuxpan,30189,85364,89992,175356
2025,Veracruz,30,Tuxtilla,30190,1207,1242,2449
2025,Veracruz,30,Ursulo Galván,30191,16363,17312,33675
2025,Veracruz,30,Uxpanapa,30210,15764,15268,31032
2025,Veracruz,30,Vega de Alatorre,30192,10612,11330,21942
2025,Veracruz,30,Veracruz,30193,308026,335608,643634
2025,Veracruz,30,Villa Aldama,30194,6231,6399,12630
2025,Veracruz,30,Xalapa,30087,246558,278071,524629
2025,Veracruz,30,Xico,30092,20392,20989,41381
2025,Veracruz,30,Xoxocotla,30195,2944,2828,5772
2025,Veracruz,30,Yanga,30196,9221,10397,19618
2025,Veracruz,30,Yecuatla,30197,6375,6571,12946
2025,Veracruz,30,Zacualpan,30198,3740,4025,7765
2025,Veracruz,30,Zaragoza,30199,5885,6125,12010
2025,Veracruz,30,Zentla,30200,7293,7154,14447
2025,Veracruz,30,Zongolica,30201,22995,23512,46507
2025,Veracruz,30,Zontecomatlán de López y Fuentes,30202,7627,7859,15486
2025,Veracruz,30,Zozocolco de Hidalgo,30203,7932,8282,16214
2025,Veracruz,30,Álamo Temapache,30160,56045,56740,112785
2025,Yucatán,31,Abalá,31001,3766,3601,7367
2025,Yucatán,31,Acanceh,31002,9136,9126,18262
2025,Yucatán,31,Akil,31003,6057,6304,12361
2025,Yucatán,31,Baca,31004,3368,3455,6823
2025,Yucatán,31,Bokobá,31005,1270,1221,2491
2025,Yucatán,31,Buctzotz,31006,5033,5016,10049
2025,Yucatán,31,Cacalchén,31007,4214,3998,8212
2025,Yucatán,31,Calotmul,31008,2286,2283,4569
2025,Yucatán,31,Cansahcab,31009,2615,2672,5287
2025,Yucatán,31,Cantamayec,31010,1463,1342,2805
2025,Yucatán,31,Celestún,31011,4447,4217,8664
2025,Yucatán,31,Cenotillo,31012,2169,2311,4480
2025,Yucatán,31,Chacsinkín,31016,1683,1650,3333
2025,Yucatán,31,Chankom,31017,2600,2516,5116
2025,Yucatán,31,Chapab,31018,1791,1785,3576
2025,Yucatán,31,Chemax,31019,20417,20093,40510
2025,Yucatán,31,Chichimilá,31021,4703,4633,9336
2025,Yucatán,31,Chicxulub Pueblo,31020,2604,2478,5082
2025,Yucatán,31,Chikindzonot,31022,2322,2259,4581
2025,Yucatán,31,Chocholá,31023,2717,2629,5346
2025,Yucatán,31,Chumayel,31024,1807,1867,3674
2025,Yucatán,31,Conkal,31013,6360,6350,12710
2025,Yucatán,31,Cuncunul,31014,919,891,1810
2025,Yucatán,31,Cuzamá,31015,2938,2853,5791
2025,Yucatán,31,Dzemul,31026,2131,2125,4256
2025,Yucatán,31,Dzidzantún,31027,4728,4626,9354
2025,Yucatán,31,Dzilam González,31029,3529,3353,6882
2025,Yucatán,31,Dzilam de Bravo,31028,1575,1484,3059
2025,Yucatán,31,Dzitás,31030,2186,2085,4271
2025,Yucatán,31,Dzoncauich,31031,1469,1508,2977
2025,Yucatán,31,Dzán,31025,2927,3052,5979
2025,Yucatán,31,Espita,31032,9184,8926,18110
2025,Yucatán,31,Halachó,31033,11491,11241,22732
2025,Yucatán,31,Hocabá,31034,3477,3471,6948
2025,Yucatán,31,Hoctún,31035,3315,3384,6699
2025,Yucatán,31,Homún,31036,4404,4237,8641
2025,Yucatán,31,Huhí,31037,3003,2894,5897
2025,Yucatán,31,Hunucmá,31038,18210,18310,36520
2025,Yucatán,31,Ixil,31039,2345,2265,4610
2025,Yucatán,31,Izamal,31040,15077,15390,30467
2025,Yucatán,31,Kanasín,31041,57892,58735,116627
2025,Yucatán,31,Kantunil,31042,2954,3111,6065
2025,Yucatán,31,Kaua,31043,1762,1696,3458
2025,Yucatán,31,Kinchil,31044,4079,3982,8061
2025,Yucatán,31,Kopomá,31045,1487,1404,2891
2025,Yucatán,31,Mama,31046,1694,1861,3555
2025,Yucatán,31,Maní,31047,3095,3223,6318
2025,Yucatán,31,Maxcanú,31048,12846,12660,25506
2025,Yucatán,31,Mayapán,31049,2116,1957,4073
2025,Yucatán,31,Mocochá,31051,1886,1844,3730
2025,Yucatán,31,Motul,31052,20458,20820,41278
2025,Yucatán,31,Muna,31053,6986,7256,14242
2025,Yucatán,31,Muxupip,31054,1591,1656,3247
2025,Yucatán,31,Mérida,31050,489196,529096,1018292
2025,Yucatán,31,Opichén,31055,3872,3742,7614
2025,Yucatán,31,Oxkutzcab,31056,16621,18099,34720
2025,Yucatán,31,Panabá,31057,4307,4343,8650
2025,Yucatán,31,Peto,31058,13996,14201,28197
2025,Yucatán,31,Progreso,31059,32979,33395,66374
2025,Yucatán,31,Quintana Roo,31060,542,544,1086
2025,Yucatán,31,Río Lagartos,31061,2055,1949,4004
2025,Yucatán,31,Sacalum,31062,2769,2637,5406
2025,Yucatán,31,Samahil,31063,2912,2894,5806
2025,Yucatán,31,San Felipe,31065,1117,1054,2171
2025,Yucatán,31,Sanahcat,31064,977,967,1944
2025,Yucatán,31,Santa Elena,31066,2176,2281,4457
2025,Yucatán,31,Seyé,31067,5520,5285,10805
2025,Yucatán,31,Sinanché,31068,1868,1724,3592
2025,Yucatán,31,Sotuta,31069,5080,4899,9979
2025,Yucatán,31,Sucilá,31070,2242,2168,4410
2025,Yucatán,31,Sudzal,31071,1007,904,1911
2025,Yucatán,31,Suma,31072,1063,1036,2099
2025,Yucatán,31,Tahdziú,31073,2890,2722,5612
2025,Yucatán,31,Tahmek,31074,2162,2094,4256
2025,Yucatán,31,Teabo,31075,3676,3702,7378
2025,Yucatán,31,Tecoh,31076,9911,9850,19761
2025,Yucatán,31,Tekal de Venegas,31077,1520,1478,2998
2025,Yucatán,31,Tekantó,31078,2136,2147,4283
2025,Yucatán,31,Tekax,31079,23355,24154,47509
2025,Yucatán,31,Tekit,31080,5798,5640,11438
2025,Yucatán,31,Tekom,31081,1782,1817,3599
2025,Yucatán,31,Telchac Pueblo,31082,2183,2167,4350
2025,Yucatán,31,Telchac Puerto,31083,1048,952,2000
2025,Yucatán,31,Temax,31084,4118,4103,8221
2025,Yucatán,31,Temozón,31085,8764,8523,17287
2025,Yucatán,31,Tepakán,31086,1299,1243,2542
2025,Yucatán,31,Tetiz,31087,2831,2837,5668
2025,Yucatán,31,Teya,31088,1099,1117,2216
2025,Yucatán,31,Ticul,31089,22157,22832,44989
2025,Yucatán,31,Timucuy,31090,4210,4044,8254
2025,Yucatán,31,Tinum,31091,6786,6561,13347
2025,Yucatán,31,Tixcacalcupul,31092,3995,3945,7940
2025,Yucatán,31,Tixkokob,31093,10117,10318,20435
2025,Yucatán,31,Tixmehuac,31094,2726,2718,5444
2025,Yucatán,31,Tixpéhual,31095,3070,3190,6260
2025,Yucatán,31,Tizimín,31096,42701,43946,86647
2025,Yucatán,31,Tunkás,31097,2024,1938,3962
2025,Yucatán,31,Tzucacab,31098,8263,8116,16379
2025,Yucatán,31,Uayma,31099,2356,2261,4617
2025,Yucatán,31,Ucú,31100,2104,2074,4178
2025,Yucatán,31,Umán,31101,30080,30070,60150
2025,Yucatán,31,Valladolid,31102,44640,45442,90082
2025,Yucatán,31,Xocchel,31103,2010,1932,3942
2025,Yucatán,31,Yaxcabá,31104,8767,8264,17031
2025,Yucatán,31,Yaxkukul,31105,1781,1801,3582
2025,Yucatán,31,Yobaín,31106,1316,1270,2586
2025,Zacatecas,32,Apozol,32001,3154,3376,6530
2025,Zacatecas,32,Apulco,32002,2485,2744,5229
2025,Zacatecas,32,Atolinga,32003,1325,1416,2741
2025,Zacatecas,32,Benito Juárez,32004,2245,2179,4424
2025,Zacatecas,32,Calera,32005,24273,24249,48522
2025,Zacatecas,32,Cañitas de Felipe Pescador,32006,4403,4513,8916
2025,Zacatecas,32,Chalchihuites,32009,6031,6346,12377
2025,Zacatecas,32,Concepción del Oro,32007,7317,7206,14523
2025,Zacatecas,32,Cuauhtémoc,32008,6599,6965,13564
2025,Zacatecas,32,El Plateado de Joaquín Amaro,32015,688,711,1399
2025,Zacatecas,32,El Salvador,32041,1296,1260,2556
2025,Zacatecas,32,Fresnillo,32010,123399,126902,250301
2025,Zacatecas,32,Genaro Codina,32012,4288,4498,8786
2025,Zacatecas,32,General Enrique Estrada,32013,3362,3426,6788
2025,Zacatecas,32,General Francisco R. Murguía,32014,11405,12087,23492
2025,Zacatecas,32,General Pánfilo Natera,32016,12215,12688,24903
2025,Zacatecas,32,Guadalupe,32017,101438,106411,207849
2025,Zacatecas,32,Huanusco,32018,2163,2256,4419
2025,Zacatecas,32,Jalpa,32019,12827,13410,26237
2025,Zacatecas,32,Jerez,32020,31839,33846,65685
2025,Zacatecas,32,Jiménez del Teul,32021,2220,2268,4488
2025,Zacatecas,32,Juan Aldama,32022,11435,12110,23545
2025,Zacatecas,32,Juchipila,32023,6583,7342,13925
2025,Zacatecas,32,Loreto,32024,28979,29418,58397
2025,Zacatecas,32,Luis Moya,32025,7203,7266,14469
2025,Zacatecas,32,Mazapil,32026,10051,9178,19229
2025,Zacatecas,32,Melchor Ocampo,32027,1750,1534,3284
2025,Zacatecas,32,Mezquital del Oro,32028,1293,1404,2697
2025,Zacatecas,32,Miguel Auza,32029,12520,13024,25544
2025,Zacatecas,32,Momax,32030,1263,1362,2625
2025,Zacatecas,32,Monte Escobedo,32031,5020,5143,10163
2025,Zacatecas,32,Morelos,32032,6736,6796,13532
2025,Zacatecas,32,Moyahua de Estrada,32033,2032,2316,4348
2025,Zacatecas,32,Nochistlán de Mejía,32034,14502,15958,30460
2025,Zacatecas,32,Noria de Ángeles,32035,8989,9257,18246
2025,Zacatecas,32,Ojocaliente,32036,22710,23677,46387
2025,Zacatecas,32,Pinos,32038,38568,40336,78904
2025,Zacatecas,32,Pánuco,32037,9693,9660,19353
2025,Zacatecas,32,Río Grande,32039,33756,35806,69562
2025,Zacatecas,32,Sain Alto,32040,11698,12309,24007
2025,Zacatecas,32,Santa María de la Paz,32058,1442,1473,2915
2025,Zacatecas,32,Sombrerete,32042,33080,34080,67160
2025,Zacatecas,32,Susticacán,32043,717,787,1504
2025,Zacatecas,32,Tabasco,32044,8186,8624,16810
2025,Zacatecas,32,Tepechitlán,32045,4565,4986,9551
2025,Zacatecas,32,Tepetongo,32046,3823,4071,7894
2025,Zacatecas,32,Teúl de González Ortega,32047,2554,2699,5253
2025,Zacatecas,32,Tlaltenango de Sánchez Román,32048,14258,14906,29164
2025,Zacatecas,32,Trancoso,32057,10337,10577,20914
2025,Zacatecas,32,Trinidad García de la Cadena,32011,1528,1592,3120
2025,Zacatecas,32,Valparaíso,32049,17799,18360,36159
2025,Zacatecas,32,Vetagrande,32050,5369,5502,10871
2025,Zacatecas,32,Villa García,32052,10286,10445,20731
2025,Zacatecas,32,Villa González Ortega,32053,6993,7385,14378
2025,Zacatecas,32,Villa Hidalgo,32054,10262,10396,20658
2025,Zacatecas,32,Villa de Cos,32051,19230,18961,38191
2025,Zacatecas,32,Villanueva,32055,16155,16839,32994
2025,Zacatecas,32,Zacatecas,32056,77567,82388,159955
2026,Aguascalientes,01,Aguascalientes,01001,507161,528142,1035303
2026,Aguascalientes,01,Asientos,01002,26993,27165,54158
2026,Aguascalientes,01,Calvillo,01003,32153,33323,65476
2026,Aguascalientes,01,Cosío,01004,8851,9119,17970
2026,Aguascalientes,01,El Llano,01010,11868,11559,23427
2026,Aguascalientes,01,Jesús María,01005,70430,69467,139897
2026,Aguascalientes,01,Pabellón de Arteaga,01006,25995,27168,53163
2026,Aguascalientes,01,Rincón de Romos,01007,30704,30972,61676
2026,Aguascalientes,01,San Francisco de los Romo,01011,27762,27774,55536
2026,Aguascalientes,01,San José de Gracia,01008,5048,5315,10363
2026,Aguascalientes,01,Tepezalá,01009,12078,12358,24436
2026,Baja California,02,Ensenada,02001,291434,292946,584380
2026,Baja California,02,Mexicali,02002,593963,599685,1193648
2026,Baja California,02,Playas de Rosarito,02005,58846,58618,117464
2026,Baja California,02,Tecate,02003,63242,60219,123461
2026,Baja California,02,Tijuana,02004,961223,970345,1931568
2026,Baja California Sur,03,Comondú,03001,47634,46463,94097
2026,Baja California Sur,03,La Paz,03003,167275,169778,337053
2026,Baja California Sur,03,Loreto,03009,12810,11784,24594
2026,Baja California Sur,03,Los Cabos,03008,189655,179137,368792
2026,Baja California Sur,03,Mulegé,03002,38484,35976,74460
2026,Campeche,04,Calakmul,04010,17444,16713,34157
2026,Campeche,04,Calkiní,04001,34038,35257,69295
2026,Campeche,04,Campeche,04002,167949,180911,348860
2026,Campeche,04,Candelaria,04011,26994,26113,53107
2026,Campeche,04,Carmen,04003,150105,151064,301169
2026,Campeche,04,Champotón,04004,55459,54775,110234
2026,Campeche,04,Escárcega,04009,34287,34799,69086
2026,Campeche,04,Hecelchakán,04005,18871,18976,37847
2026,Campeche,04,Hopelchén,04006,24836,23682,48518
2026,Campeche,04,Palizada,04007,5455,5336,10791
2026,Campeche,04,Tenabo,04008,6681,6354,13035
2026,Chiapas,07,Acacoyagua,07001,10822,10718,21540
2026,Chiapas,07,Acala,07002,18590,19004,37594
2026,Chiapas,07,Acapetahua,07003,16964,16920,33884
2026,Chiapas,07,Aldama,07113,3717,4033,7750
2026,Chiapas,07,Altamirano,07004,19508,19320,38828
2026,Chiapas,07,Amatenango de la Frontera,07006,17883,18873,36756
2026,Chiapas,07,Amatenango del Valle,07007,5553,6043,11596
2026,Chiapas,07,Amatán,07005,11697,11369,23066
2026,Chiapas,07,Angel Albino Corzo,07008,16502,16646,33148
2026,Chiapas,07,Arriaga,07009,23205,24963,48168
2026,Chiapas,07,Bejucal de Ocampo,07010,4506,4476,8982
2026,Chiapas,07,Bella Vista,07011,11893,12005,23898
2026,Chiapas,07,Benemérito de las Américas,07114,11977,11713,23690
2026,Chiapas,07,Berriozábal,07012,31076,31436,62512
2026,Chiapas,07,Bochil,07013,20273,20733,41006
2026,Chiapas,07,Cacahoatán,07015,26686,28070,54756
2026,Chiapas,07,Catazajá,07016,10431,10324,20755
2026,Chiapas,07,Chalchihuitán,07022,9505,9686,19191
2026,Chiapas,07,Chamula,07023,47456,55742,103198
2026,Chiapas,07,Chanal,07024,7196,7237,14433
2026,Chiapas,07,Chapultenango,07025,4423,4405,8828
2026,Chiapas,07,Chenalhó,07026,23302,23820,47122
2026,Chiapas,07,Chiapa de Corzo,07027,59654,62099,121753
2026,Chiapas,07,Chiapilla,07028,3545,3426,6971
2026,Chiapas,07,Chicoasén,07029,2982,3004,5986
2026,Chiapas,07,Chicomuselo,07030,20725,20970,41695
2026,Chiapas,07,Chilón,07031,74792,76597,151389
2026,Chiapas,07,Cintalapa,07017,50588,51431,102019
2026,Chiapas,07,Coapilla,07018,5334,5491,10825
2026,Chiapas,07,Comitán de Domínguez,07019,88186,97133,185319
2026,Chiapas,07,Copainalá,07021,12643,13268,25911
2026,Chiapas,07,El Bosque,07014,12843,13734,26577
2026,Chiapas,07,El Porvenir,07070,8320,8410,16730
2026,Chiapas,07,Escuintla,07032,18514,19043,37557
2026,Chiapas,07,Francisco León,07033,4514,4361,8875
2026,Chiapas,07,Frontera Comalapa,07034,42879,45192,88071
2026,Chiapas,07,Frontera Hidalgo,07035,8403,8862,17265
2026,Chiapas,07,Huehuetán,07037,20194,21302,41496
2026,Chiapas,07,Huitiupán,07039,13507,13341,26848
2026,Chiapas,07,Huixtla,07040,31003,33394,64397
2026,Chiapas,07,Huixtán,07038,13677,14184,27861
2026,Chiapas,07,Ixhuatán,07042,6596,6754,13350
2026,Chiapas,07,Ixtacomitán,07043,6273,6391,12664
2026,Chiapas,07,Ixtapa,07044,15922,16150,32072
2026,Chiapas,07,Ixtapangajoya,07045,3275,3191,6466
2026,Chiapas,07,Jiquipilas,07046,23302,24203,47505
2026,Chiapas,07,Jitotol,07047,12329,12036,24365
2026,Chiapas,07,Juárez,07048,12645,13021,25666
2026,Chiapas,07,La Concordia,07020,27459,27089,54548
2026,Chiapas,07,La Grandeza,07036,4158,4276,8434
2026,Chiapas,07,La Independencia,07041,26419,27383,53802
2026,Chiapas,07,La Libertad,07050,2882,2988,5870
2026,Chiapas,07,La Trinitaria,07099,45806,47918,93724
2026,Chiapas,07,Larráinzar,07049,13677,14178,27855
2026,Chiapas,07,Las Margaritas,07052,72609,73941,146550
2026,Chiapas,07,Las Rosas,07075,16417,16842,33259
2026,Chiapas,07,Mapastepec,07051,27861,28797,56658
2026,Chiapas,07,Maravilla Tenejapa,07115,7557,7324,14881
2026,Chiapas,07,Marqués de Comillas,07116,6836,6637,13473
2026,Chiapas,07,Mazapa de Madero,07053,4574,4758,9332
2026,Chiapas,07,Mazatán,07054,17133,17738,34871
2026,Chiapas,07,Metapa,07055,3234,3512,6746
2026,Chiapas,07,Mitontic,07056,7060,7125,14185
2026,Chiapas,07,Montecristo de Guerrero,07117,4492,4397,8889
2026,Chiapas,07,Motozintla,07057,42316,43968,86284
2026,Chiapas,07,Nicolás Ruíz,07058,2587,2442,5029
2026,Chiapas,07,Ocosingo,07059,128276,129288,257564
2026,Chiapas,07,Ocotepec,07060,7167,7509,14676
2026,Chiapas,07,Ocozocoautla de Espinosa,07061,53445,55001,108446
2026,Chiapas,07,Ostuacán,07062,10896,10760,21656
2026,Chiapas,07,Osumacinta,07063,2194,2202,4396
2026,Chiapas,07,Oxchuc,07064,27829,27621,55450
2026,Chiapas,07,Palenque,07065,69673,71842,141515
2026,Chiapas,07,Pantelhó,07066,12718,12932,25650
2026,Chiapas,07,Pantepec,07067,7168,7298,14466
2026,Chiapas,07,Pichucalco,07068,18374,18867,37241
2026,Chiapas,07,Pijijiapan,07069,31306,32211,63517
2026,Chiapas,07,Pueblo Nuevo Solistahuacán,07072,17844,19457,37301
2026,Chiapas,07,Rayón,07073,5622,5743,11365
2026,Chiapas,07,Reforma,07074,26771,27230,54001
2026,Chiapas,07,Sabanilla,07076,15802,15635,31437
2026,Chiapas,07,Salto de Agua,07077,36871,37311,74182
2026,Chiapas,07,San Andrés Duraznal,07118,3153,3323,6476
2026,Chiapas,07,San Cristóbal de las Casas,07078,118210,131721,249931
2026,Chiapas,07,San Fernando,07079,23724,23261,46985
2026,Chiapas,07,San Juan Cancuc,07112,20116,21018,41134
2026,Chiapas,07,San Lucas,07110,4237,4265,8502
2026,Chiapas,07,Santiago el Pinar,07119,2128,2083,4211
2026,Chiapas,07,Siltepec,07080,21354,20664,42018
2026,Chiapas,07,Simojovel,07081,25717,26192,51909
2026,Chiapas,07,Sitalá,07082,8358,8460,16818
2026,Chiapas,07,Socoltenango,07083,10836,10897,21733
2026,Chiapas,07,Solosuchiapa,07084,4713,4663,9376
2026,Chiapas,07,Soyaló,07085,6372,6330,12702
2026,Chiapas,07,Suchiapa,07086,14430,14470,28900
2026,Chiapas,07,Suchiate,07087,22310,23334,45644
2026,Chiapas,07,Sunuapa,07088,1429,1403,2832
2026,Chiapas,07,Tapachula,07089,199998,219265,419263
2026,Chiapas,07,Tapalapa,07090,2275,2397,4672
2026,Chiapas,07,Tapilula,07091,7515,7935,15450
2026,Chiapas,07,Tecpatán,07092,24358,24704,49062
2026,Chiapas,07,Tenejapa,07093,24740,26174,50914
2026,Chiapas,07,Teopisca,07094,24735,26201,50936
2026,Chiapas,07,Tila,07096,46273,46229,92502
2026,Chiapas,07,Tonalá,07097,52407,54029,106436
2026,Chiapas,07,Totolapa,07098,4283,4239,8522
2026,Chiapas,07,Tumbalá,07100,19630,20651,40281
2026,Chiapas,07,Tuxtla Chico,07102,24439,26045,50484
2026,Chiapas,07,Tuxtla Gutiérrez,07101,339992,377071,717063
2026,Chiapas,07,Tuzantán,07103,18929,19484,38413
2026,Chiapas,07,Tzimol,07104,8974,9415,18389
2026,Chiapas,07,Unión Juárez,07105,8959,9459,18418
2026,Chiapas,07,Venustiano Carranza,07106,38060,38513,76573
2026,Chiapas,07,Villa Comaltitlán,07071,16855,17246,34101
2026,Chiapas,07,Villa Corzo,07107,45469,47148,92617
2026,Chiapas,07,Villaflores,07108,61332,64280,125612
2026,Chiapas,07,Yajalón,07109,21999,23076,45075
2026,Chiapas,07,Zinacantán,07111,22529,25732,48261
2026,Chihuahua,08,Ahumada,08001,6897,6759,13656
2026,Chihuahua,08,Aldama,08002,13907,14045,27952
2026,Chihuahua,08,Allende,08003,5230,5110,10340
2026,Chihuahua,08,Aquiles Serdán,08004,10434,10037,20471
2026,Chihuahua,08,Ascensión,08005,13907,13606,27513
2026,Chihuahua,08,Bachíniva,08006,3804,3657,7461
2026,Chihuahua,08,Balleza,08007,9407,9131,18538
2026,Chihuahua,08,Batopilas,08008,6518,6545,13063
2026,Chihuahua,08,Bocoyna,08009,15073,15755,30828
2026,Chihuahua,08,Buenaventura,08010,13360,13065,26425
2026,Chihuahua,08,Camargo,08011,28990,30115,59105
2026,Chihuahua,08,Carichí,08012,5544,5418,10962
2026,Chihuahua,08,Casas Grandes,08013,6753,6435,13188
2026,Chihuahua,08,Chihuahua,08019,489134,517953,1007087
2026,Chihuahua,08,Chínipas,08020,4702,4260,8962
2026,Chihuahua,08,Coronado,08014,1362,1255,2617
2026,Chihuahua,08,Coyame del Sotol,08015,1113,911,2024
2026,Chihuahua,08,Cuauhtémoc,08017,93742,100020,193762
2026,Chihuahua,08,Cusihuiriachi,08018,2863,2649,5512
2026,Chihuahua,08,Delicias,08021,83323,87797,171120
2026,Chihuahua,08,Dr. Belisario Domínguez,08022,1630,1578,3208
2026,Chihuahua,08,El Tule,08064,1022,984,2006
2026,Chihuahua,08,Galeana,08023,3736,3733,7469
2026,Chihuahua,08,Gran Morelos,08026,1591,1529,3120
2026,Chihuahua,08,Guachochi,08027,25151,26423,51574
2026,Chihuahua,08,Guadalupe,08028,2421,2472,4893
2026,Chihuahua,08,Guadalupe y Calvo,08029,30473,29868,60341
2026,Chihuahua,08,Guazapares,08030,4658,4449,9107
2026,Chihuahua,08,Guerrero,08031,22961,22594,45555
2026,Chihuahua,08,Gómez Farías,08025,5282,5241,10523
2026,Chihuahua,08,Hidalgo del Parral,08032,60168,64270,124438
2026,Chihuahua,08,Huejotitán,08033,599,601,1200
2026,Chihuahua,08,Ignacio Zaragoza,08034,4143,4063,8206
2026,Chihuahua,08,Janos,08035,6612,6044,12656
2026,Chihuahua,08,Jiménez,08036,24002,24459,48461
2026,Chihuahua,08,Julimes,08038,2699,2614,5313
2026,Chihuahua,08,Juárez,08037,754370,758177,1512547
2026,Chihuahua,08,La Cruz,08016,2345,2225,4570
2026,Chihuahua,08,López,08039,2458,2281,4739
2026,Chihuahua,08,Madera,08040,16471,16286,32757
2026,Chihuahua,08,Maguarichi,08041,904,854,1758
2026,Chihuahua,08,Manuel Benavides,08042,947,801,1748
2026,Chihuahua,08,Matachí,08043,1828,1808,3636
2026,Chihuahua,08,Matamoros,08044,2698,2592,5290
2026,Chihuahua,08,Meoqui,08045,25315,25876,51191
2026,Chihuahua,08,Morelos,08046,4263,4185,8448
2026,Chihuahua,08,Moris,08047,3005,2825,5830
2026,Chihuahua,08,Namiquipa,08048,14522,13842,28364
2026,Chihuahua,08,Nonoava,08049,1572,1486,3058
2026,Chihuahua,08,Nuevo Casas Grandes,08050,34924,36543,71467
2026,Chihuahua,08,Ocampo,08051,4380,4069,8449
2026,Chihuahua,08,Ojinaga,08052,16285,16086,32371
2026,Chihuahua,08,Praxedis G. Guerrero,08053,2602,2557,5159
2026,Chihuahua,08,Riva Palacio,08054,4459,4285,8744
2026,Chihuahua,08,Rosales,08055,9896,9732,19628
2026,Chihuahua,08,Rosario,08056,1239,1170,2409
2026,Chihuahua,08,San Francisco de Borja,08057,1425,1339,2764
2026,Chihuahua,08,San Francisco de Conchos,08058,1586,1485,3071
2026,Chihuahua,08,San Francisco del Oro,08059,3111,3102,6213
2026,Chihuahua,08,Santa Bárbara,08060,6288,6408,12696
2026,Chihuahua,08,Santa Isabel,08024,2321,2373,4694
2026,Chihuahua,08,Satevó,08061,1926,1811,3737
2026,Chihuahua,08,Saucillo,08062,18406,18212,36618
2026,Chihuahua,08,Temósachic,08063,3949,3778,7727
2026,Chihuahua,08,Urique,08065,11899,11520,23419
2026,Chihuahua,08,Uruachi,08066,3383,3205,6588
2026,Chihuahua,08,Valle de Zaragoza,08067,3231,3081,6312
2026,Ciudad de México,09,Azcapotzalco,09002,190228,215624,405852
2026,Ciudad de México,09,Benito Juárez,09014,204333,240814,445147
2026,Ciudad de México,09,Coyoacán,09003,289316,328888,618204
2026,Ciudad de México,09,Cuajimalpa de Morelos,09004,94169,101183,195352
2026,Ciudad de México,09,Cuauhtémoc,09015,260603,289837,550440
2026,Ciudad de México,09,Gustavo A. Madero,09005,557076,605937,1163013
2026,Ciudad de México,09,Iztacalco,09006,185241,206532,391773
2026,Ciudad de México,09,Iztapalapa,09007,853518,907323,1760841
2026,Ciudad de México,09,La Magdalena Contreras,09008,115668,124831,240499
2026,Ciudad de México,09,Miguel Hidalgo,09016,176621,206059,382680
2026,Ciudad de México,09,Milpa Alta,09009,66289,69171,135460
2026,Ciudad de México,09,Tlalpan,09012,321184,350609,671793
2026,Ciudad de México,09,Tláhuac,09011,170536,183330,353866
2026,Ciudad de México,09,Venustiano Carranza,09017,202500,229081,431581
2026,Ciudad de México,09,Xochimilco,09013,197685,206853,404538
2026,Ciudad de México,09,Álvaro Obregón,09010,355611,390399,746010
2026,Coahuila,05,Abasolo,05001,632,624,1256
2026,Coahuila,05,Acuña,05002,86021,85344,171365
2026,Coahuila,05,Allende,05003,13074,13392,26466
2026,Coahuila,05,Arteaga,05004,14118,13457,27575
2026,Coahuila,05,Candela,05005,1119,1016,2135
2026,Coahuila,05,Castaños,05006,16560,16483,33043
2026,Coahuila,05,Cuatro Ciénegas,05007,7985,7817,15802
2026,Coahuila,05,Escobedo,05008,1870,1779,3649
2026,Coahuila,05,Francisco I. Madero,05009,35011,35056,70067
2026,Coahuila,05,Frontera,05010,47572,47087,94659
2026,Coahuila,05,General Cepeda,05011,7693,7043,14736
2026,Coahuila,05,Guerrero,05012,1122,998,2120
2026,Coahuila,05,Hidalgo,05013,1019,976,1995
2026,Coahuila,05,Jiménez,05014,5959,5756,11715
2026,Coahuila,05,Juárez,05015,980,891,1871
2026,Coahuila,05,Lamadrid,05016,1130,1060,2190
2026,Coahuila,05,Matamoros,05017,64178,63897,128075
2026,Coahuila,05,Monclova,05018,134644,136697,271341
2026,Coahuila,05,Morelos,05019,5177,5047,10224
2026,Coahuila,05,Múzquiz,05020,41469,40555,82024
2026,Coahuila,05,Nadadores,05021,3900,3835,7735
2026,Coahuila,05,Nava,05022,18107,17153,35260
2026,Coahuila,05,Ocampo,05023,6298,5810,12108
2026,Coahuila,05,Parras,05024,26519,25348,51867
2026,Coahuila,05,Piedras Negras,05025,94735,93923,188658
2026,Coahuila,05,Progreso,05026,2054,1908,3962
2026,Coahuila,05,Ramos Arizpe,05027,57488,55064,112552
2026,Coahuila,05,Sabinas,05028,37671,37487,75158
2026,Coahuila,05,Sacramento,05029,1442,1397,2839
2026,Coahuila,05,Saltillo,05030,465663,468924,934587
2026,Coahuila,05,San Buenaventura,05031,14089,14072,28161
2026,Coahuila,05,San Juan de Sabinas,05032,25186,26278,51464
2026,Coahuila,05,San Pedro,05033,63903,64020,127923
2026,Coahuila,05,Sierra Mojada,05034,4537,4168,8705
2026,Coahuila,05,Torreón,05035,392233,411366,803599
2026,Coahuila,05,Viesca,05036,13209,12664,25873
2026,Coahuila,05,Villa Unión,05037,3773,3577,7350
2026,Coahuila,05,Zaragoza,05038,7629,7564,15193
2026,Colima,06,Armería,06001,17909,17510,35419
2026,Colima,06,Colima,06002,90233,95196,185429
2026,Colima,06,Comala,06003,13098,12873,25971
2026,Colima,06,Coquimatlán,06004,12229,11881,24110
2026,Colima,06,Cuauhtémoc,06005,18197,17880,36077
2026,Colima,06,Ixtlahuacán,06006,3394,3304,6698
2026,Colima,06,Manzanillo,06007,112087,109063,221150
2026,Colima,06,Minatitlán,06008,5542,5048,10590
2026,Colima,06,Tecomán,06009,73879,72105,145984
2026,Colima,06,Villa de Álvarez,06010,79643,83262,162905
2026,Durango,10,Canatlán,10001,18162,18631,36793
2026,Durango,10,Canelas,10002,2621,2396,5017
2026,Durango,10,Coneto de Comonfort,10003,2426,2441,4867
2026,Durango,10,Cuencamé,10004,19877,19534,39411
2026,Durango,10,Durango,10005,352303,377371,729674
2026,Durango,10,El Oro,10018,6565,6647,13212
2026,Durango,10,General Simón Bolívar,10006,5653,5743,11396
2026,Durango,10,Guadalupe Victoria,10008,19656,20016,39672
2026,Durango,10,Guanaceví,10009,5668,5307,10975
2026,Durango,10,Gómez Palacio,10007,190437,194930,385367
2026,Durango,10,Hidalgo,10010,2233,2173,4406
2026,Durango,10,Indé,10011,2956,2919,5875
2026,Durango,10,Lerdo,10012,85708,86656,172364
2026,Durango,10,Mapimí,10013,14894,14850,29744
2026,Durango,10,Mezquital,10014,20569,21251,41820
2026,Durango,10,Nazas,10015,7358,7363,14721
2026,Durango,10,Nombre de Dios,10016,11046,11088,22134
2026,Durango,10,Nuevo Ideal,10039,15132,15289,30421
2026,Durango,10,Ocampo,10017,5674,5451,11125
2026,Durango,10,Otáez,10019,2942,2706,5648
2026,Durango,10,Peñón Blanco,10021,6126,6034,12160
2026,Durango,10,Poanas,10022,14035,14339,28374
2026,Durango,10,Pueblo Nuevo,10023,26959,27181,54140
2026,Durango,10,Pánuco de Coronado,10020,6745,6913,13658
2026,Durango,10,Rodeo,10024,7724,7667,15391
2026,Durango,10,San Bernardo,10025,1972,1752,3724
2026,Durango,10,San Dimas,10026,10667,10015,20682
2026,Durango,10,San Juan de Guadalupe,10027,3054,3162,6216
2026,Durango,10,San Juan del Río,10028,7028,7158,14186
2026,Durango,10,San Luis del Cordero,10029,1217,1181,2398
2026,Durango,10,San Pedro del Gallo,10030,918,837,1755
2026,Durango,10,Santa Clara,10031,3977,3964,7941
2026,Durango,10,Santiago Papasquiaro,10032,26798,26813,53611
2026,Durango,10,Súchil,10033,3362,3653,7015
2026,Durango,10,Tamazula,10034,14426,13180,27606
2026,Durango,10,Tepehuanes,10035,6043,6086,12129
2026,Durango,10,Tlahualilo,10036,13505,13253,26758
2026,Durango,10,Topia,10037,5375,4997,10372
2026,Durango,10,Vicente Guerrero,10038,11782,12496,24278
2026,Estado de México,15,Acambay de Ruíz Castañeda,15001,35638,37675,73313
2026,Estado de México,15,Acolman,15002,100280,100026,200306
2026,Estado de México,15,Aculco,15003,27281,27791,55072
2026,Estado de México,15,Almoloya de Alquisiras,15004,7830,8453,16283
2026,Estado de México,15,Almoloya de Juárez,15005,98531,100424,198955
2026,Estado de México,15,Almoloya del Río,15006,6234,6662,12896
2026,Estado de México,15,Amanalco,15007,13292,13770,27062
2026,Estado de México,15,Amatepec,15008,14782,15540,30322
2026,Estado de México,15,Amecameca,15009,27727,29628,57355
2026,Estado de México,15,Apaxco,15010,16435,16812,33247
2026,Estado de México,15,Atenco,15011,36763,37583,74346
2026,Estado de México,15,Atizapán,15012,6391,6743,13134
2026,Estado de México,15,Atizapán de Zaragoza,15013,283354,300634,583988
2026,Estado de México,15,Atlacomulco,15014,54070,58721,112791
2026,Estado de México,15,Atlautla,15015,17001,17659,34660
2026,Estado de México,15,Axapusco,15016,15936,16050,31986
2026,Estado de México,15,Ayapango,15017,5825,6043,11868
2026,Estado de México,15,Calimaya,15018,31402,32820,64222
2026,Estado de México,15,Capulhuac,15019,19444,20622,40066
2026,Estado de México,15,Chalco,15025,212000,219928,431928
2026,Estado de México,15,Chapa de Mota,15026,15658,16282,31940
2026,Estado de México,15,Chapultepec,15027,6889,7065,13954
2026,Estado de México,15,Chiautla,15028,16674,17235,33909
2026,Estado de México,15,Chicoloapan,15029,116594,123731,240325
2026,Estado de México,15,Chiconcuac,15030,14478,14838,29316
2026,Estado de México,15,Chimalhuacán,15031,366533,378666,745199
2026,Estado de México,15,Coacalco de Berriozábal,15020,155409,167971,323380
2026,Estado de México,15,Coatepec Harinas,15021,21209,22656,43865
2026,Estado de México,15,Cocotitlán,15022,7998,8377,16375
2026,Estado de México,15,Coyotepec,15023,22663,23094,45757
2026,Estado de México,15,Cuautitlán,15024,91684,93684,185368
2026,Estado de México,15,Cuautitlán Izcalli,15121,295428,310996,606424
2026,Estado de México,15,Donato Guerra,15032,18439,19054,37493
2026,Estado de México,15,Ecatepec de Morelos,15033,881884,905540,1787424
2026,Estado de México,15,Ecatzingo,15034,5182,5324,10506
2026,Estado de México,15,El Oro,15064,20211,21550,41761
2026,Estado de México,15,Huehuetoca,15035,78152,80018,158170
2026,Estado de México,15,Hueypoxtla,15036,24986,24421,49407
2026,Estado de México,15,Huixquilucan,15037,148420,158984,307404
2026,Estado de México,15,Isidro Fabela,15038,6555,6637,13192
2026,Estado de México,15,Ixtapaluca,15039,281683,291655,573338
2026,Estado de México,15,Ixtapan de la Sal,15040,19533,20913,40446
2026,Estado de México,15,Ixtapan del Oro,15041,3897,3790,7687
2026,Estado de México,15,Ixtlahuaca,15042,82938,88776,171714
2026,Estado de México,15,Jaltenco,15044,14682,15595,30277
2026,Estado de México,15,Jilotepec,15045,49414,50911,100325
2026,Estado de México,15,Jilotzingo,15046,10598,11174,21772
2026,Estado de México,15,Jiquipilco,15047,40507,43014,83521
2026,Estado de México,15,Jocotitlán,15048,35958,38422,74380
2026,Estado de México,15,Joquicingo,15049,7599,7881,15480
2026,Estado de México,15,Juchitepec,15050,14158,14537,28695
2026,Estado de México,15,La Paz,15070,160534,164274,324808
2026,Estado de México,15,Lerma,15051,83745,85913,169658
2026,Estado de México,15,Luvianos,15123,15595,15775,31370
2026,Estado de México,15,Malinalco,15052,15459,15827,31286
2026,Estado de México,15,Melchor Ocampo,15053,31938,33225,65163
2026,Estado de México,15,Metepec,15054,125792,133746,259538
2026,Estado de México,15,Mexicaltzingo,15055,7053,7502,14555
2026,Estado de México,15,Morelos,15056,16150,17476,33626
2026,Estado de México,15,Naucalpan de Juárez,15057,470332,498684,969016
2026,Estado de México,15,Nextlalpan,15059,22988,23427,46415
2026,Estado de México,15,Nezahualcóyotl,15058,582331,627577,1209908
2026,Estado de México,15,Nicolás Romero,15060,228701,237952,466653
2026,Estado de México,15,Nopaltepec,15061,5106,5127,10233
2026,Estado de México,15,Ocoyoacac,15062,37317,38528,75845
2026,Estado de México,15,Ocuilan,15063,18952,19623,38575
2026,Estado de México,15,Otumba,15065,20293,19967,40260
2026,Estado de México,15,Otzoloapan,15066,2181,2123,4304
2026,Estado de México,15,Otzolotepec,15067,46995,48084,95079
2026,Estado de México,15,Ozumba,15068,15849,17056,32905
2026,Estado de México,15,Papalotla,15069,2220,2338,4558
2026,Estado de México,15,Polotitlán,15071,7884,8180,16064
2026,Estado de México,15,Rayón,15072,7627,7844,15471
2026,Estado de México,15,San Antonio la Isla,15073,16889,17245,34134
2026,Estado de México,15,San Felipe del Progreso,15074,68035,76072,144107
2026,Estado de México,15,San José del Rincón,15124,50177,51174,101351
2026,Estado de México,15,San Martín de las Pirámides,15075,15269,15586,30855
2026,Estado de México,15,San Mateo Atenco,15076,41430,42794,84224
2026,Estado de México,15,San Simón de Guerrero,15077,3331,3526,6857
2026,Estado de México,15,Santo Tomás,15078,5342,5462,10804
2026,Estado de México,15,Soyaniquilpan de Juárez,15079,7583,7704,15287
2026,Estado de México,15,Sultepec,15080,14110,15608,29718
2026,Estado de México,15,Tecámac,15081,262614,274666,537280
2026,Estado de México,15,Tejupilco,15082,40240,43331,83571
2026,Estado de México,15,Temamatla,15083,6993,7377,14370
2026,Estado de México,15,Temascalapa,15084,21918,21888,43806
2026,Estado de México,15,Temascalcingo,15085,33943,36764,70707
2026,Estado de México,15,Temascaltepec,15086,17661,18315,35976
2026,Estado de México,15,Temoaya,15087,55819,58913,114732
2026,Estado de México,15,Tenancingo,15088,54150,57081,111231
2026,Estado de México,15,Tenango del Aire,15089,7045,7202,14247
2026,Estado de México,15,Tenango del Valle,15090,47549,49368,96917
2026,Estado de México,15,Teoloyucan,15091,34921,35651,70572
2026,Estado de México,15,Teotihuacán,15092,31573,32557,64130
2026,Estado de México,15,Tepetlaoxtoc,15093,17375,17622,34997
2026,Estado de México,15,Tepetlixpa,15094,11036,11302,22338
2026,Estado de México,15,Tepotzotlán,15095,54375,56206,110581
2026,Estado de México,15,Tequixquiac,15096,20854,21014,41868
2026,Estado de México,15,Texcaltitlán,15097,10286,10884,21170
2026,Estado de México,15,Texcalyacac,15098,2964,3046,6010
2026,Estado de México,15,Texcoco,15099,133693,142045,275738
2026,Estado de México,15,Tezoyuca,15100,24805,25002,49807
2026,Estado de México,15,Tianguistenco,15101,42207,44454,86661
2026,Estado de México,15,Timilpan,15102,8542,9237,17779
2026,Estado de México,15,Tlalmanalco,15103,26169,28118,54287
2026,Estado de México,15,Tlalnepantla de Baz,15104,393702,421126,814828
2026,Estado de México,15,Tlatlaya,15105,19841,20537,40378
2026,Estado de México,15,Toluca,15106,482913,517185,1000098
2026,Estado de México,15,Tonanitla,15125,5486,5618,11104
2026,Estado de México,15,Tonatico,15107,7058,7506,14564
2026,Estado de México,15,Tultepec,15108,82920,85888,168808
2026,Estado de México,15,Tultitlán,15109,283596,294318,577914
2026,Estado de México,15,Valle de Bravo,15110,35943,37274,73217
2026,Estado de México,15,Valle de Chalco Solidaridad,15122,216331,223383,439714
2026,Estado de México,15,Villa Guerrero,15113,37335,38294,75629
2026,Estado de México,15,Villa Victoria,15114,57659,58344,116003
2026,Estado de México,15,Villa de Allende,15111,27999,29181,57180
2026,Estado de México,15,Villa del Carbón,15112,26667,26346,53013
2026,Estado de México,15,Xalatlaco,15043,16598,17458,34056
2026,Estado de México,15,Xonacatlán,15115,28633,28344,56977
2026,Estado de México,15,Zacazonapan,15116,2265,2233,4498
2026,Estado de México,15,Zacualpan,15117,8153,8946,17099
2026,Estado de México,15,Zinacantepec,15118,105331,107975,213306
2026,Estado de México,15,Zumpahuacán,15119,8930,9722,18652
2026,Estado de México,15,Zumpango,15120,112135,119543,231678
2026,Guanajuato,11,Abasolo,11001,48665,51428,100093
2026,Guanajuato,11,Acámbaro,11002,60742,65496,126238
2026,Guanajuato,11,Apaseo el Alto,11004,36757,38459,75216
2026,Guanajuato,11,Apaseo el Grande,11005,50462,53449,103911
2026,Guanajuato,11,Atarjea,11006,2871,2965,5836
2026,Guanajuato,11,Celaya,11007,269451,285208,554659
2026,Guanajuato,11,Comonfort,11009,42995,47633,90628
2026,Guanajuato,11,Coroneo,11010,6460,7220,13680
2026,Guanajuato,11,Cortazar,11011,51667,54654,106321
2026,Guanajuato,11,Cuerámaro,11012,15176,16306,31482
2026,Guanajuato,11,Doctor Mora,11013,12761,13728,26489
2026,Guanajuato,11,Dolores Hidalgo Cuna de la Independencia Nacional,11014,78428,87462,165890
2026,Guanajuato,11,Guanajuato,11015,101526,105971,207497
2026,Guanajuato,11,Huanímaro,11016,11334,12484,23818
2026,Guanajuato,11,Irapuato,11017,311727,327657,639384
2026,Guanajuato,11,Jaral del Progreso,11018,21501,22030,43531
2026,Guanajuato,11,Jerécuaro,11019,24987,28504,53491
2026,Guanajuato,11,León,11020,867676,882726,1750402
2026,Guanajuato,11,Manuel Doblado,11008,20535,22193,42728
2026,Guanajuato,11,Moroleón,11021,27609,30209,57818
2026,Guanajuato,11,Ocampo,11022,12521,13306,25827
2026,Guanajuato,11,Pueblo Nuevo,11024,6403,7043,13446
2026,Guanajuato,11,Purísima del Rincón,11025,45212,44951,90163
2026,Guanajuato,11,Pénjamo,11023,80135,87261,167396
2026,Guanajuato,11,Romita,11026,31842,33344,65186
2026,Guanajuato,11,Salamanca,11027,150467,158363,308830
2026,Guanajuato,11,Salvatierra,11028,54199,59407,113606
2026,Guanajuato,11,San Diego de la Unión,11029,20221,23185,43406
2026,Guanajuato,11,San Felipe,11030,59983,63390,123373
2026,Guanajuato,11,San Francisco del Rincón,11031,63691,66823,130514
2026,Guanajuato,11,San José Iturbide,11032,42397,44810,87207
2026,Guanajuato,11,San Luis de la Paz,11033,62970,69204,132174
2026,Guanajuato,11,San Miguel de Allende,11003,92265,99449,191714
2026,Guanajuato,11,Santa Catarina,11034,2785,3064,5849
2026,Guanajuato,11,Santa Cruz de Juventino Rosas,11035,44672,47710,92382
2026,Guanajuato,11,Santiago Maravatío,11036,3808,4169,7977
2026,Guanajuato,11,Silao de la Victoria,11037,103870,106310,210180
2026,Guanajuato,11,Tarandacuao,11038,6622,7273,13895
2026,Guanajuato,11,Tarimoro,11039,18830,19690,38520
2026,Guanajuato,11,Tierra Blanca,11040,10172,10911,21083
2026,Guanajuato,11,Uriangato,11041,34290,36519,70809
2026,Guanajuato,11,Valle de Santiago,11042,77097,84481,161578
2026,Guanajuato,11,Victoria,11043,10639,11882,22521
2026,Guanajuato,11,Villagrán,11044,32134,33459,65593
2026,Guanajuato,11,Xichú,11045,6171,6757,12928
2026,Guanajuato,11,Yuriria,11046,37395,40937,78332
2026,Guerrero,12,Acapulco de Juárez,12001,411329,444811,856140
2026,Guerrero,12,Acatepec,12076,18580,19531,38111
2026,Guerrero,12,Ahuacuotzingo,12002,12954,14694,27648
2026,Guerrero,12,Ajuchitlán del Progreso,12003,18972,20135,39107
2026,Guerrero,12,Alcozauca de Guerrero,12004,9524,10845,20369
2026,Guerrero,12,Alpoyeca,12005,3345,3726,7071
2026,Guerrero,12,Apaxtla,12006,5726,6194,11920
2026,Guerrero,12,Arcelia,12007,15992,16987,32979
2026,Guerrero,12,Atenango del Río,12008,4393,4750,9143
2026,Guerrero,12,Atlamajalcingo del Monte,12009,2455,2739,5194
2026,Guerrero,12,Atlixtac,12010,13627,14537,28164
2026,Guerrero,12,Atoyac de Álvarez,12011,31236,32385,63621
2026,Guerrero,12,Ayutla de los Libres,12012,34514,35996,70510
2026,Guerrero,12,Azoyú,12013,6463,6833,13296
2026,Guerrero,12,Benito Juárez,12014,8031,8455,16486
2026,Guerrero,12,Buenavista de Cuéllar,12015,6852,7207,14059
2026,Guerrero,12,Chilapa de Álvarez,12028,63966,71140,135106
2026,Guerrero,12,Chilpancingo de los Bravo,12029,138678,151161,289839
2026,Guerrero,12,Coahuayutla de José María Izazaga,12016,6467,6136,12603
2026,Guerrero,12,Cochoapa el Grande,12078,8928,9871,18799
2026,Guerrero,12,Cocula,12017,6941,7412,14353
2026,Guerrero,12,Copala,12018,7361,7615,14976
2026,Guerrero,12,Copalillo,12019,7226,7921,15147
2026,Guerrero,12,Copanatoyac,12020,9963,10962,20925
2026,Guerrero,12,Coyuca de Benítez,12021,39403,40878,80281
2026,Guerrero,12,Coyuca de Catalán,12022,20597,20067,40664
2026,Guerrero,12,Cuajinicuilapa,12023,14280,14166,28446
2026,Guerrero,12,Cualác,12024,3835,4083,7918
2026,Guerrero,12,Cuautepec,12025,8336,8381,16717
2026,Guerrero,12,Cuetzala del Progreso,12026,4465,4692,9157
2026,Guerrero,12,Cutzamala de Pinzón,12027,10321,10675,20996
2026,Guerrero,12,Eduardo Neri,12075,26501,27633,54134
2026,Guerrero,12,Florencio Villarreal,12030,10770,11012,21782
2026,Guerrero,12,General Canuto A. Neri,12031,2932,3168,6100
2026,Guerrero,12,General Heliodoro Castillo,12032,18864,18841,37705
2026,Guerrero,12,Huamuxtitlán,12033,7581,8515,16096
2026,Guerrero,12,Huitzuco de los Figueroa,12034,19104,20621,39725
2026,Guerrero,12,Iguala de la Independencia,12035,77867,83770,161637
2026,Guerrero,12,Igualapa,12036,5728,5907,11635
2026,Guerrero,12,Iliatenco,12081,5394,5975,11369
2026,Guerrero,12,Ixcateopan de Cuauhtémoc,12037,3146,3483,6629
2026,Guerrero,12,José Joaquín de Herrera,12079,8907,9093,18000
2026,Guerrero,12,Juan R. Escudero,12039,12754,13401,26155
2026,Guerrero,12,Juchitán,12080,4056,3977,8033
2026,Guerrero,12,La Unión de Isidoro Montes de Oca,12068,14016,13367,27383
2026,Guerrero,12,Leonardo Bravo,12040,13433,13693,27126
2026,Guerrero,12,Malinaltepec,12041,13088,14794,27882
2026,Guerrero,12,Marquelia,12077,7178,7270,14448
2026,Guerrero,12,Metlatónoc,12043,8658,9983,18641
2026,Guerrero,12,Mochitlán,12044,6660,6944,13604
2026,Guerrero,12,Mártir de Cuilapan,12042,9413,10319,19732
2026,Guerrero,12,Olinalá,12045,12839,13804,26643
2026,Guerrero,12,Ometepec,12046,34476,36249,70725
2026,Guerrero,12,Pedro Ascencio Alquisiras,12047,3304,3830,7134
2026,Guerrero,12,Petatlán,12048,22634,23101,45735
2026,Guerrero,12,Pilcaya,12049,6625,7011,13636
2026,Guerrero,12,Pungarabato,12050,18799,20050,38849
2026,Guerrero,12,Quechultenango,12051,18250,19046,37296
2026,Guerrero,12,San Luis Acatlán,12052,22133,22765,44898
2026,Guerrero,12,San Marcos,12053,25487,26268,51755
2026,Guerrero,12,San Miguel Totolapan,12054,13843,14409,28252
2026,Guerrero,12,Taxco de Alarcón,12055,54844,59942,114786
2026,Guerrero,12,Tecoanapa,12056,23644,24333,47977
2026,Guerrero,12,Teloloapan,12058,28651,32171,60822
2026,Guerrero,12,Tepecoacuilco de Trujano,12059,16447,17816,34263
2026,Guerrero,12,Tetipac,12060,7437,7836,15273
2026,Guerrero,12,Tixtla de Guerrero,12061,21774,23614,45388
2026,Guerrero,12,Tlacoachistlahuaca,12062,11536,13011,24547
2026,Guerrero,12,Tlacoapa,12063,5043,5602,10645
2026,Guerrero,12,Tlalchapa,12064,6675,6670,13345
2026,Guerrero,12,Tlalixtaquilla de Maldonado,12065,3756,4050,7806
2026,Guerrero,12,Tlapa de Comonfort,12066,45026,50074,95100
2026,Guerrero,12,Tlapehuala,12067,11101,11907,23008
2026,Guerrero,12,Técpan de Galeana,12057,34174,34696,68870
2026,Guerrero,12,Xalpatláhuac,12069,5644,6616,12260
2026,Guerrero,12,Xochihuehuetlán,12070,3553,4010,7563
2026,Guerrero,12,Xochistlahuaca,12071,14733,15638,30371
2026,Guerrero,12,Zapotitlán Tablas,12072,6500,7159,13659
2026,Guerrero,12,Zihuatanejo de Azueta,12038,65247,67014,132261
2026,Guerrero,12,Zirándaro,12073,9319,8903,18222
2026,Guerrero,12,Zitlala,12074,11429,12807,24236
2026,Hidalgo,13,Acatlán,13001,11258,12048,23306
2026,Hidalgo,13,Acaxochitlán,13002,23346,25339,48685
2026,Hidalgo,13,Actopan,13003,30909,34273,65182
2026,Hidalgo,13,Agua Blanca de Iturbide,13004,4859,5399,10258
2026,Hidalgo,13,Ajacuba,13005,10412,10823,21235
2026,Hidalgo,13,Alfajayucan,13006,11607,12254,23861
2026,Hidalgo,13,Almoloya,13007,6925,7005,13930
2026,Hidalgo,13,Apan,13008,24469,26574,51043
2026,Hidalgo,13,Atitalaquia,13010,16962,17331,34293
2026,Hidalgo,13,Atlapexco,13011,11052,11989,23041
2026,Hidalgo,13,Atotonilco de Tula,13013,21382,22549,43931
2026,Hidalgo,13,Atotonilco el Grande,13012,14905,16559,31464
2026,Hidalgo,13,Calnali,13014,9625,10432,20057
2026,Hidalgo,13,Cardonal,13015,10238,11082,21320
2026,Hidalgo,13,Chapantongo,13017,7715,8126,15841
2026,Hidalgo,13,Chapulhuacán,13018,13608,13429,27037
2026,Hidalgo,13,Chilcuautla,13019,10308,10603,20911
2026,Hidalgo,13,Cuautepec de Hinojosa,13016,31610,34623,66233
2026,Hidalgo,13,El Arenal,13009,10301,11187,21488
2026,Hidalgo,13,Eloxochitlán,13020,1527,1736,3263
2026,Hidalgo,13,Emiliano Zapata,13021,8014,8903,16917
2026,Hidalgo,13,Epazoyucan,13022,8355,8847,17202
2026,Hidalgo,13,Francisco I. Madero,13023,19904,21643,41547
2026,Hidalgo,13,Huasca de Ocampo,13024,9690,10567,20257
2026,Hidalgo,13,Huautla,13025,11800,12999,24799
2026,Hidalgo,13,Huazalingo,13026,7746,8207,15953
2026,Hidalgo,13,Huehuetla,13027,14045,14993,29038
2026,Hidalgo,13,Huejutla de Reyes,13028,72097,74958,147055
2026,Hidalgo,13,Huichapan,13029,25462,27567,53029
2026,Hidalgo,13,Ixmiquilpan,13030,50111,56092,106203
2026,Hidalgo,13,Jacala de Ledezma,13031,7408,8235,15643
2026,Hidalgo,13,Jaltocán,13032,6731,6937,13668
2026,Hidalgo,13,Juárez Hidalgo,13033,1758,1929,3687
2026,Hidalgo,13,La Misión,13040,5750,5903,11653
2026,Hidalgo,13,Lolotla,13034,5261,5552,10813
2026,Hidalgo,13,Metepec,13035,6201,7018,13219
2026,Hidalgo,13,Metztitlán,13037,11269,12461,23730
2026,Hidalgo,13,Mineral de la Reforma,13051,96175,105758,201933
2026,Hidalgo,13,Mineral del Chico,13038,5064,5365,10429
2026,Hidalgo,13,Mineral del Monte,13039,8063,8834,16897
2026,Hidalgo,13,Mixquiahuala de Juárez,13041,25706,27602,53308
2026,Hidalgo,13,Molango de Escamilla,13042,6554,6847,13401
2026,Hidalgo,13,Nicolás Flores,13043,3742,4203,7945
2026,Hidalgo,13,Nopala de Villagrán,13044,9554,9879,19433
2026,Hidalgo,13,Omitlán de Juárez,13045,5412,5873,11285
2026,Hidalgo,13,Pachuca de Soto,13048,139549,154094,293643
2026,Hidalgo,13,Pacula,13047,2670,3060,5730
2026,Hidalgo,13,Pisaflores,13049,9845,9810,19655
2026,Hidalgo,13,Progreso de Obregón,13050,12838,14277,27115
2026,Hidalgo,13,San Agustín Metzquititlán,13036,5321,5782,11103
2026,Hidalgo,13,San Agustín Tlaxiaca,13052,20545,21470,42015
2026,Hidalgo,13,San Bartolo Tutotepec,13053,10479,10791,21270
2026,Hidalgo,13,San Felipe Orizatlán,13046,21472,22395,43867
2026,Hidalgo,13,San Salvador,13054,19594,20981,40575
2026,Hidalgo,13,Santiago Tulantepec de Lugo Guerrero,13056,20301,22180,42481
2026,Hidalgo,13,Santiago de Anaya,13055,9619,10051,19670
2026,Hidalgo,13,Singuilucan,13057,9184,9388,18572
2026,Hidalgo,13,Tasquillo,13058,8582,10041,18623
2026,Hidalgo,13,Tecozautla,13059,20792,22359,43151
2026,Hidalgo,13,Tenango de Doria,13060,9892,10940,20832
2026,Hidalgo,13,Tepeapulco,13061,30386,32331,62717
2026,Hidalgo,13,Tepehuacán de Guerrero,13062,17494,16995,34489
2026,Hidalgo,13,Tepeji del Río de Ocampo,13063,48898,50197,99095
2026,Hidalgo,13,Tepetitlán,13064,6184,6516,12700
2026,Hidalgo,13,Tetepango,13065,6613,6637,13250
2026,Hidalgo,13,Tezontepec de Aldama,13067,29965,30622,60587
2026,Hidalgo,13,Tianguistengo,13068,8374,8760,17134
2026,Hidalgo,13,Tizayuca,13069,73326,75285,148611
2026,Hidalgo,13,Tlahuelilpan,13070,10847,11211,22058
2026,Hidalgo,13,Tlahuiltepa,13071,5883,5895,11778
2026,Hidalgo,13,Tlanalapa,13072,5772,6150,11922
2026,Hidalgo,13,Tlanchinol,13073,22099,22461,44560
2026,Hidalgo,13,Tlaxcoapan,13074,16035,16410,32445
2026,Hidalgo,13,Tolcayuca,13075,9189,9732,18921
2026,Hidalgo,13,Tula de Allende,13076,61353,65036,126389
2026,Hidalgo,13,Tulancingo de Bravo,13077,85273,94704,179977
2026,Hidalgo,13,Villa de Tezontepec,13066,6947,7261,14208
2026,Hidalgo,13,Xochiatipan,13078,10817,11545,22362
2026,Hidalgo,13,Xochicoatlán,13079,4428,4577,9005
2026,Hidalgo,13,Yahualica,13080,13476,14127,27603
2026,Hidalgo,13,Zacualtipán de Ángeles,13081,19157,20915,40072
2026,Hidalgo,13,Zapotlán de Juárez,13082,10352,11205,21557
2026,Hidalgo,13,Zempoala,13083,26706,28265,54971
2026,Hidalgo,13,Zimapán,13084,21014,24307,45321
2026,Jalisco,14,Acatic,14001,11861,12320,24181
2026,Jalisco,14,Acatlán de Juárez,14002,12636,12248,24884
2026,Jalisco,14,Ahualulco de Mercado,14003,12859,13250,26109
2026,Jalisco,14,Amacueca,14004,3019,3151,6170
2026,Jalisco,14,Amatitán,14005,8570,8640,17210
2026,Jalisco,14,Ameca,14006,34004,35292,69296
2026,Jalisco,14,Arandas,14008,39917,42949,82866
2026,Jalisco,14,Atemajac de Brizuela,14010,3688,3730,7418
2026,Jalisco,14,Atengo,14011,3296,3061,6357
2026,Jalisco,14,Atenguillo,14012,2232,2314,4546
2026,Jalisco,14,Atotonilco el Alto,14013,33645,34660,68305
2026,Jalisco,14,Atoyac,14014,4449,4786,9235
2026,Jalisco,14,Autlán de Navarro,14015,34161,35295,69456
2026,Jalisco,14,Ayotlán,14016,20840,21671,42511
2026,Jalisco,14,Ayutla,14017,7138,7085,14223
2026,Jalisco,14,Bolaños,14019,4371,4364,8735
2026,Jalisco,14,Cabo Corrientes,14020,6131,5632,11763
2026,Jalisco,14,Casimiro Castillo,14021,12420,12367,24787
2026,Jalisco,14,Cañadas de Obregón,14117,2358,2455,4813
2026,Jalisco,14,Chapala,14030,28410,29852,58262
2026,Jalisco,14,Chimaltitán,14031,1825,1867,3692
2026,Jalisco,14,Chiquilistlán,14032,3450,3384,6834
2026,Jalisco,14,Cihuatlán,14022,23656,23027,46683
2026,Jalisco,14,Cocula,14024,14803,15478,30281
2026,Jalisco,14,Colotlán,14025,9843,10523,20366
2026,Jalisco,14,Concepción de Buenos Aires,14026,3572,3431,7003
2026,Jalisco,14,Cuautitlán de García Barragán,14027,10138,9862,20000
2026,Jalisco,14,Cuautla,14028,1213,1295,2508
2026,Jalisco,14,Cuquío,14029,9915,10733,20648
2026,Jalisco,14,Degollado,14033,11773,12427,24200
2026,Jalisco,14,Ejutla,14034,1145,1065,2210
2026,Jalisco,14,El Arenal,14009,11064,11125,22189
2026,Jalisco,14,El Grullo,14037,13551,14345,27896
2026,Jalisco,14,El Limón,14054,3202,3199,6401
2026,Jalisco,14,El Salto,14070,105290,105898,211188
2026,Jalisco,14,Encarnación de Díaz,14035,29168,31179,60347
2026,Jalisco,14,Etzatlán,14036,10959,11489,22448
2026,Jalisco,14,Guachinango,14038,2493,2398,4891
2026,Jalisco,14,Guadalajara,14039,767975,817056,1585031
2026,Jalisco,14,Gómez Farías,14079,7830,8350,16180
2026,Jalisco,14,Hostotipaquillo,14040,6254,5401,11655
2026,Jalisco,14,Huejuquilla el Alto,14042,4867,5240,10107
2026,Jalisco,14,Huejúcar,14041,3219,3523,6742
2026,Jalisco,14,Ixtlahuacán de los Membrillos,14044,32076,32565,64641
2026,Jalisco,14,Ixtlahuacán del Río,14045,10478,11082,21560
2026,Jalisco,14,Jalostotitlán,14046,18805,19209,38014
2026,Jalisco,14,Jamay,14047,14029,13987,28016
2026,Jalisco,14,Jesús María,14048,9919,11706,21625
2026,Jalisco,14,Jilotlán de los Dolores,14049,5440,5170,10610
2026,Jalisco,14,Jocotepec,14050,25938,26242,52180
2026,Jalisco,14,Juanacatlán,14051,10272,10206,20478
2026,Jalisco,14,Juchitlán,14052,3141,3302,6443
2026,Jalisco,14,La Barca,14018,35709,37848,73557
2026,Jalisco,14,La Huerta,14043,14167,13561,27728
2026,Jalisco,14,La Manzanilla de la Paz,14057,2077,2217,4294
2026,Jalisco,14,Lagos de Moreno,14053,90277,93892,184169
2026,Jalisco,14,Magdalena,14055,12714,12679,25393
2026,Jalisco,14,Mascota,14058,8255,8508,16763
2026,Jalisco,14,Mazamitla,14059,7622,8243,15865
2026,Jalisco,14,Mexticacán,14060,2626,3070,5696
2026,Jalisco,14,Mezquitic,14061,10562,11203,21765
2026,Jalisco,14,Mixtlán,14062,2029,1998,4027
2026,Jalisco,14,Ocotlán,14063,54711,56592,111303
2026,Jalisco,14,Ojuelos de Jalisco,14064,17352,18216,35568
2026,Jalisco,14,Pihuamo,14065,6483,6383,12866
2026,Jalisco,14,Poncitlán,14066,28428,29126,57554
2026,Jalisco,14,Puerto Vallarta,14067,158694,154900,313594
2026,Jalisco,14,Quitupan,14069,4482,4967,9449
2026,Jalisco,14,San Cristóbal de la Barranca,14071,1673,1662,3335
2026,Jalisco,14,San Diego de Alejandría,14072,3940,4208,8148
2026,Jalisco,14,San Gabriel,14113,9160,9480,18640
2026,Jalisco,14,San Ignacio Cerro Gordo,14125,10280,10896,21176
2026,Jalisco,14,San Juan de los Lagos,14073,38759,39165,77924
2026,Jalisco,14,San Juanito de Escobedo,14007,5339,5245,10584
2026,Jalisco,14,San Julián,14074,8594,9436,18030
2026,Jalisco,14,San Marcos,14075,2163,2115,4278
2026,Jalisco,14,San Martín Hidalgo,14077,15482,16156,31638
2026,Jalisco,14,San Martín de Bolaños,14076,1688,1692,3380
2026,Jalisco,14,San Miguel el Alto,14078,18091,18984,37075
2026,Jalisco,14,San Pedro Tlaquepaque,14098,368224,371677,739901
2026,Jalisco,14,San Sebastián del Oeste,14080,3352,3000,6352
2026,Jalisco,14,Santa María de los Ángeles,14081,1734,1902,3636
2026,Jalisco,14,Santa María del Oro,14056,1158,1146,2304
2026,Jalisco,14,Sayula,14082,19927,21415,41342
2026,Jalisco,14,Tala,14083,45422,45899,91321
2026,Jalisco,14,Talpa de Allende,14084,8568,8426,16994
2026,Jalisco,14,Tamazula de Gordiano,14085,21480,22483,43963
2026,Jalisco,14,Tapalpa,14086,10569,10981,21550
2026,Jalisco,14,Tecalitlán,14087,9187,9582,18769
2026,Jalisco,14,Techaluta de Montenegro,14089,2121,2172,4293
2026,Jalisco,14,Tecolotlán,14088,9874,9869,19743
2026,Jalisco,14,Tenamaxtlán,14090,3964,3969,7933
2026,Jalisco,14,Teocaltiche,14091,22384,24409,46793
2026,Jalisco,14,Teocuitatlán de Corona,14092,5896,6089,11985
2026,Jalisco,14,Tepatitlán de Morelos,14093,77471,80183,157654
2026,Jalisco,14,Tequila,14094,23116,23428,46544
2026,Jalisco,14,Teuchitlán,14095,5460,5624,11084
2026,Jalisco,14,Tizapán el Alto,14096,11690,12211,23901
2026,Jalisco,14,Tlajomulco de Zúñiga,14097,344490,349314,693804
2026,Jalisco,14,Tolimán,14099,5795,5842,11637
2026,Jalisco,14,Tomatlán,14100,20483,19359,39842
2026,Jalisco,14,Tonalá,14101,299783,300733,600516
2026,Jalisco,14,Tonaya,14102,3390,3525,6915
2026,Jalisco,14,Tonila,14103,4502,4514,9016
2026,Jalisco,14,Totatiche,14104,2557,2590,5147
2026,Jalisco,14,Tototlán,14105,12950,13215,26165
2026,Jalisco,14,Tuxcacuesco,14106,2553,2428,4981
2026,Jalisco,14,Tuxcueca,14107,3412,3627,7039
2026,Jalisco,14,Tuxpan,14108,19160,20337,39497
2026,Jalisco,14,Unión de San Antonio,14109,9863,10499,20362
2026,Jalisco,14,Unión de Tula,14110,7450,7910,15360
2026,Jalisco,14,Valle de Guadalupe,14111,3954,3978,7932
2026,Jalisco,14,Valle de Juárez,14112,3054,3221,6275
2026,Jalisco,14,Villa Corona,14114,10099,10331,20430
2026,Jalisco,14,Villa Guerrero,14115,3100,3197,6297
2026,Jalisco,14,Villa Hidalgo,14116,11116,11847,22963
2026,Jalisco,14,Villa Purificación,14068,6426,5939,12365
2026,Jalisco,14,Yahualica de González Gallo,14118,12054,13188,25242
2026,Jalisco,14,Zacoalco de Torres,14119,16042,16260,32302
2026,Jalisco,14,Zapopan,14120,737402,763558,1500960
2026,Jalisco,14,Zapotiltic,14121,16276,16880,33156
2026,Jalisco,14,Zapotitlán de Vadillo,14122,3993,3951,7944
2026,Jalisco,14,Zapotlanejo,14124,37542,38350,75892
2026,Jalisco,14,Zapotlán del Rey,14123,10197,10203,20400
2026,Jalisco,14,Zapotlán el Grande,14023,58438,61547,119985
2026,Michoacán,16,Acuitzio,16001,6019,6471,12490
2026,Michoacán,16,Aguililla,16002,7825,7633,15458
2026,Michoacán,16,Angamacutiro,16004,8025,8751,16776
2026,Michoacán,16,Angangueo,16005,5930,6285,12215
2026,Michoacán,16,Apatzingán,16006,68300,69187,137487
2026,Michoacán,16,Aporo,16007,1722,1836,3558
2026,Michoacán,16,Aquila,16008,13724,13341,27065
2026,Michoacán,16,Ario,16009,19575,20610,40185
2026,Michoacán,16,Arteaga,16010,11719,11824,23543
2026,Michoacán,16,Briseñas,16011,6109,6404,12513
2026,Michoacán,16,Buenavista,16012,26449,25059,51508
2026,Michoacán,16,Carácuaro,16013,4990,4940,9930
2026,Michoacán,16,Charapan,16021,6360,7156,13516
2026,Michoacán,16,Charo,16022,12313,11700,24013
2026,Michoacán,16,Chavinda,16023,5561,5818,11379
2026,Michoacán,16,Cherán,16024,9998,10748,20746
2026,Michoacán,16,Chilchota,16025,20602,22188,42790
2026,Michoacán,16,Chinicuila,16026,2679,2432,5111
2026,Michoacán,16,Chucándiro,16027,2191,2514,4705
2026,Michoacán,16,Churintzio,16028,2725,3055,5780
2026,Michoacán,16,Churumuco,16029,8285,8228,16513
2026,Michoacán,16,Coahuayana,16014,8240,7585,15825
2026,Michoacán,16,Coalcomán de Vázquez Pallares,16015,9342,9471,18813
2026,Michoacán,16,Coeneo,16016,10768,12352,23120
2026,Michoacán,16,Cojumatlán de Régules,16074,5612,5820,11432
2026,Michoacán,16,Contepec,16017,18040,18886,36926
2026,Michoacán,16,Copándaro,16018,4702,5171,9873
2026,Michoacán,16,Cotija,16019,9669,10598,20267
2026,Michoacán,16,Cuitzeo,16020,15584,17101,32685
2026,Michoacán,16,Ecuandureo,16030,6384,7460,13844
2026,Michoacán,16,Epitacio Huerta,16031,8921,9254,18175
2026,Michoacán,16,Erongarícuaro,16032,8105,8700,16805
2026,Michoacán,16,Gabriel Zamora,16033,12397,12420,24817
2026,Michoacán,16,Hidalgo,16034,64915,68029,132944
2026,Michoacán,16,Huandacareo,16036,6172,7026,13198
2026,Michoacán,16,Huaniqueo,16037,4215,4875,9090
2026,Michoacán,16,Huetamo,16038,21528,22547,44075
2026,Michoacán,16,Huiramba,16039,4719,4871,9590
2026,Michoacán,16,Indaparapeo,16040,8879,9277,18156
2026,Michoacán,16,Irimbo,16041,7893,8574,16467
2026,Michoacán,16,Ixtlán,16042,6976,7109,14085
2026,Michoacán,16,Jacona,16043,36331,38351,74682
2026,Michoacán,16,Jiménez,16044,6811,7344,14155
2026,Michoacán,16,Jiquilpan,16045,17236,18915,36151
2026,Michoacán,16,José Sixto Verduzco,16113,13870,15149,29019
2026,Michoacán,16,Jungapeo,16047,11455,11533,22988
2026,Michoacán,16,Juárez,16046,7786,8123,15909
2026,Michoacán,16,La Huacana,16035,18450,18556,37006
2026,Michoacán,16,La Piedad,16069,55054,59954,115008
2026,Michoacán,16,Lagunillas,16048,3020,3094,6114
2026,Michoacán,16,Los Reyes,16075,37388,39092,76480
2026,Michoacán,16,Lázaro Cárdenas,16052,98645,97774,196419
2026,Michoacán,16,Madero,16049,9826,9544,19370
2026,Michoacán,16,Maravatío,16050,46529,49880,96409
2026,Michoacán,16,Marcos Castellanos,16051,7360,7856,15216
2026,Michoacán,16,Morelia,16053,411045,444166,855211
2026,Michoacán,16,Morelos,16054,3768,4437,8205
2026,Michoacán,16,Múgica,16055,24437,24933,49370
2026,Michoacán,16,Nahuatzen,16056,15024,15870,30894
2026,Michoacán,16,Nocupétaro,16057,4389,4419,8808
2026,Michoacán,16,Nuevo Parangaricutiro,16058,10623,10933,21556
2026,Michoacán,16,Nuevo Urecho,16059,4407,4388,8795
2026,Michoacán,16,Numarán,16060,5116,5610,10726
2026,Michoacán,16,Ocampo,16061,12928,12938,25866
2026,Michoacán,16,Pajacuarán,16062,10187,10856,21043
2026,Michoacán,16,Panindícuaro,16063,8239,9173,17412
2026,Michoacán,16,Paracho,16065,19585,21335,40920
2026,Michoacán,16,Parácuaro,16064,14709,14251,28960
2026,Michoacán,16,Penjamillo,16067,8809,9996,18805
2026,Michoacán,16,Peribán,16068,15367,15121,30488
2026,Michoacán,16,Puruándiro,16071,34633,38244,72877
2026,Michoacán,16,Purépero,16070,8161,8510,16671
2026,Michoacán,16,Pátzcuaro,16066,48767,52834,101601
2026,Michoacán,16,Queréndaro,16072,7286,7577,14863
2026,Michoacán,16,Quiroga,16073,14524,15870,30394
2026,Michoacán,16,Sahuayo,16076,41430,43284,84714
2026,Michoacán,16,Salvador Escalante,16079,26084,27418,53502
2026,Michoacán,16,San Lucas,16077,9815,9942,19757
2026,Michoacán,16,Santa Ana Maya,16078,6462,7304,13766
2026,Michoacán,16,Senguio,16080,10052,10651,20703
2026,Michoacán,16,Susupuato,16081,4735,4721,9456
2026,Michoacán,16,Tacámbaro,16082,41433,43128,84561
2026,Michoacán,16,Tancítaro,16083,17093,16545,33638
2026,Michoacán,16,Tangamandapio,16084,15447,16468,31915
2026,Michoacán,16,Tangancícuaro,16085,17956,19002,36958
2026,Michoacán,16,Tanhuato,16086,8277,8644,16921
2026,Michoacán,16,Taretan,16087,8020,8152,16172
2026,Michoacán,16,Tarímbaro,16088,61043,65746,126789
2026,Michoacán,16,Tepalcatepec,16089,13139,12823,25962
2026,Michoacán,16,Tingambato,16090,8001,8437,16438
2026,Michoacán,16,Tingüindín,16091,7748,8340,16088
2026,Michoacán,16,Tiquicheo de Nicolás Romero,16092,7181,7279,14460
2026,Michoacán,16,Tlalpujahua,16093,14834,16458,31292
2026,Michoacán,16,Tlazazalca,16094,3474,3677,7151
2026,Michoacán,16,Tocumbo,16095,6618,6702,13320
2026,Michoacán,16,Tumbiscatío,16096,3549,3406,6955
2026,Michoacán,16,Turicato,16097,16333,17044,33377
2026,Michoacán,16,Tuxpan,16098,14132,15088,29220
2026,Michoacán,16,Tuzantla,16099,8183,8201,16384
2026,Michoacán,16,Tzintzuntzan,16100,7522,8265,15787
2026,Michoacán,16,Tzitzio,16101,4667,4515,9182
2026,Michoacán,16,Uruapan,16102,177964,189479,367443
2026,Michoacán,16,Venustiano Carranza,16103,13452,13974,27426
2026,Michoacán,16,Villamar,16104,8855,9458,18313
2026,Michoacán,16,Vista Hermosa,16105,11174,11588,22762
2026,Michoacán,16,Yurécuaro,16106,16827,17637,34464
2026,Michoacán,16,Zacapu,16107,39813,42916,82729
2026,Michoacán,16,Zamora,16108,104852,110837,215689
2026,Michoacán,16,Zinapécuaro,16110,24754,26659,51413
2026,Michoacán,16,Zináparo,16109,1670,1929,3599
2026,Michoacán,16,Ziracuaretiro,16111,9417,9557,18974
2026,Michoacán,16,Zitácuaro,16112,84774,92677,177451
2026,Michoacán,16,Álvaro Obregón,16003,11633,12302,23935
2026,Morelos,17,Amacuzac,17001,9780,10184,19964
2026,Morelos,17,Atlatlahucan,17002,12746,13118,25864
2026,Morelos,17,Axochiapan,17003,20086,20374,40460
2026,Morelos,17,Ayala,17004,46678,49570,96248
2026,Morelos,17,Coatlán del Río,17005,5587,5688,11275
2026,Morelos,17,Cuautla,17006,106899,114212,221111
2026,Morelos,17,Cuernavaca,17007,198579,224360,422939
2026,Morelos,17,Emiliano Zapata,17008,55871,57358,113229
2026,Morelos,17,Huitzilac,17009,10722,10758,21480
2026,Morelos,17,Jantetelco,17010,9586,9928,19514
2026,Morelos,17,Jiutepec,17011,115324,122332,237656
2026,Morelos,17,Jojutla,17012,31572,33675,65247
2026,Morelos,17,Jonacatepec,17013,8584,9178,17762
2026,Morelos,17,Mazatepec,17014,5565,5765,11330
2026,Morelos,17,Miacatlán,17015,14645,15240,29885
2026,Morelos,17,Ocuituco,17016,10342,10509,20851
2026,Morelos,17,Puente de Ixtla,17017,36759,38077,74836
2026,Morelos,17,Temixco,17018,63801,66219,130020
2026,Morelos,17,Temoac,17033,8802,9212,18014
2026,Morelos,17,Tepalcingo,17019,15096,15575,30671
2026,Morelos,17,Tepoztlán,17020,27152,27963,55115
2026,Morelos,17,Tetecala,17021,4440,4442,8882
2026,Morelos,17,Tetela del Volcán,17022,11360,11861,23221
2026,Morelos,17,Tlalnepantla,17023,4136,4006,8142
2026,Morelos,17,Tlaltizapán de Zapata,17024,28807,30034,58841
2026,Morelos,17,Tlaquiltenango,17025,19078,19509,38587
2026,Morelos,17,Tlayacapan,17026,10037,10175,20212
2026,Morelos,17,Totolapan,17027,6661,6802,13463
2026,Morelos,17,Xochitepec,17028,39690,38966,78656
2026,Morelos,17,Yautepec,17029,56500,59370,115870
2026,Morelos,17,Yecapixtla,17030,29578,30099,59677
2026,Morelos,17,Zacatepec,17031,20056,21626,41682
2026,Morelos,17,Zacualpan,17032,5339,5521,10860
2026,Nayarit,18,Acaponeta,18001,21791,21665,43456
2026,Nayarit,18,Ahuacatlán,18002,9427,9276,18703
2026,Nayarit,18,Amatlán de Cañas,18003,7116,6820,13936
2026,Nayarit,18,Bahía de Banderas,18020,97109,93043,190152
2026,Nayarit,18,Compostela,18004,44387,43920,88307
2026,Nayarit,18,Del Nayar,18009,24052,23949,48001
2026,Nayarit,18,Huajicori,18005,7345,7086,14431
2026,Nayarit,18,Ixtlán del Río,18006,16585,17635,34220
2026,Nayarit,18,Jala,18007,10635,10788,21423
2026,Nayarit,18,La Yesca,18019,8116,7600,15716
2026,Nayarit,18,Rosamorada,18010,20456,19468,39924
2026,Nayarit,18,Ruíz,18011,14718,14276,28994
2026,Nayarit,18,San Blas,18012,27558,24520,52078
2026,Nayarit,18,San Pedro Lagunillas,18013,4551,4398,8949
2026,Nayarit,18,Santa María del Oro,18014,13850,13420,27270
2026,Nayarit,18,Santiago Ixcuintla,18015,58754,56516,115270
2026,Nayarit,18,Tecuala,18016,23771,22985,46756
2026,Nayarit,18,Tepic,18017,233661,245290,478951
2026,Nayarit,18,Tuxpan,18018,18067,18159,36226
2026,Nayarit,18,Xalisco,18008,32686,33908,66594
2026,Nuevo León,19,Abasolo,19001,1511,1513,3024
2026,Nuevo León,19,Agualeguas,19002,1337,1271,2608
2026,Nuevo León,19,Allende,19004,20807,20556,41363
2026,Nuevo León,19,Anáhuac,19005,10657,10757,21414
2026,Nuevo León,19,Apodaca,19006,357664,350978,708642
2026,Nuevo León,19,Aramberri,19007,9893,9661,19554
2026,Nuevo León,19,Bustamante,19008,2402,2386,4788
2026,Nuevo León,19,Cadereyta Jiménez,19009,57708,55325,113033
2026,Nuevo León,19,Cerralvo,19011,4569,4276,8845
2026,Nuevo León,19,China,19013,6693,6370,13063
2026,Nuevo León,19,Ciénega de Flores,19012,28273,27134,55407
2026,Nuevo León,19,Doctor Arroyo,19014,20887,20336,41223
2026,Nuevo León,19,Doctor Coss,19015,1068,1035,2103
2026,Nuevo León,19,Doctor González,19016,1811,1719,3530
2026,Nuevo León,19,El Carmen,19010,26485,25872,52357
2026,Nuevo León,19,Galeana,19017,24800,24181,48981
2026,Nuevo León,19,García,19018,167188,164517,331705
2026,Nuevo León,19,General Bravo,19020,3456,3297,6753
2026,Nuevo León,19,General Escobedo,19021,247789,246680,494469
2026,Nuevo León,19,General Terán,19022,8964,9008,17972
2026,Nuevo León,19,General Treviño,19023,619,648,1267
2026,Nuevo León,19,General Zaragoza,19024,3693,3445,7138
2026,Nuevo León,19,General Zuazua,19025,51050,50003,101053
2026,Nuevo León,19,Guadalupe,19026,382516,374901,757417
2026,Nuevo León,19,Hidalgo,19047,8374,8300,16674
2026,Nuevo León,19,Higueras,19028,955,887,1842
2026,Nuevo León,19,Hualahuises,19029,4204,4245,8449
2026,Nuevo León,19,Iturbide,19030,2255,2083,4338
2026,Nuevo León,19,Juárez,19031,219268,213079,432347
2026,Nuevo León,19,Lampazos de Naranjo,19032,3203,3112,6315
2026,Nuevo León,19,Linares,19033,47897,47885,95782
2026,Nuevo León,19,Los Aldamas,19003,910,892,1802
2026,Nuevo León,19,Los Herreras,19027,1121,1148,2269
2026,Nuevo León,19,Los Ramones,19042,2769,2718,5487
2026,Nuevo León,19,Marín,19034,3375,3173,6548
2026,Nuevo León,19,Melchor Ocampo,19035,618,597,1215
2026,Nuevo León,19,Mier y Noriega,19036,4135,4035,8170
2026,Nuevo León,19,Mina,19037,3203,3052,6255
2026,Nuevo León,19,Montemorelos,19038,36813,36641,73454
2026,Nuevo León,19,Monterrey,19039,598111,626205,1224316
2026,Nuevo León,19,Parás,19040,601,584,1185
2026,Nuevo León,19,Pesquería,19041,62895,62097,124992
2026,Nuevo León,19,Rayones,19043,1721,1601,3322
2026,Nuevo León,19,Sabinas Hidalgo,19044,20740,21525,42265
2026,Nuevo León,19,Salinas Victoria,19045,34447,32803,67250
2026,Nuevo León,19,San Nicolás de los Garza,19046,246859,257268,504127
2026,Nuevo León,19,San Pedro Garza García,19019,70368,78568,148936
2026,Nuevo León,19,Santa Catarina,19048,172165,170142,342307
2026,Nuevo León,19,Santiago,19049,25503,25280,50783
2026,Nuevo León,19,Vallecillo,19050,1166,997,2163
2026,Nuevo León,19,Villaldama,19051,2509,2503,5012
2026,Oaxaca,20,Abejones,20001,433,591,1024
2026,Oaxaca,20,Acatlán de Pérez Figueroa,20002,24022,25041,49063
2026,Oaxaca,20,Asunción Cacalotepec,20003,1076,1158,2234
2026,Oaxaca,20,Asunción Cuyotepeji,20004,499,571,1070
2026,Oaxaca,20,Asunción Ixtaltepec,20005,8204,8324,16528
2026,Oaxaca,20,Asunción Nochixtlán,20006,9558,10760,20318
2026,Oaxaca,20,Asunción Ocotlán,20007,1126,1402,2528
2026,Oaxaca,20,Asunción Tlacolulita,20008,411,438,849
2026,Oaxaca,20,Ayoquezco de Aldama,20398,2169,2427,4596
2026,Oaxaca,20,Ayotzintepec,20009,3797,3848,7645
2026,Oaxaca,20,Calihualá,20011,595,632,1227
2026,Oaxaca,20,Candelaria Loxicha,20012,5411,5689,11100
2026,Oaxaca,20,Capulálpam de Méndez,20247,764,933,1697
2026,Oaxaca,20,Chahuites,20025,6184,6262,12446
2026,Oaxaca,20,Chalcatongo de Hidalgo,20026,4612,5266,9878
2026,Oaxaca,20,Chiquihuitlán de Benito Juárez,20027,1143,1381,2524
2026,Oaxaca,20,Ciudad Ixtepec,20014,15204,16568,31772
2026,Oaxaca,20,Ciénega de Zimatlán,20013,1573,1717,3290
2026,Oaxaca,20,Coatecas Altas,20015,2177,2521,4698
2026,Oaxaca,20,Coicoyán de las Flores,20016,4976,5642,10618
2026,Oaxaca,20,Concepción Buenavista,20018,417,445,862
2026,Oaxaca,20,Concepción Pápalo,20019,1589,1599,3188
2026,Oaxaca,20,Constancia del Rosario,20020,1909,2209,4118
2026,Oaxaca,20,Cosolapa,20021,8028,8687,16715
2026,Oaxaca,20,Cosoltepec,20022,376,447,823
2026,Oaxaca,20,Cuilápam de Guerrero,20023,11553,12223,23776
2026,Oaxaca,20,Cuyamecalco Villa de Zaragoza,20024,1971,1947,3918
2026,Oaxaca,20,El Barrio de la Soledad,20010,7391,8012,15403
2026,Oaxaca,20,El Espinal,20030,4643,4867,9510
2026,Oaxaca,20,Eloxochitlán de Flores Magón,20029,2148,2427,4575
2026,Oaxaca,20,Fresnillo de Trujano,20032,540,584,1124
2026,Oaxaca,20,Guadalupe Etla,20033,1388,1548,2936
2026,Oaxaca,20,Guadalupe de Ramírez,20034,682,695,1377
2026,Oaxaca,20,Guelatao de Juárez,20035,281,294,575
2026,Oaxaca,20,Guevea de Humboldt,20036,2721,2844,5565
2026,Oaxaca,20,Heroica Ciudad de Ejutla de Crespo,20028,10859,12151,23010
2026,Oaxaca,20,Heroica Ciudad de Huajuapan de León,20039,39784,44359,84143
2026,Oaxaca,20,Heroica Ciudad de Juchitán de Zaragoza,20043,51757,54592,106349
2026,Oaxaca,20,Heroica Ciudad de Tlaxiaco,20397,20509,23311,43820
2026,Oaxaca,20,Huautepec,20040,3028,3509,6537
2026,Oaxaca,20,Huautla de Jiménez,20041,15277,17702,32979
2026,Oaxaca,20,Ixpantepec Nieves,20065,550,694,1244
2026,Oaxaca,20,Ixtlán de Juárez,20042,4301,4451,8752
2026,Oaxaca,20,La Compañía,20017,1673,1847,3520
2026,Oaxaca,20,La Pe,20069,1365,1458,2823
2026,Oaxaca,20,La Reforma,20076,1618,1766,3384
2026,Oaxaca,20,La Trinidad Vista Hermosa,20556,125,151,276
2026,Oaxaca,20,Loma Bonita,20044,22063,24163,46226
2026,Oaxaca,20,Magdalena Apasco,20045,4609,5137,9746
2026,Oaxaca,20,Magdalena Jaltepec,20046,1591,1869,3460
2026,Oaxaca,20,Magdalena Mixtepec,20048,683,717,1400
2026,Oaxaca,20,Magdalena Ocotlán,20049,600,644,1244
2026,Oaxaca,20,Magdalena Peñasco,20050,1712,1994,3706
2026,Oaxaca,20,Magdalena Teitipac,20051,2350,2517,4867
2026,Oaxaca,20,Magdalena Tequisistlán,20052,3224,3386,6610
2026,Oaxaca,20,Magdalena Tlacotepec,20053,655,714,1369
2026,Oaxaca,20,Magdalena Yodocono de Porfirio Díaz,20562,810,863,1673
2026,Oaxaca,20,Magdalena Zahuatlán,20054,210,236,446
2026,Oaxaca,20,Mariscala de Juárez,20055,1854,2014,3868
2026,Oaxaca,20,Matías Romero Avendaño,20057,20162,21573,41735
2026,Oaxaca,20,Mazatlán Villa de Flores,20058,6817,6977,13794
2026,Oaxaca,20,Mesones Hidalgo,20037,2147,2536,4683
2026,Oaxaca,20,Miahuatlán de Porfirio Díaz,20059,22516,24791,47307
2026,Oaxaca,20,Mixistlán de la Reforma,20060,1310,1457,2767
2026,Oaxaca,20,Monjas,20061,1368,1608,2976
2026,Oaxaca,20,Mártires de Tacubaya,20056,746,811,1557
2026,Oaxaca,20,Natividad,20062,330,378,708
2026,Oaxaca,20,Nazareno Etla,20063,2091,2304,4395
2026,Oaxaca,20,Nejapa de Madero,20064,3944,4093,8037
2026,Oaxaca,20,Nuevo Zoquiápam,20504,832,899,1731
2026,Oaxaca,20,Oaxaca de Juárez,20067,122582,141240,263822
2026,Oaxaca,20,Ocotlán de Morelos,20068,11310,12310,23620
2026,Oaxaca,20,Pinotepa de Don Luis,20070,3642,3747,7389
2026,Oaxaca,20,Pluma Hidalgo,20071,1509,1570,3079
2026,Oaxaca,20,Putla Villa de Guerrero,20073,16776,18912,35688
2026,Oaxaca,20,Reforma de Pineda,20075,1470,1579,3049
2026,Oaxaca,20,Reyes Etla,20077,2074,2204,4278
2026,Oaxaca,20,Rojas de Cuauhtémoc,20078,570,646,1216
2026,Oaxaca,20,Salina Cruz,20079,45906,49760,95666
2026,Oaxaca,20,San Agustín Amatengo,20080,741,843,1584
2026,Oaxaca,20,San Agustín Atenango,20081,870,998,1868
2026,Oaxaca,20,San Agustín Chayuco,20082,1961,2158,4119
2026,Oaxaca,20,San Agustín Etla,20084,2123,2345,4468
2026,Oaxaca,20,San Agustín Loxicha,20085,12940,13454,26394
2026,Oaxaca,20,San Agustín Tlacotepec,20086,436,592,1028
2026,Oaxaca,20,San Agustín Yatareni,20087,2242,2538,4780
2026,Oaxaca,20,San Agustín de las Juntas,20083,5163,5378,10541
2026,Oaxaca,20,San Andrés Cabecera Nueva,20088,1463,1494,2957
2026,Oaxaca,20,San Andrés Dinicuiti,20089,1094,1158,2252
2026,Oaxaca,20,San Andrés Huaxpaltepec,20090,3173,3358,6531
2026,Oaxaca,20,San Andrés Huayápam,20091,2771,3044,5815
2026,Oaxaca,20,San Andrés Ixtlahuaca,20092,826,931,1757
2026,Oaxaca,20,San Andrés Lagunas,20093,244,286,530
2026,Oaxaca,20,San Andrés Nuxiño,20094,876,961,1837
2026,Oaxaca,20,San Andrés Paxtlán,20095,2294,2297,4591
2026,Oaxaca,20,San Andrés Sinaxtla,20096,376,439,815
2026,Oaxaca,20,San Andrés Solaga,20097,907,968,1875
2026,Oaxaca,20,San Andrés Teotilálpam,20098,2235,2446,4681
2026,Oaxaca,20,San Andrés Tepetlapa,20099,254,289,543
2026,Oaxaca,20,San Andrés Yaá,20100,227,272,499
2026,Oaxaca,20,San Andrés Zabache,20101,339,427,766
2026,Oaxaca,20,San Andrés Zautla,20102,2424,2587,5011
2026,Oaxaca,20,San Antonino Castillo Velasco,20103,3140,3454,6594
2026,Oaxaca,20,San Antonino Monte Verde,20105,3511,4104,7615
2026,Oaxaca,20,San Antonino el Alto,20104,1424,1462,2886
2026,Oaxaca,20,San Antonio Acutla,20106,122,151,273
2026,Oaxaca,20,San Antonio Huitepec,20108,2168,2553,4721
2026,Oaxaca,20,San Antonio Nanahuatípam,20109,655,664,1319
2026,Oaxaca,20,San Antonio Sinicahua,20110,773,900,1673
2026,Oaxaca,20,San Antonio Tepetlapa,20111,2193,2359,4552
2026,Oaxaca,20,San Antonio de la Cal,20107,12450,13898,26348
2026,Oaxaca,20,San Baltazar Chichicápam,20112,1284,1461,2745
2026,Oaxaca,20,San Baltazar Loxicha,20113,1537,1600,3137
2026,Oaxaca,20,San Baltazar Yatzachi el Bajo,20114,336,382,718
2026,Oaxaca,20,San Bartolo Coyotepec,20115,4999,5579,10578
2026,Oaxaca,20,San Bartolo Soyaltepec,20121,319,395,714
2026,Oaxaca,20,San Bartolo Yautepec,20122,353,359,712
2026,Oaxaca,20,San Bartolomé Ayautla,20116,2309,2477,4786
2026,Oaxaca,20,San Bartolomé Loxicha,20117,1187,1237,2424
2026,Oaxaca,20,San Bartolomé Quialana,20118,1079,1526,2605
2026,Oaxaca,20,San Bartolomé Yucuañe,20119,167,244,411
2026,Oaxaca,20,San Bartolomé Zoogocho,20120,136,189,325
2026,Oaxaca,20,San Bernardo Mixtepec,20123,1395,1491,2886
2026,Oaxaca,20,San Blas Atempa,20124,9633,9569,19202
2026,Oaxaca,20,San Carlos Yautepec,20125,6581,6446,13027
2026,Oaxaca,20,San Cristóbal Amatlán,20126,2608,2973,5581
2026,Oaxaca,20,San Cristóbal Amoltepec,20127,525,632,1157
2026,Oaxaca,20,San Cristóbal Lachirioag,20128,671,719,1390
2026,Oaxaca,20,San Cristóbal Suchixtlahuaca,20129,195,205,400
2026,Oaxaca,20,San Dionisio Ocotepec,20131,5370,6057,11427
2026,Oaxaca,20,San Dionisio Ocotlán,20132,615,629,1244
2026,Oaxaca,20,San Dionisio del Mar,20130,2798,2676,5474
2026,Oaxaca,20,San Esteban Atatlahuca,20133,1953,2061,4014
2026,Oaxaca,20,San Felipe Jalapa de Díaz,20134,14145,15165,29310
2026,Oaxaca,20,San Felipe Tejalápam,20135,4058,4439,8497
2026,Oaxaca,20,San Felipe Usila,20136,5865,6368,12233
2026,Oaxaca,20,San Francisco Cahuacuá,20137,1775,1808,3583
2026,Oaxaca,20,San Francisco Cajonos,20138,232,256,488
2026,Oaxaca,20,San Francisco Chapulapa,20139,1048,1131,2179
2026,Oaxaca,20,San Francisco Chindúa,20140,424,450,874
2026,Oaxaca,20,San Francisco Huehuetlán,20142,515,652,1167
2026,Oaxaca,20,San Francisco Ixhuatán,20143,4753,4804,9557
2026,Oaxaca,20,San Francisco Jaltepetongo,20144,530,556,1086
2026,Oaxaca,20,San Francisco Lachigoló,20145,2361,2443,4804
2026,Oaxaca,20,San Francisco Logueche,20146,1443,1672,3115
2026,Oaxaca,20,San Francisco Nuxaño,20147,210,197,407
2026,Oaxaca,20,San Francisco Ozolotepec,20148,963,1028,1991
2026,Oaxaca,20,San Francisco Sola,20149,873,965,1838
2026,Oaxaca,20,San Francisco Telixtlahuaca,20150,6698,7217,13915
2026,Oaxaca,20,San Francisco Teopan,20151,183,169,352
2026,Oaxaca,20,San Francisco Tlapancingo,20152,1070,1353,2423
2026,Oaxaca,20,San Francisco del Mar,20141,4201,4093,8294
2026,Oaxaca,20,San Gabriel Mixtepec,20153,2531,2685,5216
2026,Oaxaca,20,San Ildefonso Amatlán,20154,1247,1429,2676
2026,Oaxaca,20,San Ildefonso Sola,20155,523,512,1035
2026,Oaxaca,20,San Ildefonso Villa Alta,20156,1785,1891,3676
2026,Oaxaca,20,San Jacinto Amilpas,20157,8991,9933,18924
2026,Oaxaca,20,San Jacinto Tlacotepec,20158,1100,1158,2258
2026,Oaxaca,20,San Jerónimo Coatlán,20159,2681,2835,5516
2026,Oaxaca,20,San Jerónimo Silacayoapilla,20160,708,732,1440
2026,Oaxaca,20,San Jerónimo Sosola,20161,1332,1501,2833
2026,Oaxaca,20,San Jerónimo Taviche,20162,976,1054,2030
2026,Oaxaca,20,San Jerónimo Tecóatl,20163,813,917,1730
2026,Oaxaca,20,San Jerónimo Tlacochahuaya,20550,2825,3167,5992
2026,Oaxaca,20,San Jorge Nuchita,20164,1371,1642,3013
2026,Oaxaca,20,San José Ayuquila,20165,767,889,1656
2026,Oaxaca,20,San José Chiltepec,20166,6357,6690,13047
2026,Oaxaca,20,San José Estancia Grande,20168,558,566,1124
2026,Oaxaca,20,San José Independencia,20169,1870,2007,3877
2026,Oaxaca,20,San José Lachiguiri,20170,1636,2039,3675
2026,Oaxaca,20,San José Tenango,20171,9235,10054,19289
2026,Oaxaca,20,San José del Peñasco,20167,1105,1154,2259
2026,Oaxaca,20,San José del Progreso,20072,3502,3708,7210
2026,Oaxaca,20,San Juan Achiutla,20172,220,230,450
2026,Oaxaca,20,San Juan Atepec,20173,770,863,1633
2026,Oaxaca,20,San Juan Bautista Atatlahuca,20175,827,880,1707
2026,Oaxaca,20,San Juan Bautista Coixtlahuaca,20176,1348,1509,2857
2026,Oaxaca,20,San Juan Bautista Cuicatlán,20177,5214,5538,10752
2026,Oaxaca,20,San Juan Bautista Guelache,20178,3918,4386,8304
2026,Oaxaca,20,San Juan Bautista Jayacatlán,20179,825,812,1637
2026,Oaxaca,20,San Juan Bautista Lo de Soto,20180,1387,1417,2804
2026,Oaxaca,20,San Juan Bautista Suchitepec,20181,226,266,492
2026,Oaxaca,20,San Juan Bautista Tlachichilco,20183,682,786,1468
2026,Oaxaca,20,San Juan Bautista Tlacoatzintepec,20182,1071,1188,2259
2026,Oaxaca,20,San Juan Bautista Tuxtepec,20184,83942,90994,174936
2026,Oaxaca,20,San Juan Bautista Valle Nacional,20559,11534,12454,23988
2026,Oaxaca,20,San Juan Cacahuatepec,20185,4661,4882,9543
2026,Oaxaca,20,San Juan Chicomezúchil,20191,171,199,370
2026,Oaxaca,20,San Juan Chilateca,20192,768,895,1663
2026,Oaxaca,20,San Juan Cieneguilla,20186,306,335,641
2026,Oaxaca,20,San Juan Coatzóspam,20187,1101,1089,2190
2026,Oaxaca,20,San Juan Colorado,20188,5124,5460,10584
2026,Oaxaca,20,San Juan Comaltepec,20189,1478,1540,3018
2026,Oaxaca,20,San Juan Cotzocón,20190,12303,12939,25242
2026,Oaxaca,20,San Juan Diuxi,20195,569,595,1164
2026,Oaxaca,20,San Juan Evangelista Analco,20196,224,244,468
2026,Oaxaca,20,San Juan Guelavía,20197,1727,1846,3573
2026,Oaxaca,20,San Juan Guichicovi,20198,15047,16955,32002
2026,Oaxaca,20,San Juan Ihualtepec,20199,311,361,672
2026,Oaxaca,20,San Juan Juquila Mixes,20200,1939,2171,4110
2026,Oaxaca,20,San Juan Juquila Vijanos,20201,988,1087,2075
2026,Oaxaca,20,San Juan Lachao,20202,2448,2621,5069
2026,Oaxaca,20,San Juan Lachigalla,20203,1666,1812,3478
2026,Oaxaca,20,San Juan Lajarcia,20204,321,389,710
2026,Oaxaca,20,San Juan Lalana,20205,8683,9112,17795
2026,Oaxaca,20,San Juan Mazatlán,20207,9797,9877,19674
2026,Oaxaca,20,San Juan Mixtepec Distrito 08,20208,3480,3983,7463
2026,Oaxaca,20,San Juan Mixtepec Distrito 26,20209,288,423,711
2026,Oaxaca,20,San Juan Ozolotepec,20211,1389,1373,2762
2026,Oaxaca,20,San Juan Petlapa,20212,1493,1592,3085
2026,Oaxaca,20,San Juan Quiahije,20213,1918,2188,4106
2026,Oaxaca,20,San Juan Quiotepec,20214,1067,1108,2175
2026,Oaxaca,20,San Juan Sayultepec,20215,405,479,884
2026,Oaxaca,20,San Juan Tabaá,20216,689,756,1445
2026,Oaxaca,20,San Juan Tamazola,20217,1523,1609,3132
2026,Oaxaca,20,San Juan Teita,20218,327,345,672
2026,Oaxaca,20,San Juan Teitipac,20219,1353,1485,2838
2026,Oaxaca,20,San Juan Tepeuxila,20220,1440,1362,2802
2026,Oaxaca,20,San Juan Teposcolula,20221,647,686,1333
2026,Oaxaca,20,San Juan Yaeé,20222,758,857,1615
2026,Oaxaca,20,San Juan Yatzona,20223,214,274,488
2026,Oaxaca,20,San Juan Yucuita,20224,291,345,636
2026,Oaxaca,20,San Juan de los Cués,20206,1272,1298,2570
2026,Oaxaca,20,San Juan del Estado,20193,1394,1511,2905
2026,Oaxaca,20,San Juan del Río,20194,637,757,1394
2026,Oaxaca,20,San Juan Ñumí,20210,2905,3338,6243
2026,Oaxaca,20,San Lorenzo,20225,3118,3365,6483
2026,Oaxaca,20,San Lorenzo Albarradas,20226,1525,1475,3000
2026,Oaxaca,20,San Lorenzo Cacaotepec,20227,8299,9015,17314
2026,Oaxaca,20,San Lorenzo Cuaunecuiltitla,20228,451,411,862
2026,Oaxaca,20,San Lorenzo Texmelúcan,20229,4002,4680,8682
2026,Oaxaca,20,San Lorenzo Victoria,20230,525,549,1074
2026,Oaxaca,20,San Lucas Camotlán,20231,1526,1638,3164
2026,Oaxaca,20,San Lucas Ojitlán,20232,10272,10936,21208
2026,Oaxaca,20,San Lucas Quiaviní,20233,774,1099,1873
2026,Oaxaca,20,San Lucas Zoquiápam,20234,3823,4060,7883
2026,Oaxaca,20,San Luis Amatlán,20235,1798,2124,3922
2026,Oaxaca,20,San Marcial Ozolotepec,20236,758,834,1592
2026,Oaxaca,20,San Marcos Arteaga,20237,640,737,1377
2026,Oaxaca,20,San Martín Huamelúlpam,20239,520,618,1138
2026,Oaxaca,20,San Martín Itunyoso,20240,996,1276,2272
2026,Oaxaca,20,San Martín Lachilá,20241,523,649,1172
2026,Oaxaca,20,San Martín Peras,20242,6008,6507,12515
2026,Oaxaca,20,San Martín Tilcajete,20243,878,1072,1950
2026,Oaxaca,20,San Martín Toxpalan,20244,1972,2088,4060
2026,Oaxaca,20,San Martín Zacatepec,20245,682,705,1387
2026,Oaxaca,20,San Martín de los Cansecos,20238,455,467,922
2026,Oaxaca,20,San Mateo Cajonos,20246,310,372,682
2026,Oaxaca,20,San Mateo Etlatongo,20250,593,634,1227
2026,Oaxaca,20,San Mateo Nejápam,20251,574,633,1207
2026,Oaxaca,20,San Mateo Peñasco,20252,1064,1225,2289
2026,Oaxaca,20,San Mateo Piñas,20253,1003,1010,2013
2026,Oaxaca,20,San Mateo Río Hondo,20254,1646,1727,3373
2026,Oaxaca,20,San Mateo Sindihui,20255,1026,1143,2169
2026,Oaxaca,20,San Mateo Tlapiltepec,20256,109,131,240
2026,Oaxaca,20,San Mateo Yoloxochitlán,20249,1822,2020,3842
2026,Oaxaca,20,San Mateo Yucutindoo,20566,1593,1631,3224
2026,Oaxaca,20,San Mateo del Mar,20248,8244,7962,16206
2026,Oaxaca,20,San Melchor Betaza,20257,520,601,1121
2026,Oaxaca,20,San Miguel Achiutla,20258,390,440,830
2026,Oaxaca,20,San Miguel Ahuehuetitlán,20259,1211,1344,2555
2026,Oaxaca,20,San Miguel Aloápam,20260,1080,1224,2304
2026,Oaxaca,20,San Miguel Amatitlán,20261,3796,4268,8064
2026,Oaxaca,20,San Miguel Amatlán,20262,509,542,1051
2026,Oaxaca,20,San Miguel Chicahua,20264,1031,1273,2304
2026,Oaxaca,20,San Miguel Chimalapa,20265,3766,3556,7322
2026,Oaxaca,20,San Miguel Coatlán,20263,1587,1863,3450
2026,Oaxaca,20,San Miguel Ejutla,20268,495,580,1075
2026,Oaxaca,20,San Miguel Huautla,20270,547,638,1185
2026,Oaxaca,20,San Miguel Mixtepec,20271,1662,1709,3371
2026,Oaxaca,20,San Miguel Panixtlahuaca,20272,2991,3702,6693
2026,Oaxaca,20,San Miguel Peras,20273,1702,1831,3533
2026,Oaxaca,20,San Miguel Piedras,20274,664,709,1373
2026,Oaxaca,20,San Miguel Quetzaltepec,20275,4462,4393,8855
2026,Oaxaca,20,San Miguel Santa Flor,20276,381,378,759
2026,Oaxaca,20,San Miguel Soyaltepec,20278,20068,21383,41451
2026,Oaxaca,20,San Miguel Suchixtepec,20279,1372,1516,2888
2026,Oaxaca,20,San Miguel Tecomatlán,20281,176,157,333
2026,Oaxaca,20,San Miguel Tenango,20282,396,380,776
2026,Oaxaca,20,San Miguel Tequixtepec,20283,523,574,1097
2026,Oaxaca,20,San Miguel Tilquiápam,20284,1427,1830,3257
2026,Oaxaca,20,San Miguel Tlacamama,20285,1923,1977,3900
2026,Oaxaca,20,San Miguel Tlacotepec,20286,1547,1781,3328
2026,Oaxaca,20,San Miguel Tulancingo,20287,134,209,343
2026,Oaxaca,20,San Miguel Yotao,20288,296,335,631
2026,Oaxaca,20,San Miguel del Puerto,20266,4349,4429,8778
2026,Oaxaca,20,San Miguel del Río,20267,149,142,291
2026,Oaxaca,20,San Miguel el Grande,20269,2179,2472,4651
2026,Oaxaca,20,San Nicolás,20289,569,687,1256
2026,Oaxaca,20,San Nicolás Hidalgo,20290,504,584,1088
2026,Oaxaca,20,San Pablo Coatlán,20291,2185,2287,4472
2026,Oaxaca,20,San Pablo Cuatro Venados,20292,694,791,1485
2026,Oaxaca,20,San Pablo Etla,20293,9433,10482,19915
2026,Oaxaca,20,San Pablo Huitzo,20294,3659,4130,7789
2026,Oaxaca,20,San Pablo Huixtepec,20295,4841,5319,10160
2026,Oaxaca,20,San Pablo Macuiltianguis,20296,483,502,985
2026,Oaxaca,20,San Pablo Tijaltepec,20297,1138,1368,2506
2026,Oaxaca,20,San Pablo Villa de Mitla,20298,6557,7150,13707
2026,Oaxaca,20,San Pablo Yaganiza,20299,535,606,1141
2026,Oaxaca,20,San Pedro Amuzgos,20300,3374,3863,7237
2026,Oaxaca,20,San Pedro Apóstol,20301,767,901,1668
2026,Oaxaca,20,San Pedro Atoyac,20302,2228,2501,4729
2026,Oaxaca,20,San Pedro Cajonos,20303,537,660,1197
2026,Oaxaca,20,San Pedro Comitancillo,20305,2214,2420,4634
2026,Oaxaca,20,San Pedro Coxcaltepec Cántaros,20304,379,423,802
2026,Oaxaca,20,San Pedro Huamelula,20307,5245,5275,10520
2026,Oaxaca,20,San Pedro Huilotepec,20308,1681,1703,3384
2026,Oaxaca,20,San Pedro Ixcatlán,20309,5874,6190,12064
2026,Oaxaca,20,San Pedro Ixtlahuaca,20310,4753,5030,9783
2026,Oaxaca,20,San Pedro Jaltepetongo,20311,288,329,617
2026,Oaxaca,20,San Pedro Jicayán,20312,6240,6871,13111
2026,Oaxaca,20,San Pedro Jocotipac,20313,384,462,846
2026,Oaxaca,20,San Pedro Juchatengo,20314,815,898,1713
2026,Oaxaca,20,San Pedro Mixtepec Distrito 22,20318,25809,27030,52839
2026,Oaxaca,20,San Pedro Mixtepec Distrito 26,20319,554,596,1150
2026,Oaxaca,20,San Pedro Molinos,20320,341,379,720
2026,Oaxaca,20,San Pedro Mártir,20315,780,977,1757
2026,Oaxaca,20,San Pedro Mártir Quiechapa,20316,351,397,748
2026,Oaxaca,20,San Pedro Mártir Yucuxaco,20317,610,720,1330
2026,Oaxaca,20,San Pedro Nopala,20321,368,404,772
2026,Oaxaca,20,San Pedro Ocopetatillo,20322,400,469,869
2026,Oaxaca,20,San Pedro Ocotepec,20323,1077,1155,2232
2026,Oaxaca,20,San Pedro Pochutla,20324,24842,25674,50516
2026,Oaxaca,20,San Pedro Quiatoni,20325,5649,5972,11621
2026,Oaxaca,20,San Pedro Sochiápam,20326,2624,2700,5324
2026,Oaxaca,20,San Pedro Tapanatepec,20327,7775,7942,15717
2026,Oaxaca,20,San Pedro Taviche,20328,628,642,1270
2026,Oaxaca,20,San Pedro Teozacoalco,20329,637,678,1315
2026,Oaxaca,20,San Pedro Teutila,20330,2211,2289,4500
2026,Oaxaca,20,San Pedro Tidaá,20331,461,538,999
2026,Oaxaca,20,San Pedro Topiltepec,20332,189,210,399
2026,Oaxaca,20,San Pedro Totolápam,20333,1353,1503,2856
2026,Oaxaca,20,San Pedro Yaneri,20335,469,503,972
2026,Oaxaca,20,San Pedro Yucunama,20341,104,139,243
2026,Oaxaca,20,San Pedro Yólox,20336,866,938,1804
2026,Oaxaca,20,San Pedro el Alto,20306,1802,1911,3713
2026,Oaxaca,20,San Pedro y San Pablo Ayutla,20337,2542,3049,5591
2026,Oaxaca,20,San Pedro y San Pablo Teposcolula,20339,2121,2361,4482
2026,Oaxaca,20,San Pedro y San Pablo Tequixtepec,20340,855,1055,1910
2026,Oaxaca,20,San Raymundo Jalpan,20342,1792,2150,3942
2026,Oaxaca,20,San Sebastián Abasolo,20343,1005,1093,2098
2026,Oaxaca,20,San Sebastián Coatlán,20344,1390,1484,2874
2026,Oaxaca,20,San Sebastián Ixcapa,20345,2179,2228,4407
2026,Oaxaca,20,San Sebastián Nicananduta,20346,680,888,1568
2026,Oaxaca,20,San Sebastián Río Hondo,20347,1918,1949,3867
2026,Oaxaca,20,San Sebastián Tecomaxtlahuaca,20348,4203,4668,8871
2026,Oaxaca,20,San Sebastián Teitipac,20349,966,1144,2110
2026,Oaxaca,20,San Sebastián Tutla,20350,8888,10339,19227
2026,Oaxaca,20,San Simón Almolongas,20351,1414,1618,3032
2026,Oaxaca,20,San Simón Zahuatlán,20352,2190,2238,4428
2026,Oaxaca,20,San Vicente Coatlán,20534,1885,2234,4119
2026,Oaxaca,20,San Vicente Lachixío,20535,1335,1538,2873
2026,Oaxaca,20,San Vicente Nuñú,20536,215,253,468
2026,Oaxaca,20,Santa Ana,20353,1136,1209,2345
2026,Oaxaca,20,Santa Ana Ateixtlahuaca,20354,272,273,545
2026,Oaxaca,20,Santa Ana Cuauhtémoc,20355,373,394,767
2026,Oaxaca,20,Santa Ana Tavela,20357,422,458,880
2026,Oaxaca,20,Santa Ana Tlapacoyan,20358,1078,1168,2246
2026,Oaxaca,20,Santa Ana Yareni,20359,457,516,973
2026,Oaxaca,20,Santa Ana Zegache,20360,1921,2165,4086
2026,Oaxaca,20,Santa Ana del Valle,20356,1096,1148,2244
2026,Oaxaca,20,Santa Catalina Quierí,20361,435,547,982
2026,Oaxaca,20,Santa Catarina Cuixtla,20362,717,897,1614
2026,Oaxaca,20,Santa Catarina Ixtepeji,20363,1350,1459,2809
2026,Oaxaca,20,Santa Catarina Juquila,20364,8025,8547,16572
2026,Oaxaca,20,Santa Catarina Lachatao,20365,567,615,1182
2026,Oaxaca,20,Santa Catarina Loxicha,20366,1973,2044,4017
2026,Oaxaca,20,Santa Catarina Mechoacán,20367,2344,2401,4745
2026,Oaxaca,20,Santa Catarina Minas,20368,1031,1066,2097
2026,Oaxaca,20,Santa Catarina Quiané,20369,1027,1071,2098
2026,Oaxaca,20,Santa Catarina Quioquitani,20074,278,307,585
2026,Oaxaca,20,Santa Catarina Tayata,20370,323,386,709
2026,Oaxaca,20,Santa Catarina Ticuá,20371,521,646,1167
2026,Oaxaca,20,Santa Catarina Yosonotú,20372,817,1002,1819
2026,Oaxaca,20,Santa Catarina Zapoquila,20373,189,217,406
2026,Oaxaca,20,Santa Cruz Acatepec,20374,799,876,1675
2026,Oaxaca,20,Santa Cruz Amilpas,20375,6605,7652,14257
2026,Oaxaca,20,Santa Cruz Itundujia,20377,5883,6396,12279
2026,Oaxaca,20,Santa Cruz Mixtepec,20378,1817,1983,3800
2026,Oaxaca,20,Santa Cruz Nundaco,20379,1442,1705,3147
2026,Oaxaca,20,Santa Cruz Papalutla,20380,1131,1197,2328
2026,Oaxaca,20,Santa Cruz Tacache de Mina,20381,1382,1520,2902
2026,Oaxaca,20,Santa Cruz Tacahua,20382,556,629,1185
2026,Oaxaca,20,Santa Cruz Tayata,20383,320,330,650
2026,Oaxaca,20,Santa Cruz Xitla,20384,2443,2690,5133
2026,Oaxaca,20,Santa Cruz Xoxocotlán,20385,48348,54364,102712
2026,Oaxaca,20,Santa Cruz Zenzontepec,20386,9357,9808,19165
2026,Oaxaca,20,Santa Cruz de Bravo,20376,190,209,399
2026,Oaxaca,20,Santa Gertrudis,20387,1491,1589,3080
2026,Oaxaca,20,Santa Inés Yatzeche,20389,426,560,986
2026,Oaxaca,20,Santa Inés de Zaragoza,20569,815,937,1752
2026,Oaxaca,20,Santa Inés del Monte,20388,1228,1283,2511
2026,Oaxaca,20,Santa Lucía Miahuatlán,20391,1754,1851,3605
2026,Oaxaca,20,Santa Lucía Monteverde,20392,3277,3597,6874
2026,Oaxaca,20,Santa Lucía Ocotlán,20393,1868,2212,4080
2026,Oaxaca,20,Santa Lucía del Camino,20390,25286,27677,52963
2026,Oaxaca,20,Santa Magdalena Jicotlán,20047,47,58,105
2026,Oaxaca,20,Santa María Alotepec,20394,1481,1517,2998
2026,Oaxaca,20,Santa María Apazco,20395,832,1069,1901
2026,Oaxaca,20,Santa María Atzompa,20399,18658,20041,38699
2026,Oaxaca,20,Santa María Camotlán,20400,825,958,1783
2026,Oaxaca,20,Santa María Chachoápam,20404,377,427,804
2026,Oaxaca,20,Santa María Chilchotla,20406,10438,10867,21305
2026,Oaxaca,20,Santa María Chimalapa,20407,4838,4674,9512
2026,Oaxaca,20,Santa María Colotepec,20401,12785,12979,25764
2026,Oaxaca,20,Santa María Cortijo,20402,548,581,1129
2026,Oaxaca,20,Santa María Coyotepec,20403,1595,1772,3367
2026,Oaxaca,20,Santa María Ecatepec,20410,1781,1819,3600
2026,Oaxaca,20,Santa María Guelacé,20411,396,490,886
2026,Oaxaca,20,Santa María Guienagati,20412,1646,1651,3297
2026,Oaxaca,20,Santa María Huatulco,20413,23454,24287,47741
2026,Oaxaca,20,Santa María Huazolotitlán,20414,6045,6190,12235
2026,Oaxaca,20,Santa María Ipalapa,20415,2531,2783,5314
2026,Oaxaca,20,Santa María Ixcatlán,20416,251,283,534
2026,Oaxaca,20,Santa María Jacatepec,20417,4638,5161,9799
2026,Oaxaca,20,Santa María Jalapa del Marqués,20418,6904,7282,14186
2026,Oaxaca,20,Santa María Jaltianguis,20419,252,310,562
2026,Oaxaca,20,Santa María Lachixío,20420,961,1124,2085
2026,Oaxaca,20,Santa María Mixtequilla,20421,2430,2572,5002
2026,Oaxaca,20,Santa María Nativitas,20422,294,354,648
2026,Oaxaca,20,Santa María Nduayaco,20423,267,271,538
2026,Oaxaca,20,Santa María Ozolotepec,20424,1937,2062,3999
2026,Oaxaca,20,Santa María Petapa,20427,8496,9118,17614
2026,Oaxaca,20,Santa María Peñoles,20426,4360,4612,8972
2026,Oaxaca,20,Santa María Pápalo,20425,1118,1120,2238
2026,Oaxaca,20,Santa María Quiegolani,20428,1044,1024,2068
2026,Oaxaca,20,Santa María Sola,20429,757,822,1579
2026,Oaxaca,20,Santa María Tataltepec,20430,206,225,431
2026,Oaxaca,20,Santa María Tecomavaca,20431,862,921,1783
2026,Oaxaca,20,Santa María Temaxcalapa,20432,488,505,993
2026,Oaxaca,20,Santa María Temaxcaltepec,20433,1245,1423,2668
2026,Oaxaca,20,Santa María Teopoxco,20434,2062,2371,4433
2026,Oaxaca,20,Santa María Tepantlali,20435,1978,2058,4036
2026,Oaxaca,20,Santa María Texcatitlán,20436,503,553,1056
2026,Oaxaca,20,Santa María Tlahuitoltepec,20437,4700,5074,9774
2026,Oaxaca,20,Santa María Tlalixtac,20438,872,923,1795
2026,Oaxaca,20,Santa María Tonameca,20439,13371,13530,26901
2026,Oaxaca,20,Santa María Totolapilla,20440,418,459,877
2026,Oaxaca,20,Santa María Xadani,20441,4723,4641,9364
2026,Oaxaca,20,Santa María Yalina,20442,138,160,298
2026,Oaxaca,20,Santa María Yavesía,20443,247,310,557
2026,Oaxaca,20,Santa María Yolotepec,20444,211,229,440
2026,Oaxaca,20,Santa María Yosoyúa,20445,881,870,1751
2026,Oaxaca,20,Santa María Yucuhiti,20446,3178,3494,6672
2026,Oaxaca,20,Santa María Zacatepec,20447,8041,9007,17048
2026,Oaxaca,20,Santa María Zaniza,20448,1119,1182,2301
2026,Oaxaca,20,Santa María Zoquitlán,20449,1608,1642,3250
2026,Oaxaca,20,Santa María del Rosario,20408,278,258,536
2026,Oaxaca,20,Santa María del Tule,20409,4526,5204,9730
2026,Oaxaca,20,Santa María la Asunción,20396,1528,1959,3487
2026,Oaxaca,20,Santiago Amoltepec,20450,6361,6802,13163
2026,Oaxaca,20,Santiago Apoala,20451,453,537,990
2026,Oaxaca,20,Santiago Apóstol,20452,1889,2340,4229
2026,Oaxaca,20,Santiago Astata,20453,2113,2129,4242
2026,Oaxaca,20,Santiago Atitlán,20454,1599,1550,3149
2026,Oaxaca,20,Santiago Ayuquililla,20455,1375,1515,2890
2026,Oaxaca,20,Santiago Cacaloxtepec,20456,831,902,1733
2026,Oaxaca,20,Santiago Camotlán,20457,1656,1669,3325
2026,Oaxaca,20,Santiago Chazumba,20459,2160,2714,4874
2026,Oaxaca,20,Santiago Choápam,20460,2627,2804,5431
2026,Oaxaca,20,Santiago Comaltepec,20458,485,537,1022
2026,Oaxaca,20,Santiago Huajolotitlán,20462,2052,2427,4479
2026,Oaxaca,20,Santiago Huauclilla,20463,268,299,567
2026,Oaxaca,20,Santiago Ihuitlán Plumas,20464,167,214,381
2026,Oaxaca,20,Santiago Ixcuintepec,20465,843,871,1714
2026,Oaxaca,20,Santiago Ixtayutla,20466,6554,6908,13462
2026,Oaxaca,20,Santiago Jamiltepec,20467,9717,10552,20269
2026,Oaxaca,20,Santiago Jocotepec,20468,7268,7438,14706
2026,Oaxaca,20,Santiago Juxtlahuaca,20469,18190,20112,38302
2026,Oaxaca,20,Santiago Lachiguiri,20470,2462,2514,4976
2026,Oaxaca,20,Santiago Lalopa,20471,263,277,540
2026,Oaxaca,20,Santiago Laollaga,20472,1849,1867,3716
2026,Oaxaca,20,Santiago Laxopa,20473,665,748,1413
2026,Oaxaca,20,Santiago Llano Grande,20474,1748,1770,3518
2026,Oaxaca,20,Santiago Matatlán,20475,4941,5599,10540
2026,Oaxaca,20,Santiago Miltepec,20476,227,229,456
2026,Oaxaca,20,Santiago Minas,20477,717,736,1453
2026,Oaxaca,20,Santiago Nacaltepec,20478,907,1009,1916
2026,Oaxaca,20,Santiago Nejapilla,20479,121,109,230
2026,Oaxaca,20,Santiago Niltepec,20066,2882,2930,5812
2026,Oaxaca,20,Santiago Nundiche,20480,471,519,990
2026,Oaxaca,20,Santiago Nuyoó,20481,868,970,1838
2026,Oaxaca,20,Santiago Pinotepa Nacional,20482,27716,29068,56784
2026,Oaxaca,20,Santiago Suchilquitongo,20483,5457,5867,11324
2026,Oaxaca,20,Santiago Tamazola,20484,2231,2539,4770
2026,Oaxaca,20,Santiago Tapextla,20485,1659,1597,3256
2026,Oaxaca,20,Santiago Tenango,20487,1100,1097,2197
2026,Oaxaca,20,Santiago Tepetlapa,20488,58,72,130
2026,Oaxaca,20,Santiago Tetepec,20489,2566,2594,5160
2026,Oaxaca,20,Santiago Texcalcingo,20490,1572,1694,3266
2026,Oaxaca,20,Santiago Textitlán,20491,2301,2308,4609
2026,Oaxaca,20,Santiago Tilantongo,20492,1422,1678,3100
2026,Oaxaca,20,Santiago Tillo,20493,273,316,589
2026,Oaxaca,20,Santiago Tlazoyaltepec,20494,2298,2730,5028
2026,Oaxaca,20,Santiago Xanica,20495,1600,1583,3183
2026,Oaxaca,20,Santiago Xiacuí,20496,1077,1181,2258
2026,Oaxaca,20,Santiago Yaitepec,20497,2075,2469,4544
2026,Oaxaca,20,Santiago Yaveo,20498,3723,3683,7406
2026,Oaxaca,20,Santiago Yolomécatl,20499,1053,1239,2292
2026,Oaxaca,20,Santiago Yosondúa,20500,4277,4807,9084
2026,Oaxaca,20,Santiago Yucuyachi,20501,487,529,1016
2026,Oaxaca,20,Santiago Zacatepec,20502,2769,2863,5632
2026,Oaxaca,20,Santiago Zoochila,20503,199,216,415
2026,Oaxaca,20,Santiago del Río,20461,293,321,614
2026,Oaxaca,20,Santo Domingo Albarradas,20506,387,444,831
2026,Oaxaca,20,Santo Domingo Armenta,20507,1819,1819,3638
2026,Oaxaca,20,Santo Domingo Chihuitán,20508,808,838,1646
2026,Oaxaca,20,Santo Domingo Ingenio,20505,4330,4356,8686
2026,Oaxaca,20,Santo Domingo Ixcatlán,20510,290,351,641
2026,Oaxaca,20,Santo Domingo Nuxaá,20511,1638,1741,3379
2026,Oaxaca,20,Santo Domingo Ozolotepec,20512,397,432,829
2026,Oaxaca,20,Santo Domingo Petapa,20513,4988,4904,9892
2026,Oaxaca,20,Santo Domingo Roayaga,20514,522,567,1089
2026,Oaxaca,20,Santo Domingo Tehuantepec,20515,34140,36041,70181
2026,Oaxaca,20,Santo Domingo Teojomulco,20516,2609,2725,5334
2026,Oaxaca,20,Santo Domingo Tepuxtepec,20517,2864,3262,6126
2026,Oaxaca,20,Santo Domingo Tlatayápam,20518,71,81,152
2026,Oaxaca,20,Santo Domingo Tomaltepec,20519,1579,1625,3204
2026,Oaxaca,20,Santo Domingo Tonaltepec,20521,115,145,260
2026,Oaxaca,20,Santo Domingo Tonalá,20520,3501,3904,7405
2026,Oaxaca,20,Santo Domingo Xagacía,20522,589,672,1261
2026,Oaxaca,20,Santo Domingo Yanhuitlán,20523,797,899,1696
2026,Oaxaca,20,Santo Domingo Yodohino,20524,155,164,319
2026,Oaxaca,20,Santo Domingo Zanatepec,20525,6522,6600,13122
2026,Oaxaca,20,Santo Domingo de Morelos,20509,5513,6125,11638
2026,Oaxaca,20,Santo Tomás Jalieza,20530,1822,2004,3826
2026,Oaxaca,20,Santo Tomás Mazaltepec,20531,1385,1506,2891
2026,Oaxaca,20,Santo Tomás Ocotepec,20532,1883,2162,4045
2026,Oaxaca,20,Santo Tomás Tamazulapan,20533,1173,1247,2420
2026,Oaxaca,20,Santos Reyes Nopala,20526,9074,9686,18760
2026,Oaxaca,20,Santos Reyes Pápalo,20527,1323,1437,2760
2026,Oaxaca,20,Santos Reyes Tepejillo,20528,452,599,1051
2026,Oaxaca,20,Santos Reyes Yucuná,20529,662,673,1335
2026,Oaxaca,20,Silacayoápam,20537,3430,3900,7330
2026,Oaxaca,20,Sitio de Xitlapehua,20538,347,390,737
2026,Oaxaca,20,Soledad Etla,20539,3020,3172,6192
2026,Oaxaca,20,Tamazulápam del Espíritu Santo,20031,3568,4350,7918
2026,Oaxaca,20,Tanetze de Zaragoza,20541,850,920,1770
2026,Oaxaca,20,Taniche,20542,403,480,883
2026,Oaxaca,20,Tataltepec de Valdés,20543,2971,3129,6100
2026,Oaxaca,20,Teococuilco de Marcos Pérez,20544,449,541,990
2026,Oaxaca,20,Teotitlán de Flores Magón,20545,5037,5640,10677
2026,Oaxaca,20,Teotitlán del Valle,20546,2984,3308,6292
2026,Oaxaca,20,Teotongo,20547,480,568,1048
2026,Oaxaca,20,Tepelmeme Villa de Morelos,20548,804,964,1768
2026,Oaxaca,20,Tlacolula de Matamoros,20551,11859,13381,25240
2026,Oaxaca,20,Tlacotepec Plumas,20552,231,255,486
2026,Oaxaca,20,Tlalixtac de Cabrera,20553,5367,5939,11306
2026,Oaxaca,20,Totontepec Villa de Morelos,20554,2751,2982,5733
2026,Oaxaca,20,Trinidad Zaachila,20555,1521,1694,3215
2026,Oaxaca,20,Unión Hidalgo,20557,8188,8644,16832
2026,Oaxaca,20,Valerio Trujano,20558,684,832,1516
2026,Oaxaca,20,Villa Díaz Ordaz,20560,3359,3978,7337
2026,Oaxaca,20,Villa Hidalgo,20038,992,1098,2090
2026,Oaxaca,20,Villa Sola de Vega,20277,6394,6532,12926
2026,Oaxaca,20,Villa Talea de Castro,20280,1174,1290,2464
2026,Oaxaca,20,Villa Tejúpam de la Unión,20486,1279,1378,2657
2026,Oaxaca,20,Villa Tezoatlán de Segura y Luna,20549,5416,6370,11786
2026,Oaxaca,20,Villa de Chilapa de Díaz,20405,1037,1313,2350
2026,Oaxaca,20,Villa de Etla,20338,5661,6260,11921
2026,Oaxaca,20,Villa de Tamazulápam del Progreso,20540,3906,4400,8306
2026,Oaxaca,20,Villa de Tututepec de Melchor Ocampo,20334,23689,24617,48306
2026,Oaxaca,20,Villa de Zaachila,20565,23367,25569,48936
2026,Oaxaca,20,Yaxe,20561,1451,1568,3019
2026,Oaxaca,20,Yogana,20563,626,732,1358
2026,Oaxaca,20,Yutanduchi de Guerrero,20564,588,653,1241
2026,Oaxaca,20,Zapotitlán Lagunas,20567,1588,1780,3368
2026,Oaxaca,20,Zapotitlán Palmas,20568,698,854,1552
2026,Oaxaca,20,Zimatlán de Álvarez,20570,10072,11439,21511
2026,Oaxaca,20,Ánimas Trujano,20174,2069,2297,4366
2026,Puebla,21,Acajete,21001,35043,37302,72345
2026,Puebla,21,Acateno,21002,5194,5117,10311
2026,Puebla,21,Acatlán,21003,18414,21339,39753
2026,Puebla,21,Acatzingo,21004,32121,33245,65366
2026,Puebla,21,Acteopan,21005,1560,1736,3296
2026,Puebla,21,Ahuacatlán,21006,8360,9295,17655
2026,Puebla,21,Ahuatlán,21007,1719,1860,3579
2026,Puebla,21,Ahuazotepec,21008,6282,6462,12744
2026,Puebla,21,Ahuehuetitla,21009,929,1062,1991
2026,Puebla,21,Ajalpan,21010,35528,37422,72950
2026,Puebla,21,Albino Zertuche,21011,928,1086,2014
2026,Puebla,21,Aljojuca,21012,3526,3847,7373
2026,Puebla,21,Altepexi,21013,11597,12161,23758
2026,Puebla,21,Amixtlán,21014,2613,2880,5493
2026,Puebla,21,Amozoc,21015,65029,67638,132667
2026,Puebla,21,Aquixtla,21016,4872,4901,9773
2026,Puebla,21,Atempan,21017,14717,16542,31259
2026,Puebla,21,Atexcal,21018,2036,2193,4229
2026,Puebla,21,Atlequizayan,21080,1378,1544,2922
2026,Puebla,21,Atlixco,21019,71888,80095,151983
2026,Puebla,21,Atoyatempan,21020,3762,3977,7739
2026,Puebla,21,Atzala,21021,698,766,1464
2026,Puebla,21,Atzitzihuacán,21022,6427,7291,13718
2026,Puebla,21,Atzitzintla,21023,5051,5125,10176
2026,Puebla,21,Axutla,21024,501,580,1081
2026,Puebla,21,Ayotoxco de Guerrero,21025,4704,4836,9540
2026,Puebla,21,Calpan,21026,7731,8506,16237
2026,Puebla,21,Caltepec,21027,2042,2351,4393
2026,Puebla,21,Camocuautla,21028,1454,1481,2935
2026,Puebla,21,Caxhuacan,21029,1959,2157,4116
2026,Puebla,21,Cañada Morelos,21099,10337,10979,21316
2026,Puebla,21,Chalchicomula de Sesma,21045,25477,27597,53074
2026,Puebla,21,Chapulco,21046,4174,4465,8639
2026,Puebla,21,Chiautla,21047,10853,11520,22373
2026,Puebla,21,Chiautzingo,21048,10824,11852,22676
2026,Puebla,21,Chichiquila,21050,13734,14657,28391
2026,Puebla,21,Chiconcuautla,21049,9004,9404,18408
2026,Puebla,21,Chietla,21051,18703,19976,38679
2026,Puebla,21,Chigmecatitlán,21052,616,731,1347
2026,Puebla,21,Chignahuapan,21053,34430,35488,69918
2026,Puebla,21,Chignautla,21054,18320,19389,37709
2026,Puebla,21,Chila,21055,2431,2717,5148
2026,Puebla,21,Chila de la Sal,21056,796,858,1654
2026,Puebla,21,Chilchotla,21058,10899,10890,21789
2026,Puebla,21,Chinantla,21059,1192,1346,2538
2026,Puebla,21,Coatepec,21030,405,447,852
2026,Puebla,21,Coatzingo,21031,1558,1725,3283
2026,Puebla,21,Cohetzala,21032,772,761,1533
2026,Puebla,21,Cohuecan,21033,2606,2820,5426
2026,Puebla,21,Coronango,21034,22440,23168,45608
2026,Puebla,21,Coxcatlán,21035,10874,11988,22862
2026,Puebla,21,Coyomeapan,21036,7300,8038,15338
2026,Puebla,21,Coyotepec,21037,1214,1430,2644
2026,Puebla,21,Cuapiaxtla de Madero,21038,5606,5631,11237
2026,Puebla,21,Cuautempan,21039,4999,5363,10362
2026,Puebla,21,Cuautinchán,21040,5689,5721,11410
2026,Puebla,21,Cuautlancingo,21041,66539,69972,136511
2026,Puebla,21,Cuayuca de Andrade,21042,1707,1822,3529
2026,Puebla,21,Cuetzalan del Progreso,21043,25984,27350,53334
2026,Puebla,21,Cuyoaco,21044,8381,9079,17460
2026,Puebla,21,Domingo Arenas,21060,3969,4396,8365
2026,Puebla,21,Eloxochitlán,21061,6750,7191,13941
2026,Puebla,21,Epatlán,21062,2632,2773,5405
2026,Puebla,21,Esperanza,21063,8047,8543,16590
2026,Puebla,21,Francisco Z. Mena,21064,9680,9498,19178
2026,Puebla,21,General Felipe Ángeles,21065,11021,11938,22959
2026,Puebla,21,Guadalupe,21066,2997,3466,6463
2026,Puebla,21,Guadalupe Victoria,21067,9204,9687,18891
2026,Puebla,21,Hermenegildo Galeana,21068,4248,4328,8576
2026,Puebla,21,Honey,21057,4264,4593,8857
2026,Puebla,21,Huaquechula,21069,12963,14636,27599
2026,Puebla,21,Huatlatlauca,21070,3349,4026,7375
2026,Puebla,21,Huauchinango,21071,55526,61497,117023
2026,Puebla,21,Huehuetla,21072,10333,10631,20964
2026,Puebla,21,Huehuetlán el Chico,21073,4632,4840,9472
2026,Puebla,21,Huehuetlán el Grande,21150,3947,4185,8132
2026,Puebla,21,Huejotzingo,21074,40502,42274,82776
2026,Puebla,21,Hueyapan,21075,6794,7233,14027
2026,Puebla,21,Hueytamalco,21076,14337,14680,29017
2026,Puebla,21,Hueytlalpan,21077,2960,3099,6059
2026,Puebla,21,Huitzilan de Serdán,21078,8395,8214,16609
2026,Puebla,21,Huitziltepec,21079,2946,3154,6100
2026,Puebla,21,Ixcamilpa de Guerrero,21081,1915,2110,4025
2026,Puebla,21,Ixcaquixtla,21082,4753,5215,9968
2026,Puebla,21,Ixtacamaxtitlán,21083,13388,13650,27038
2026,Puebla,21,Ixtepec,21084,3797,4017,7814
2026,Puebla,21,Izúcar de Matamoros,21085,41216,45820,87036
2026,Puebla,21,Jalpan,21086,6441,6911,13352
2026,Puebla,21,Jolalpan,21087,7011,7507,14518
2026,Puebla,21,Jonotla,21088,2493,2593,5086
2026,Puebla,21,Jopala,21089,7085,7378,14463
2026,Puebla,21,Juan C. Bonilla,21090,11501,12467,23968
2026,Puebla,21,Juan Galindo,21091,5588,6393,11981
2026,Puebla,21,Juan N. Méndez,21092,2910,2963,5873
2026,Puebla,21,La Magdalena Tlatlauquitepec,21095,321,314,635
2026,Puebla,21,Lafragua,21093,4402,4528,8930
2026,Puebla,21,Libres,21094,18381,19329,37710
2026,Puebla,21,Los Reyes de Juárez,21118,14924,15318,30242
2026,Puebla,21,Mazapiltepec de Juárez,21096,1582,1599,3181
2026,Puebla,21,Mixtla,21097,1243,1385,2628
2026,Puebla,21,Molcaxac,21098,3205,3595,6800
2026,Puebla,21,Naupan,21100,5235,5732,10967
2026,Puebla,21,Nauzontla,21101,1830,2048,3878
2026,Puebla,21,Nealtican,21102,6592,7161,13753
2026,Puebla,21,Nicolás Bravo,21103,3378,3595,6973
2026,Puebla,21,Nopalucan,21104,17083,17472,34555
2026,Puebla,21,Ocotepec,21105,2576,2776,5352
2026,Puebla,21,Ocoyucan,21106,14796,16574,31370
2026,Puebla,21,Olintla,21107,6311,6629,12940
2026,Puebla,21,Oriental,21108,9913,10492,20405
2026,Puebla,21,Pahuatlán,21109,11730,12905,24635
2026,Puebla,21,Palmar de Bravo,21110,25265,25648,50913
2026,Puebla,21,Pantepec,21111,10007,10582,20589
2026,Puebla,21,Petlalcingo,21112,5097,5800,10897
2026,Puebla,21,Piaxtla,21113,2404,2612,5016
2026,Puebla,21,Puebla,21114,853723,930035,1783758
2026,Puebla,21,Quecholac,21115,27648,28551,56199
2026,Puebla,21,Quimixtlán,21116,11985,12304,24289
2026,Puebla,21,Rafael Lara Grajales,21117,7364,7876,15240
2026,Puebla,21,San Andrés Cholula,21119,82242,83776,166018
2026,Puebla,21,San Antonio Cañada,21120,2878,3231,6109
2026,Puebla,21,San Diego la Mesa Tochimiltzingo,21121,667,666,1333
2026,Puebla,21,San Felipe Teotlalcingo,21122,5671,6025,11696
2026,Puebla,21,San Felipe Tepatlán,21123,2139,2207,4346
2026,Puebla,21,San Gabriel Chilac,21124,8320,9230,17550
2026,Puebla,21,San Gregorio Atzompa,21125,4981,5235,10216
2026,Puebla,21,San Jerónimo Tecuanipan,21126,3333,3649,6982
2026,Puebla,21,San Jerónimo Xayacatlán,21127,1802,2074,3876
2026,Puebla,21,San José Chiapa,21128,4847,4931,9778
2026,Puebla,21,San José Miahuatlán,21129,7142,7737,14879
2026,Puebla,21,San Juan Atenco,21130,1737,2001,3738
2026,Puebla,21,San Juan Atzompa,21131,505,476,981
2026,Puebla,21,San Martín Texmelucan,21132,82387,88071,170458
2026,Puebla,21,San Martín Totoltepec,21133,328,354,682
2026,Puebla,21,San Matías Tlalancaleca,21134,11224,11568,22792
2026,Puebla,21,San Miguel Ixitlán,21135,276,305,581
2026,Puebla,21,San Miguel Xoxtla,21136,6799,7166,13965
2026,Puebla,21,San Nicolás Buenos Aires,21137,5396,5621,11017
2026,Puebla,21,San Nicolás de los Ranchos,21138,6519,6743,13262
2026,Puebla,21,San Pablo Anicano,21139,1911,2078,3989
2026,Puebla,21,San Pedro Cholula,21140,70532,76404,146936
2026,Puebla,21,San Pedro Yeloixtlahuaca,21141,1786,1932,3718
2026,Puebla,21,San Salvador Huixcolotla,21144,8210,8316,16526
2026,Puebla,21,San Salvador el Seco,21142,16573,17412,33985
2026,Puebla,21,San Salvador el Verde,21143,17400,17897,35297
2026,Puebla,21,San Sebastián Tlacotepec,21145,7581,7690,15271
2026,Puebla,21,Santa Catarina Tlaltempan,21146,454,458,912
2026,Puebla,21,Santa Inés Ahuatempan,21147,3403,3740,7143
2026,Puebla,21,Santa Isabel Cholula,21148,4672,5060,9732
2026,Puebla,21,Santiago Miahuatlán,21149,13930,14657,28587
2026,Puebla,21,Santo Tomás Hueyotlipan,21151,4610,4949,9559
2026,Puebla,21,Soltepec,21152,6775,7070,13845
2026,Puebla,21,Tecali de Herrera,21153,12097,12671,24768
2026,Puebla,21,Tecamachalco,21154,41501,43864,85365
2026,Puebla,21,Tecomatlán,21155,3099,3236,6335
2026,Puebla,21,Tehuacán,21156,168593,187371,355964
2026,Puebla,21,Tehuitzingo,21157,5989,6682,12671
2026,Puebla,21,Tenampulco,21158,3977,4124,8101
2026,Puebla,21,Teopantlán,21159,1878,2335,4213
2026,Puebla,21,Teotlalco,21160,1729,1804,3533
2026,Puebla,21,Tepanco de López,21161,10863,11986,22849
2026,Puebla,21,Tepango de Rodríguez,21162,2147,2386,4533
2026,Puebla,21,Tepatlaxco de Hidalgo,21163,9433,9908,19341
2026,Puebla,21,Tepeaca,21164,42893,46508,89401
2026,Puebla,21,Tepemaxalco,21165,580,608,1188
2026,Puebla,21,Tepeojuma,21166,4470,5164,9634
2026,Puebla,21,Tepetzintla,21167,6130,6558,12688
2026,Puebla,21,Tepexco,21168,3657,3823,7480
2026,Puebla,21,Tepexi de Rodríguez,21169,11797,11858,23655
2026,Puebla,21,Tepeyahualco,21170,9369,9509,18878
2026,Puebla,21,Tepeyahualco de Cuauhtémoc,21171,1919,2080,3999
2026,Puebla,21,Tetela de Ocampo,21172,15279,16350,31629
2026,Puebla,21,Teteles de Ávila Castillo,21173,2983,3522,6505
2026,Puebla,21,Teziutlán,21174,51937,57863,109800
2026,Puebla,21,Tianguismanalco,21175,6897,7403,14300
2026,Puebla,21,Tilapa,21176,4606,4925,9531
2026,Puebla,21,Tlachichuca,21179,15984,16546,32530
2026,Puebla,21,Tlacotepec de Benito Juárez,21177,27500,29829,57329
2026,Puebla,21,Tlacuilotepec,21178,9116,9407,18523
2026,Puebla,21,Tlahuapan,21180,22150,22320,44470
2026,Puebla,21,Tlaltenango,21181,3909,3969,7878
2026,Puebla,21,Tlanepantla,21182,2632,2843,5475
2026,Puebla,21,Tlaola,21183,10723,11381,22104
2026,Puebla,21,Tlapacoya,21184,3520,3659,7179
2026,Puebla,21,Tlapanalá,21185,4503,4877,9380
2026,Puebla,21,Tlatlauquitepec,21186,28685,31624,60309
2026,Puebla,21,Tlaxco,21187,2988,3000,5988
2026,Puebla,21,Tochimilco,21188,9607,10573,20180
2026,Puebla,21,Tochtepec,21189,11329,12137,23466
2026,Puebla,21,Totoltepec de Guerrero,21190,629,763,1392
2026,Puebla,21,Tulcingo,21191,4883,5590,10473
2026,Puebla,21,Tuzamapan de Galeana,21192,3536,3689,7225
2026,Puebla,21,Tzicatlacoyan,21193,3912,3989,7901
2026,Puebla,21,Venustiano Carranza,21194,15926,17008,32934
2026,Puebla,21,Vicente Guerrero,21195,12963,13962,26925
2026,Puebla,21,Xayacatlán de Bravo,21196,814,973,1787
2026,Puebla,21,Xicotepec,21197,43488,46704,90192
2026,Puebla,21,Xicotlán,21198,639,707,1346
2026,Puebla,21,Xiutetelco,21199,21337,22965,44302
2026,Puebla,21,Xochiapulco,21200,1792,1981,3773
2026,Puebla,21,Xochiltepec,21201,1683,2017,3700
2026,Puebla,21,Xochitlán Todos Santos,21203,3414,3775,7189
2026,Puebla,21,Xochitlán de Vicente Suárez,21202,6750,7271,14021
2026,Puebla,21,Yaonáhuac,21204,4231,4652,8883
2026,Puebla,21,Yehualtepec,21205,13451,14083,27534
2026,Puebla,21,Zacapala,21206,2357,2626,4983
2026,Puebla,21,Zacapoaxtla,21207,29230,32187,61417
2026,Puebla,21,Zacatlán,21208,43921,48489,92410
2026,Puebla,21,Zapotitlán,21209,4349,5160,9509
2026,Puebla,21,Zapotitlán de Méndez,21210,3114,3146,6260
2026,Puebla,21,Zaragoza,21211,8342,9755,18097
2026,Puebla,21,Zautla,21212,9872,11251,21123
2026,Puebla,21,Zihuateutla,21213,7184,7561,14745
2026,Puebla,21,Zinacatepec,21214,9110,9925,19035
2026,Puebla,21,Zongozotla,21215,2735,2792,5527
2026,Puebla,21,Zoquiapan,21216,1265,1437,2702
2026,Puebla,21,Zoquitlán,21217,9817,10444,20261
2026,Querétaro,22,Amealco de Bonfil,22001,36087,38227,74314
2026,Querétaro,22,Arroyo Seco,22003,8018,8537,16555
2026,Querétaro,22,Cadereyta de Montes,22004,40530,43786,84316
2026,Querétaro,22,Colón,22005,37916,37113,75029
2026,Querétaro,22,Corregidora,22006,113834,120352,234186
2026,Querétaro,22,El Marqués,22011,100865,98656,199521
2026,Querétaro,22,Ezequiel Montes,22007,24267,25843,50110
2026,Querétaro,22,Huimilpan,22008,22085,23914,45999
2026,Querétaro,22,Jalpan de Serra,22009,15587,17045,32632
2026,Querétaro,22,Landa de Matamoros,22010,10662,11518,22180
2026,Querétaro,22,Pedro Escobedo,22012,41445,41978,83423
2026,Querétaro,22,Peñamiller,22013,12036,12300,24336
2026,Querétaro,22,Pinal de Amoles,22002,14866,15747,30613
2026,Querétaro,22,Querétaro,22014,531441,539704,1071145
2026,Querétaro,22,San Joaquín,22015,5308,5998,11306
2026,Querétaro,22,San Juan del Río,22016,162747,168886,331633
2026,Querétaro,22,Tequisquiapan,22017,42622,44251,86873
2026,Querétaro,22,Tolimán,22018,16865,17521,34386
2026,Quintana Roo,23,Bacalar,23010,26043,25751,51794
2026,Quintana Roo,23,Benito Juárez,23005,475557,469745,945302
2026,Quintana Roo,23,Cozumel,23001,57887,57925,115812
2026,Quintana Roo,23,Felipe Carrillo Puerto,23002,53599,53190,106789
2026,Quintana Roo,23,Isla Mujeres,23003,14211,13040,27251
2026,Quintana Roo,23,José María Morelos,23006,25235,23720,48955
2026,Quintana Roo,23,Lázaro Cárdenas,23007,18461,17600,36061
2026,Quintana Roo,23,Othón P. Blanco,23004,148494,154600,303094
2026,Quintana Roo,23,Solidaridad,23008,139724,126568,266292
2026,Quintana Roo,23,Tulum,23009,21759,19500,41259
2026,San Luis Potosí,24,Ahualulco,24001,9226,10346,19572
2026,San Luis Potosí,24,Alaquines,24002,4494,4619,9113
2026,San Luis Potosí,24,Aquismón,24003,26295,25763,52058
2026,San Luis Potosí,24,Armadillo de los Infante,24004,2233,2304,4537
2026,San Luis Potosí,24,Axtla de Terrazas,24053,20004,20578,40582
2026,San Luis Potosí,24,Catorce,24006,5471,5284,10755
2026,San Luis Potosí,24,Cedral,24007,10187,10673,20860
2026,San Luis Potosí,24,Cerritos,24008,11548,12345,23893
2026,San Luis Potosí,24,Cerro de San Pedro,24009,2515,2445,4960
2026,San Luis Potosí,24,Charcas,24015,11160,11573,22733
2026,San Luis Potosí,24,Ciudad Fernández,24011,23901,25222,49123
2026,San Luis Potosí,24,Ciudad Valles,24013,94402,101194,195596
2026,San Luis Potosí,24,Ciudad del Maíz,24010,19172,19311,38483
2026,San Luis Potosí,24,Coxcatlán,24014,8345,8254,16599
2026,San Luis Potosí,24,Cárdenas,24005,9872,10752,20624
2026,San Luis Potosí,24,Ebano,24016,23411,24280,47691
2026,San Luis Potosí,24,El Naranjo,24058,12121,11986,24107
2026,San Luis Potosí,24,Guadalcázar,24017,14646,14379,29025
2026,San Luis Potosí,24,Huehuetlán,24018,8482,8770,17252
2026,San Luis Potosí,24,Lagunillas,24019,3013,3126,6139
2026,San Luis Potosí,24,Matehuala,24020,52680,55855,108535
2026,San Luis Potosí,24,Matlapa,24057,16356,16556,32912
2026,San Luis Potosí,24,Mexquitic de Carmona,24021,29474,32008,61482
2026,San Luis Potosí,24,Moctezuma,24022,10099,10960,21059
2026,San Luis Potosí,24,Rayón,24023,8401,8830,17231
2026,San Luis Potosí,24,Rioverde,24024,50029,53084,103113
2026,San Luis Potosí,24,Salinas,24025,16506,17769,34275
2026,San Luis Potosí,24,San Antonio,24026,5067,4906,9973
2026,San Luis Potosí,24,San Ciro de Acosta,24027,5498,5866,11364
2026,San Luis Potosí,24,San Luis Potosí,24028,433746,465983,899729
2026,San Luis Potosí,24,San Martín Chalchicuautla,24029,11367,11561,22928
2026,San Luis Potosí,24,San Nicolás Tolentino,24030,2714,3002,5716
2026,San Luis Potosí,24,San Vicente Tancuayalab,24034,8003,8023,16026
2026,San Luis Potosí,24,Santa Catarina,24031,6129,6477,12606
2026,San Luis Potosí,24,Santa María del Río,24032,20536,22528,43064
2026,San Luis Potosí,24,Santo Domingo,24033,6529,6564,13093
2026,San Luis Potosí,24,Soledad de Graciano Sánchez,24035,167710,176253,343963
2026,San Luis Potosí,24,Tamasopo,24036,16638,16295,32933
2026,San Luis Potosí,24,Tamazunchale,24037,51523,52614,104137
2026,San Luis Potosí,24,Tampacán,24038,8436,8298,16734
2026,San Luis Potosí,24,Tampamolón Corona,24039,8221,8432,16653
2026,San Luis Potosí,24,Tamuín,24040,20889,21404,42293
2026,San Luis Potosí,24,Tancanhuitz,24012,10952,11331,22283
2026,San Luis Potosí,24,Tanlajás,24041,10642,10456,21098
2026,San Luis Potosí,24,Tanquián de Escobedo,24042,8079,8483,16562
2026,San Luis Potosí,24,Tierra Nueva,24043,4633,5285,9918
2026,San Luis Potosí,24,Vanegas,24044,4202,4129,8331
2026,San Luis Potosí,24,Venado,24045,7782,8079,15861
2026,San Luis Potosí,24,Villa Hidalgo,24051,8056,8194,16250
2026,San Luis Potosí,24,Villa Juárez,24052,5546,5683,11229
2026,San Luis Potosí,24,Villa de Arista,24056,8190,8261,16451
2026,San Luis Potosí,24,Villa de Arriaga,24046,9590,9743,19333
2026,San Luis Potosí,24,Villa de Guadalupe,24047,5391,5384,10775
2026,San Luis Potosí,24,Villa de Ramos,24049,19473,20471,39944
2026,San Luis Potosí,24,Villa de Reyes,24050,26425,26614,53039
2026,San Luis Potosí,24,Villa de la Paz,24048,2932,2904,5836
2026,San Luis Potosí,24,Xilitla,24054,27337,28380,55717
2026,San Luis Potosí,24,Zaragoza,24055,13793,14165,27958
2026,Sinaloa,25,Ahome,25001,246423,255821,502244
2026,Sinaloa,25,Angostura,25002,26987,26851,53838
2026,Sinaloa,25,Badiraguato,25003,17188,15901,33089
2026,Sinaloa,25,Choix,25007,18339,17350,35689
2026,Sinaloa,25,Concordia,25004,15523,15121,30644
2026,Sinaloa,25,Cosalá,25005,9036,8596,17632
2026,Sinaloa,25,Culiacán,25006,489746,509320,999066
2026,Sinaloa,25,El Fuerte,25010,57428,56297,113725
2026,Sinaloa,25,Elota,25008,31294,29054,60348
2026,Sinaloa,25,Escuinapa,25009,33350,32364,65714
2026,Sinaloa,25,Guasave,25011,164102,166917,331019
2026,Sinaloa,25,Mazatlán,25012,277096,284442,561538
2026,Sinaloa,25,Mocorito,25013,26239,24795,51034
2026,Sinaloa,25,Navolato,25018,85143,81635,166778
2026,Sinaloa,25,Rosario,25014,30600,29583,60183
2026,Sinaloa,25,Salvador Alvarado,25015,44213,46373,90586
2026,Sinaloa,25,San Ignacio,25016,11894,11027,22921
2026,Sinaloa,25,Sinaloa,25017,50407,49069,99476
2026,Sonora,26,Aconchi,26001,1723,1568,3291
2026,Sonora,26,Agua Prieta,26002,46586,45998,92584
2026,Sonora,26,Alamos,26003,15571,14576,30147
2026,Sonora,26,Altar,26004,5467,5468,10935
2026,Sonora,26,Arivechi,26005,721,693,1414
2026,Sonora,26,Arizpe,26006,1651,1564,3215
2026,Sonora,26,Atil,26007,352,336,688
2026,Sonora,26,Bacadéhuachi,26008,697,631,1328
2026,Sonora,26,Bacanora,26009,518,462,980
2026,Sonora,26,Bacerac,26010,866,818,1684
2026,Sonora,26,Bacoachi,26011,955,951,1906
2026,Sonora,26,Banámichi,26013,1002,978,1980
2026,Sonora,26,Bavispe,26015,956,850,1806
2026,Sonora,26,Baviácora,26014,2058,1948,4006
2026,Sonora,26,Benito Juárez,26071,12757,12749,25506
2026,Sonora,26,Benjamín Hill,26016,2922,3069,5991
2026,Sonora,26,Bácum,26012,13430,13244,26674
2026,Sonora,26,Caborca,26017,49493,48731,98224
2026,Sonora,26,Cajeme,26018,245170,257468,502638
2026,Sonora,26,Cananea,26019,20004,20518,40522
2026,Sonora,26,Carbó,26020,2927,2689,5616
2026,Sonora,26,Cucurpe,26022,654,524,1178
2026,Sonora,26,Cumpas,26023,3706,3679,7385
2026,Sonora,26,Divisaderos,26024,458,443,901
2026,Sonora,26,Empalme,26025,32291,32584,64875
2026,Sonora,26,Etchojoa,26026,36958,35724,72682
2026,Sonora,26,Fronteras,26027,5014,4849,9863
2026,Sonora,26,General Plutarco Elías Calles,26070,9979,9813,19792
2026,Sonora,26,Granados,26028,651,634,1285
2026,Sonora,26,Guaymas,26029,91626,93007,184633
2026,Sonora,26,Hermosillo,26030,497402,511666,1009068
2026,Sonora,26,Huachinera,26031,801,750,1551
2026,Sonora,26,Huatabampo,26033,46571,46569,93140
2026,Sonora,26,Huásabas,26032,578,510,1088
2026,Sonora,26,Huépac,26034,609,587,1196
2026,Sonora,26,Imuris,26035,7391,7311,14702
2026,Sonora,26,La Colorada,26021,1315,1048,2363
2026,Sonora,26,Magdalena,26036,18015,18294,36309
2026,Sonora,26,Mazatán,26037,769,660,1429
2026,Sonora,26,Moctezuma,26038,2869,2957,5826
2026,Sonora,26,Naco,26039,3556,3541,7097
2026,Sonora,26,Nacozari de García,26041,7559,7487,15046
2026,Sonora,26,Navojoa,26042,92633,96929,189562
2026,Sonora,26,Nogales,26043,133126,133754,266880
2026,Sonora,26,Nácori Chico,26040,1251,1141,2392
2026,Sonora,26,Onavas,26044,292,252,544
2026,Sonora,26,Opodepe,26045,1713,1511,3224
2026,Sonora,26,Oquitoa,26046,222,250,472
2026,Sonora,26,Pitiquito,26047,5529,5203,10732
2026,Sonora,26,Puerto Peñasco,26048,39478,38221,77699
2026,Sonora,26,Quiriego,26049,1787,1548,3335
2026,Sonora,26,Rayón,26050,962,877,1839
2026,Sonora,26,Rosario,26051,3116,2855,5971
2026,Sonora,26,Sahuaripa,26052,3440,3207,6647
2026,Sonora,26,San Felipe de Jesús,26053,260,248,508
2026,Sonora,26,San Ignacio Río Muerto,26072,8616,8144,16760
2026,Sonora,26,San Javier,26054,434,329,763
2026,Sonora,26,San Luis Río Colorado,26055,110670,109496,220166
2026,Sonora,26,San Miguel de Horcasitas,26056,5716,4833,10549
2026,Sonora,26,San Pedro de la Cueva,26057,983,850,1833
2026,Sonora,26,Santa Ana,26058,9419,9705,19124
2026,Sonora,26,Santa Cruz,26059,1052,1091,2143
2026,Sonora,26,Soyopa,26061,906,756,1662
2026,Sonora,26,Suaqui Grande,26062,722,606,1328
2026,Sonora,26,Sáric,26060,892,855,1747
2026,Sonora,26,Tepache,26063,940,856,1796
2026,Sonora,26,Trincheras,26064,1058,860,1918
2026,Sonora,26,Tubutama,26065,701,663,1364
2026,Sonora,26,Ures,26066,5366,5127,10493
2026,Sonora,26,Villa Hidalgo,26067,966,885,1851
2026,Sonora,26,Villa Pesqueira,26068,741,626,1367
2026,Sonora,26,Yécora,26069,3390,3338,6728
2026,Tabasco,27,Balancán,27001,34309,34385,68694
2026,Tabasco,27,Centla,27003,62201,62482,124683
2026,Tabasco,27,Centro,27004,383430,402565,785995
2026,Tabasco,27,Comalcalco,27005,113592,117381,230973
2026,Tabasco,27,Cunduacán,27006,77381,79917,157298
2026,Tabasco,27,Cárdenas,27002,142811,148448,291259
2026,Tabasco,27,Emiliano Zapata,27007,16723,18416,35139
2026,Tabasco,27,Huimanguillo,27008,104566,107181,211747
2026,Tabasco,27,Jalapa,27009,22059,22015,44074
2026,Tabasco,27,Jalpa de Méndez,27010,49734,50206,99940
2026,Tabasco,27,Jonuta,27011,17374,17326,34700
2026,Tabasco,27,Macuspana,27012,91739,95711,187450
2026,Tabasco,27,Nacajuca,27013,78088,81358,159446
2026,Tabasco,27,Paraíso,27014,53954,54464,108418
2026,Tabasco,27,Tacotalpa,27015,27663,27424,55087
2026,Tabasco,27,Teapa,27016,32422,33744,66166
2026,Tabasco,27,Tenosique,27017,32761,34725,67486
2026,Tamaulipas,28,Abasolo,28001,6829,6811,13640
2026,Tamaulipas,28,Aldama,28002,16373,16015,32388
2026,Tamaulipas,28,Altamira,28003,133542,135066,268608
2026,Tamaulipas,28,Antiguo Morelos,28004,5613,5569,11182
2026,Tamaulipas,28,Burgos,28005,2652,2450,5102
2026,Tamaulipas,28,Bustamante,28006,4694,4311,9005
2026,Tamaulipas,28,Camargo,28007,8518,8331,16849
2026,Tamaulipas,28,Casas,28008,2442,2200,4642
2026,Tamaulipas,28,Ciudad Madero,28009,112128,123837,235965
2026,Tamaulipas,28,Cruillas,28010,1044,1017,2061
2026,Tamaulipas,28,El Mante,28021,64655,68708,133363
2026,Tamaulipas,28,González,28012,24353,24532,48885
2026,Tamaulipas,28,Guerrero,28014,2644,2462,5106
2026,Tamaulipas,28,Gustavo Díaz Ordaz,28015,8949,8786,17735
2026,Tamaulipas,28,Gómez Farías,28011,5291,5036,10327
2026,Tamaulipas,28,Güémez,28013,9109,8410,17519
2026,Tamaulipas,28,Hidalgo,28016,13431,12751,26182
2026,Tamaulipas,28,Jaumave,28017,8809,8499,17308
2026,Tamaulipas,28,Jiménez,28018,4444,4448,8892
2026,Tamaulipas,28,Llera,28019,9786,9374,19160
2026,Tamaulipas,28,Mainero,28020,1487,1436,2923
2026,Tamaulipas,28,Matamoros,28022,277280,287586,564866
2026,Tamaulipas,28,Mier,28024,2180,2258,4438
2026,Tamaulipas,28,Miguel Alemán,28025,15095,15273,30368
2026,Tamaulipas,28,Miquihuana,28026,2124,1944,4068
2026,Tamaulipas,28,Méndez,28023,2173,1975,4148
2026,Tamaulipas,28,Nuevo Laredo,28027,216774,217791,434565
2026,Tamaulipas,28,Nuevo Morelos,28028,2080,1888,3968
2026,Tamaulipas,28,Ocampo,28029,8018,7605,15623
2026,Tamaulipas,28,Padilla,28030,7943,7828,15771
2026,Tamaulipas,28,Palmillas,28031,1014,965,1979
2026,Tamaulipas,28,Reynosa,28032,355459,357444,712903
2026,Tamaulipas,28,Río Bravo,28033,69980,69958,139938
2026,Tamaulipas,28,San Carlos,28034,5286,4774,10060
2026,Tamaulipas,28,San Fernando,28035,30894,30668,61562
2026,Tamaulipas,28,San Nicolás,28036,614,541,1155
2026,Tamaulipas,28,Soto la Marina,28037,14182,13482,27664
2026,Tamaulipas,28,Tampico,28038,168657,184846,353503
2026,Tamaulipas,28,Tula,28039,16399,16503,32902
2026,Tamaulipas,28,Valle Hermoso,28040,34740,35964,70704
2026,Tamaulipas,28,Victoria,28041,187700,197056,384756
2026,Tamaulipas,28,Villagrán,28042,3624,3408,7032
2026,Tamaulipas,28,Xicoténcatl,28043,13378,13395,26773
2026,Tlaxcala,29,Acuamanala de Miguel Hidalgo,29022,3822,3795,7617
2026,Tlaxcala,29,Altzayanca,29004,9932,9862,19794
2026,Tlaxcala,29,Amaxac de Guerrero,29001,6359,6548,12907
2026,Tlaxcala,29,Apetatitlán de Antonio Carvajal,29002,8364,8948,17312
2026,Tlaxcala,29,Apizaco,29005,42565,46805,89370
2026,Tlaxcala,29,Atlangatepec,29003,3651,3783,7434
2026,Tlaxcala,29,Benito Juárez,29045,3358,3430,6788
2026,Tlaxcala,29,Calpulalpan,29006,26770,28084,54854
2026,Tlaxcala,29,Chiautempan,29010,40131,43057,83188
2026,Tlaxcala,29,Contla de Juan Cuamatzi,29018,21549,22085,43634
2026,Tlaxcala,29,Cuapiaxtla,29008,8635,8615,17250
2026,Tlaxcala,29,Cuaxomulco,29009,3012,3058,6070
2026,Tlaxcala,29,El Carmen Tequexquitla,29007,9517,9729,19246
2026,Tlaxcala,29,Emiliano Zapata,29046,2497,2595,5092
2026,Tlaxcala,29,Españita,29012,4935,5030,9965
2026,Tlaxcala,29,Huamantla,29013,51868,53906,105774
2026,Tlaxcala,29,Hueyotlipan,29014,8176,8330,16506
2026,Tlaxcala,29,Ixtacuixtla de Mariano Matamoros,29015,21962,23058,45020
2026,Tlaxcala,29,Ixtenco,29016,4003,4332,8335
2026,Tlaxcala,29,La Magdalena Tlaltelulco,29048,10131,10930,21061
2026,Tlaxcala,29,Lázaro Cárdenas,29047,1727,1744,3471
2026,Tlaxcala,29,Mazatecochco de José María Morelos,29017,6095,6178,12273
2026,Tlaxcala,29,Muñoz de Domingo Arenas,29011,2578,2561,5139
2026,Tlaxcala,29,Nanacamilpa de Mariano Arista,29021,10097,10531,20628
2026,Tlaxcala,29,Natívitas,29023,14159,15089,29248
2026,Tlaxcala,29,Panotla,29024,14870,15987,30857
2026,Tlaxcala,29,Papalotla de Xicohténcatl,29041,16736,17834,34570
2026,Tlaxcala,29,San Damián Texóloc,29049,3241,3252,6493
2026,Tlaxcala,29,San Francisco Tetlanohcan,29050,5963,6181,12144
2026,Tlaxcala,29,San Jerónimo Zacualpan,29051,2115,2326,4441
2026,Tlaxcala,29,San José Teacalco,29052,3341,3502,6843
2026,Tlaxcala,29,San Juan Huactzinco,29053,4092,4465,8557
2026,Tlaxcala,29,San Lorenzo Axocomanitla,29054,3113,3334,6447
2026,Tlaxcala,29,San Lucas Tecopilco,29055,1744,1834,3578
2026,Tlaxcala,29,San Pablo del Monte,29025,43243,43272,86515
2026,Tlaxcala,29,Sanctórum de Lázaro Cárdenas,29020,5771,5895,11666
2026,Tlaxcala,29,Santa Ana Nopalucan,29056,4389,4530,8919
2026,Tlaxcala,29,Santa Apolonia Teacalco,29057,2509,2783,5292
2026,Tlaxcala,29,Santa Catarina Ayometla,29058,4915,5295,10210
2026,Tlaxcala,29,Santa Cruz Quilehtla,29059,4088,4077,8165
2026,Tlaxcala,29,Santa Cruz Tlaxcala,29026,11633,12010,23643
2026,Tlaxcala,29,Santa Isabel Xiloxoxtla,29060,2782,2921,5703
2026,Tlaxcala,29,Tenancingo,29027,7378,7594,14972
2026,Tlaxcala,29,Teolocholco,29028,13424,14182,27606
2026,Tlaxcala,29,Tepetitla de Lardizábal,29019,11665,12526,24191
2026,Tlaxcala,29,Tepeyanco,29029,7791,8526,16317
2026,Tlaxcala,29,Terrenate,29030,8868,8734,17602
2026,Tlaxcala,29,Tetla de la Solidaridad,29031,18236,18668,36904
2026,Tlaxcala,29,Tetlatlahuca,29032,8208,8681,16889
2026,Tlaxcala,29,Tlaxcala,29033,51988,57272,109260
2026,Tlaxcala,29,Tlaxco,29034,23687,24526,48213
2026,Tlaxcala,29,Tocatlán,29035,3294,3351,6645
2026,Tlaxcala,29,Totolac,29036,12337,13462,25799
2026,Tlaxcala,29,Tzompantepec,29038,9730,10409,20139
2026,Tlaxcala,29,Xaloztoc,29039,13685,13573,27258
2026,Tlaxcala,29,Xaltocan,29040,6137,6572,12709
2026,Tlaxcala,29,Xicohtzinco,29042,7536,8315,15851
2026,Tlaxcala,29,Yauhquemehcan,29043,21594,22892,44486
2026,Tlaxcala,29,Zacatelco,29044,24492,26704,51196
2026,Tlaxcala,29,Ziltlaltépec de Trinidad Sánchez Santos,29037,4827,5251,10078
2026,Veracruz,30,Acajete,30001,4724,4565,9289
2026,Veracruz,30,Acatlán,30002,1690,1737,3427
2026,Veracruz,30,Acayucan,30003,44805,48323,93128
2026,Veracruz,30,Actopan,30004,23607,24364,47971
2026,Veracruz,30,Acula,30005,2973,2959,5932
2026,Veracruz,30,Acultzingo,30006,11982,12398,24380
2026,Veracruz,30,Agua Dulce,30204,25441,26980,52421
2026,Veracruz,30,Alpatláhuac,30008,5368,5394,10762
2026,Veracruz,30,Alto Lucero de Gutiérrez Barrios,30009,16124,15981,32105
2026,Veracruz,30,Altotonga,30010,33537,36050,69587
2026,Veracruz,30,Alvarado,30011,29015,29921,58936
2026,Veracruz,30,Amatitlán,30012,4327,4539,8866
2026,Veracruz,30,Amatlán de los Reyes,30014,23870,25724,49594
2026,Veracruz,30,Angel R. Cabada,30015,18066,19204,37270
2026,Veracruz,30,Apazapan,30017,2222,2254,4476
2026,Veracruz,30,Aquila,30018,970,1026,1996
2026,Veracruz,30,Astacinga,30019,3177,3602,6779
2026,Veracruz,30,Atlahuilco,30020,5594,5854,11448
2026,Veracruz,30,Atoyac,30021,12585,13278,25863
2026,Veracruz,30,Atzacan,30022,11239,11596,22835
2026,Veracruz,30,Atzalan,30023,27093,27269,54362
2026,Veracruz,30,Ayahualulco,30025,14129,14331,28460
2026,Veracruz,30,Banderilla,30026,12124,13521,25645
2026,Veracruz,30,Benito Juárez,30027,9193,9759,18952
2026,Veracruz,30,Boca del Río,30028,74266,84440,158706
2026,Veracruz,30,Calcahualco,30029,6732,6782,13514
2026,Veracruz,30,Camarón de Tejeda,30007,3542,3524,7066
2026,Veracruz,30,Camerino Z. Mendoza,30030,21578,24469,46047
2026,Veracruz,30,Carlos A. Carrillo,30208,13047,14285,27332
2026,Veracruz,30,Carrillo Puerto,30031,8980,9197,18177
2026,Veracruz,30,Castillo de Teayo,30157,10824,10608,21432
2026,Veracruz,30,Catemaco,30032,25671,27481,53152
2026,Veracruz,30,Cazones de Herrera,30033,12444,13246,25690
2026,Veracruz,30,Cerro Azul,30034,14059,15852,29911
2026,Veracruz,30,Chacaltianguis,30054,6660,7044,13704
2026,Veracruz,30,Chalma,30055,7207,7497,14704
2026,Veracruz,30,Chiconamel,30056,3444,3728,7172
2026,Veracruz,30,Chiconquiaco,30057,7485,7580,15065
2026,Veracruz,30,Chicontepec,30058,29590,31319,60909
2026,Veracruz,30,Chinameca,30059,8603,8999,17602
2026,Veracruz,30,Chinampa de Gorostiza,30060,8946,9211,18157
2026,Veracruz,30,Chocamán,30062,11333,11325,22658
2026,Veracruz,30,Chontla,30063,7774,7919,15693
2026,Veracruz,30,Chumatlán,30064,2026,2156,4182
2026,Veracruz,30,Citlaltépetl,30035,6299,6636,12935
2026,Veracruz,30,Coacoatzintla,30036,5467,5711,11178
2026,Veracruz,30,Coahuitlán,30037,4420,4592,9012
2026,Veracruz,30,Coatepec,30038,48366,52462,100828
2026,Veracruz,30,Coatzacoalcos,30039,168433,179568,348001
2026,Veracruz,30,Coatzintla,30040,30305,32033,62338
2026,Veracruz,30,Coetzala,30041,1202,1236,2438
2026,Veracruz,30,Colipa,30042,2949,3066,6015
2026,Veracruz,30,Comapa,30043,11122,10629,21751
2026,Veracruz,30,Cosamaloapan de Carpio,30045,30090,32943,63033
2026,Veracruz,30,Cosautlán de Carvajal,30046,8697,8794,17491
2026,Veracruz,30,Coscomatepec,30047,30506,31470,61976
2026,Veracruz,30,Cosoleacaque,30048,71447,76343,147790
2026,Veracruz,30,Cotaxtla,30049,11299,11275,22574
2026,Veracruz,30,Coxquihui,30050,8806,9235,18041
2026,Veracruz,30,Coyutla,30051,11539,12457,23996
2026,Veracruz,30,Cuichapa,30052,6296,6906,13202
2026,Veracruz,30,Cuitláhuac,30053,14652,15925,30577
2026,Veracruz,30,Córdoba,30044,110524,124997,235521
2026,Veracruz,30,El Higo,30205,10658,10790,21448
2026,Veracruz,30,Emiliano Zapata,30065,42638,45721,88359
2026,Veracruz,30,Espinal,30066,14340,15062,29402
2026,Veracruz,30,Filomeno Mata,30067,9877,9864,19741
2026,Veracruz,30,Fortín,30068,34430,38395,72825
2026,Veracruz,30,Gutiérrez Zamora,30069,12603,14259,26862
2026,Veracruz,30,Hidalgotitlán,30070,10470,10061,20531
2026,Veracruz,30,Huatusco,30071,31487,33814,65301
2026,Veracruz,30,Huayacocotla,30072,11220,11998,23218
2026,Veracruz,30,Hueyapan de Ocampo,30073,22768,24012,46780
2026,Veracruz,30,Huiloapan de Cuauhtémoc,30074,3782,4070,7852
2026,Veracruz,30,Ignacio de la Llave,30075,9056,9963,19019
2026,Veracruz,30,Ilamatlán,30076,6924,7635,14559
2026,Veracruz,30,Isla,30077,22640,23643,46283
2026,Veracruz,30,Ixcatepec,30078,7325,7364,14689
2026,Veracruz,30,Ixhuacán de los Reyes,30079,6175,6089,12264
2026,Veracruz,30,Ixhuatlancillo,30081,13566,14796,28362
2026,Veracruz,30,Ixhuatlán de Madero,30083,28467,30090,58557
2026,Veracruz,30,Ixhuatlán del Café,30080,12238,12282,24520
2026,Veracruz,30,Ixhuatlán del Sureste,30082,8485,8382,16867
2026,Veracruz,30,Ixmatlahuacan,30084,3106,3166,6272
2026,Veracruz,30,Ixtaczoquitlán,30085,35812,38036,73848
2026,Veracruz,30,Jalacingo,30086,22923,24088,47011
2026,Veracruz,30,Jalcomulco,30088,2803,2781,5584
2026,Veracruz,30,Jamapa,30090,6062,6362,12424
2026,Veracruz,30,Jesús Carranza,30091,15772,15816,31588
2026,Veracruz,30,Jilotepec,30093,8852,9282,18134
2026,Veracruz,30,José Azueta,30169,12114,12517,24631
2026,Veracruz,30,Juan Rodríguez Clara,30094,21029,21478,42507
2026,Veracruz,30,Juchique de Ferrer,30095,8501,8600,17101
2026,Veracruz,30,Jáltipan,30089,21699,23751,45450
2026,Veracruz,30,La Antigua,30016,14092,15201,29293
2026,Veracruz,30,La Perla,30127,14411,14967,29378
2026,Veracruz,30,Landero y Coss,30096,853,903,1756
2026,Veracruz,30,Las Choapas,30061,43004,44520,87524
2026,Veracruz,30,Las Minas,30107,1613,1562,3175
2026,Veracruz,30,Las Vigas de Ramírez,30132,10533,10634,21167
2026,Veracruz,30,Lerdo de Tejada,30097,10158,11708,21866
2026,Veracruz,30,Los Reyes,30137,3128,3173,6301
2026,Veracruz,30,Magdalena,30098,1625,1651,3276
2026,Veracruz,30,Maltrata,30099,9333,9929,19262
2026,Veracruz,30,Manlio Fabio Altamirano,30100,12649,13110,25759
2026,Veracruz,30,Mariano Escobedo,30101,18715,20175,38890
2026,Veracruz,30,Martínez de la Torre,30102,54222,59132,113354
2026,Veracruz,30,Mecatlán,30103,6439,6658,13097
2026,Veracruz,30,Mecayapan,30104,8843,9206,18049
2026,Veracruz,30,Medellín,30105,42209,45777,87986
2026,Veracruz,30,Miahuatlán,30106,2478,2558,5036
2026,Veracruz,30,Minatitlán,30108,82570,88045,170615
2026,Veracruz,30,Misantla,30109,34026,35772,69798
2026,Veracruz,30,Mixtla de Altamirano,30110,6267,6164,12431
2026,Veracruz,30,Moloacán,30111,9087,9600,18687
2026,Veracruz,30,Nanchital de Lázaro Cárdenas del Rio,30206,15628,16533,32161
2026,Veracruz,30,Naolinco,30112,11540,12074,23614
2026,Veracruz,30,Naranjal,30113,2361,2528,4889
2026,Veracruz,30,Naranjos Amatlán,30013,14786,16516,31302
2026,Veracruz,30,Nautla,30114,5932,6154,12086
2026,Veracruz,30,Nogales,30115,19557,21531,41088
2026,Veracruz,30,Oluta,30116,8567,9246,17813
2026,Veracruz,30,Omealca,30117,12559,13387,25946
2026,Veracruz,30,Orizaba,30118,63926,75963,139889
2026,Veracruz,30,Otatitlán,30119,2950,3227,6177
2026,Veracruz,30,Oteapan,30120,8642,8935,17577
2026,Veracruz,30,Ozuluama de Mascareñas,30121,12931,12410,25341
2026,Veracruz,30,Pajapan,30122,9319,9234,18553
2026,Veracruz,30,Papantla,30124,84265,85776,170041
2026,Veracruz,30,Paso de Ovejas,30126,18258,18435,36693
2026,Veracruz,30,Paso del Macho,30125,16943,17278,34221
2026,Veracruz,30,Perote,30128,38913,39424,78337
2026,Veracruz,30,Platón Sánchez,30129,9660,10111,19771
2026,Veracruz,30,Playa Vicente,30130,19485,21015,40500
2026,Veracruz,30,Poza Rica de Hidalgo,30131,106961,119388,226349
2026,Veracruz,30,Pueblo Viejo,30133,31153,31266,62419
2026,Veracruz,30,Puente Nacional,30134,12163,12533,24696
2026,Veracruz,30,Pánuco,30123,54294,54765,109059
2026,Veracruz,30,Rafael Delgado,30135,12272,12735,25007
2026,Veracruz,30,Rafael Lucio,30136,4253,4504,8757
2026,Veracruz,30,Río Blanco,30138,21540,24517,46057
2026,Veracruz,30,Saltabarranca,30139,3299,3533,6832
2026,Veracruz,30,San Andrés Tenejapan,30140,1533,1607,3140
2026,Veracruz,30,San Andrés Tuxtla,30141,85130,92023,177153
2026,Veracruz,30,San Juan Evangelista,30142,18050,18668,36718
2026,Veracruz,30,San Rafael,30211,15832,16505,32337
2026,Veracruz,30,Santiago Sochiapan,30212,7209,7711,14920
2026,Veracruz,30,Santiago Tuxtla,30143,29930,32241,62171
2026,Veracruz,30,Sayula de Alemán,30144,17311,17820,35131
2026,Veracruz,30,Sochiapa,30146,1942,1951,3893
2026,Veracruz,30,Soconusco,30145,8597,9033,17630
2026,Veracruz,30,Soledad Atzompa,30147,12195,12326,24521
2026,Veracruz,30,Soledad de Doblado,30148,14836,15155,29991
2026,Veracruz,30,Soteapan,30149,17963,18554,36517
2026,Veracruz,30,Tamalín,30150,6309,6285,12594
2026,Veracruz,30,Tamiahua,30151,12772,12755,25527
2026,Veracruz,30,Tampico Alto,30152,7080,6630,13710
2026,Veracruz,30,Tancoco,30153,3050,3256,6306
2026,Veracruz,30,Tantima,30154,7201,6983,14184
2026,Veracruz,30,Tantoyuca,30155,54744,56447,111191
2026,Veracruz,30,Tatahuicapan de Juárez,30209,8282,8566,16848
2026,Veracruz,30,Tatatila,30156,3281,3023,6304
2026,Veracruz,30,Tecolutla,30158,12808,13192,26000
2026,Veracruz,30,Tehuipango,30159,13359,14179,27538
2026,Veracruz,30,Tempoal,30161,19001,19663,38664
2026,Veracruz,30,Tenampa,30162,3576,3691,7267
2026,Veracruz,30,Tenochtitlán,30163,2695,2855,5550
2026,Veracruz,30,Teocelo,30164,8731,9278,18009
2026,Veracruz,30,Tepatlaxco,30165,4661,4398,9059
2026,Veracruz,30,Tepetlán,30166,5310,5138,10448
2026,Veracruz,30,Tepetzintla,30167,7834,8075,15909
2026,Veracruz,30,Tequila,30168,7959,8237,16196
2026,Veracruz,30,Texcatepec,30170,5711,5971,11682
2026,Veracruz,30,Texhuacán,30171,2709,3003,5712
2026,Veracruz,30,Texistepec,30172,11272,11192,22464
2026,Veracruz,30,Tezonapa,30173,30383,31073,61456
2026,Veracruz,30,Tierra Blanca,30174,55658,59888,115546
2026,Veracruz,30,Tihuatlán,30175,51038,53162,104200
2026,Veracruz,30,Tlachichilco,30180,6142,6335,12477
2026,Veracruz,30,Tlacojalpan,30176,2639,2748,5387
2026,Veracruz,30,Tlacolulan,30177,6107,5901,12008
2026,Veracruz,30,Tlacotalpan,30178,6992,7680,14672
2026,Veracruz,30,Tlacotepec de Mejía,30179,2108,2153,4261
2026,Veracruz,30,Tlalixcoyan,30181,20420,21123,41543
2026,Veracruz,30,Tlalnelhuayocan,30182,9914,10253,20167
2026,Veracruz,30,Tlaltetela,30024,8485,8234,16719
2026,Veracruz,30,Tlapacoyan,30183,32362,34285,66647
2026,Veracruz,30,Tlaquilpa,30184,3797,4338,8135
2026,Veracruz,30,Tlilapan,30185,2762,2914,5676
2026,Veracruz,30,Tomatlán,30186,3712,3818,7530
2026,Veracruz,30,Tonayán,30187,2924,3121,6045
2026,Veracruz,30,Totutla,30188,9365,9428,18793
2026,Veracruz,30,Tres Valles,30207,24409,25684,50093
2026,Veracruz,30,Tuxpan,30189,85641,90427,176068
2026,Veracruz,30,Tuxtilla,30190,1222,1255,2477
2026,Veracruz,30,Ursulo Galván,30191,16483,17451,33934
2026,Veracruz,30,Uxpanapa,30210,15815,15288,31103
2026,Veracruz,30,Vega de Alatorre,30192,10691,11404,22095
2026,Veracruz,30,Veracruz,30193,308590,337051,645641
2026,Veracruz,30,Villa Aldama,30194,6215,6388,12603
2026,Veracruz,30,Xalapa,30087,246920,279140,526060
2026,Veracruz,30,Xico,30092,20405,21036,41441
2026,Veracruz,30,Xoxocotla,30195,2943,2831,5774
2026,Veracruz,30,Yanga,30196,9279,10465,19744
2026,Veracruz,30,Yecuatla,30197,6434,6620,13054
2026,Veracruz,30,Zacualpan,30198,3765,4051,7816
2026,Veracruz,30,Zaragoza,30199,5882,6116,11998
2026,Veracruz,30,Zentla,30200,7332,7186,14518
2026,Veracruz,30,Zongolica,30201,23038,23554,46592
2026,Veracruz,30,Zontecomatlán de López y Fuentes,30202,7626,7875,15501
2026,Veracruz,30,Zozocolco de Hidalgo,30203,7956,8312,16268
2026,Veracruz,30,Álamo Temapache,30160,56391,57093,113484
2026,Yucatán,31,Abalá,31001,3800,3634,7434
2026,Yucatán,31,Acanceh,31002,9221,9209,18430
2026,Yucatán,31,Akil,31003,6103,6349,12452
2026,Yucatán,31,Baca,31004,3410,3499,6909
2026,Yucatán,31,Bokobá,31005,1284,1237,2521
2026,Yucatán,31,Buctzotz,31006,5092,5073,10165
2026,Yucatán,31,Cacalchén,31007,4262,4046,8308
2026,Yucatán,31,Calotmul,31008,2317,2316,4633
2026,Yucatán,31,Cansahcab,31009,2655,2717,5372
2026,Yucatán,31,Cantamayec,31010,1474,1355,2829
2026,Yucatán,31,Celestún,31011,4481,4245,8726
2026,Yucatán,31,Cenotillo,31012,2204,2345,4549
2026,Yucatán,31,Chacsinkín,31016,1695,1656,3351
2026,Yucatán,31,Chankom,31017,2626,2539,5165
2026,Yucatán,31,Chapab,31018,1813,1804,3617
2026,Yucatán,31,Chemax,31019,20497,20168,40665
2026,Yucatán,31,Chichimilá,31021,4733,4666,9399
2026,Yucatán,31,Chicxulub Pueblo,31020,2628,2503,5131
2026,Yucatán,31,Chikindzonot,31022,2338,2274,4612
2026,Yucatán,31,Chocholá,31023,2748,2663,5411
2026,Yucatán,31,Chumayel,31024,1829,1881,3710
2026,Yucatán,31,Conkal,31013,6417,6413,12830
2026,Yucatán,31,Cuncunul,31014,929,898,1827
2026,Yucatán,31,Cuzamá,31015,2961,2879,5840
2026,Yucatán,31,Dzemul,31026,2161,2157,4318
2026,Yucatán,31,Dzidzantún,31027,4797,4690,9487
2026,Yucatán,31,Dzilam González,31029,3578,3395,6973
2026,Yucatán,31,Dzilam de Bravo,31028,1595,1498,3093
2026,Yucatán,31,Dzitás,31030,2210,2113,4323
2026,Yucatán,31,Dzoncauich,31031,1493,1531,3024
2026,Yucatán,31,Dzán,31025,2956,3076,6032
2026,Yucatán,31,Espita,31032,9255,9005,18260
2026,Yucatán,31,Halachó,31033,11604,11349,22953
2026,Yucatán,31,Hocabá,31034,3516,3513,7029
2026,Yucatán,31,Hoctún,31035,3354,3429,6783
2026,Yucatán,31,Homún,31036,4444,4274,8718
2026,Yucatán,31,Huhí,31037,3035,2923,5958
2026,Yucatán,31,Hunucmá,31038,18361,18464,36825
2026,Yucatán,31,Ixil,31039,2365,2287,4652
2026,Yucatán,31,Izamal,31040,15239,15572,30811
2026,Yucatán,31,Kanasín,31041,58068,58935,117003
2026,Yucatán,31,Kantunil,31042,2989,3145,6134
2026,Yucatán,31,Kaua,31043,1772,1707,3479
2026,Yucatán,31,Kinchil,31044,4109,4014,8123
2026,Yucatán,31,Kopomá,31045,1505,1422,2927
2026,Yucatán,31,Mama,31046,1716,1876,3592
2026,Yucatán,31,Maní,31047,3126,3259,6385
2026,Yucatán,31,Maxcanú,31048,12964,12777,25741
2026,Yucatán,31,Mayapán,31049,2123,1966,4089
2026,Yucatán,31,Mocochá,31051,1906,1865,3771
2026,Yucatán,31,Motul,31052,20661,21036,41697
2026,Yucatán,31,Muna,31053,7073,7336,14409
2026,Yucatán,31,Muxupip,31054,1611,1678,3289
2026,Yucatán,31,Mérida,31050,493933,535202,1029135
2026,Yucatán,31,Opichén,31055,3906,3773,7679
2026,Yucatán,31,Oxkutzcab,31056,16768,18235,35003
2026,Yucatán,31,Panabá,31057,4359,4397,8756
2026,Yucatán,31,Peto,31058,14125,14332,28457
2026,Yucatán,31,Progreso,31059,33288,33735,67023
2026,Yucatán,31,Quintana Roo,31060,552,552,1104
2026,Yucatán,31,Río Lagartos,31061,2081,1969,4050
2026,Yucatán,31,Sacalum,31062,2796,2662,5458
2026,Yucatán,31,Samahil,31063,2939,2919,5858
2026,Yucatán,31,San Felipe,31065,1128,1065,2193
2026,Yucatán,31,Sanahcat,31064,989,980,1969
2026,Yucatán,31,Santa Elena,31066,2196,2297,4493
2026,Yucatán,31,Seyé,31067,5575,5333,10908
2026,Yucatán,31,Sinanché,31068,1897,1750,3647
2026,Yucatán,31,Sotuta,31069,5129,4951,10080
2026,Yucatán,31,Sucilá,31070,2273,2195,4468
2026,Yucatán,31,Sudzal,31071,1017,914,1931
2026,Yucatán,31,Suma,31072,1083,1052,2135
2026,Yucatán,31,Tahdziú,31073,2895,2730,5625
2026,Yucatán,31,Tahmek,31074,2195,2127,4322
2026,Yucatán,31,Teabo,31075,3709,3728,7437
2026,Yucatán,31,Tecoh,31076,10002,9947,19949
2026,Yucatán,31,Tekal de Venegas,31077,1541,1496,3037
2026,Yucatán,31,Tekantó,31078,2171,2182,4353
2026,Yucatán,31,Tekax,31079,23551,24349,47900
2026,Yucatán,31,Tekit,31080,5845,5685,11530
2026,Yucatán,31,Tekom,31081,1796,1836,3632
2026,Yucatán,31,Telchac Pueblo,31082,2216,2201,4417
2026,Yucatán,31,Telchac Puerto,31083,1059,965,2024
2026,Yucatán,31,Temax,31084,4170,4153,8323
2026,Yucatán,31,Temozón,31085,8829,8591,17420
2026,Yucatán,31,Tepakán,31086,1317,1264,2581
2026,Yucatán,31,Tetiz,31087,2857,2858,5715
2026,Yucatán,31,Teya,31088,1118,1130,2248
2026,Yucatán,31,Ticul,31089,22349,23040,45389
2026,Yucatán,31,Timucuy,31090,4244,4081,8325
2026,Yucatán,31,Tinum,31091,6836,6616,13452
2026,Yucatán,31,Tixcacalcupul,31092,4021,3971,7992
2026,Yucatán,31,Tixkokob,31093,10235,10440,20675
2026,Yucatán,31,Tixmehuac,31094,2746,2743,5489
2026,Yucatán,31,Tixpéhual,31095,3107,3228,6335
2026,Yucatán,31,Tizimín,31096,43075,44354,87429
2026,Yucatán,31,Tunkás,31097,2054,1966,4020
2026,Yucatán,31,Tzucacab,31098,8332,8186,16518
2026,Yucatán,31,Uayma,31099,2372,2278,4650
2026,Yucatán,31,Ucú,31100,2126,2095,4221
2026,Yucatán,31,Umán,31101,30329,30326,60655
2026,Yucatán,31,Valladolid,31102,44912,45746,90658
2026,Yucatán,31,Xocchel,31103,2031,1954,3985
2026,Yucatán,31,Yaxcabá,31104,8840,8333,17173
2026,Yucatán,31,Yaxkukul,31105,1802,1818,3620
2026,Yucatán,31,Yobaín,31106,1336,1287,2623
2026,Zacatecas,32,Apozol,32001,3188,3417,6605
2026,Zacatecas,32,Apulco,32002,2503,2767,5270
2026,Zacatecas,32,Atolinga,32003,1345,1443,2788
2026,Zacatecas,32,Benito Juárez,32004,2261,2201,4462
2026,Zacatecas,32,Calera,32005,24304,24285,48589
2026,Zacatecas,32,Cañitas de Felipe Pescador,32006,4442,4548,8990
2026,Zacatecas,32,Chalchihuites,32009,6096,6415,12511
2026,Zacatecas,32,Concepción del Oro,32007,7377,7273,14650
2026,Zacatecas,32,Cuauhtémoc,32008,6633,7000,13633
2026,Zacatecas,32,El Plateado de Joaquín Amaro,32015,686,714,1400
2026,Zacatecas,32,El Salvador,32041,1313,1280,2593
2026,Zacatecas,32,Fresnillo,32010,123884,127523,251407
2026,Zacatecas,32,Genaro Codina,32012,4319,4520,8839
2026,Zacatecas,32,General Enrique Estrada,32013,3378,3444,6822
2026,Zacatecas,32,General Francisco R. Murguía,32014,11526,12193,23719
2026,Zacatecas,32,General Pánfilo Natera,32016,12288,12765,25053
2026,Zacatecas,32,Guadalupe,32017,101603,106633,208236
2026,Zacatecas,32,Huanusco,32018,2187,2292,4479
2026,Zacatecas,32,Jalpa,32019,12926,13526,26452
2026,Zacatecas,32,Jerez,32020,32091,34177,66268
2026,Zacatecas,32,Jiménez del Teul,32021,2237,2288,4525
2026,Zacatecas,32,Juan Aldama,32022,11514,12191,23705
2026,Zacatecas,32,Juchipila,32023,6642,7427,14069
2026,Zacatecas,32,Loreto,32024,29072,29515,58587
2026,Zacatecas,32,Luis Moya,32025,7244,7308,14552
2026,Zacatecas,32,Mazapil,32026,10143,9269,19412
2026,Zacatecas,32,Melchor Ocampo,32027,1767,1546,3313
2026,Zacatecas,32,Mezquital del Oro,32028,1309,1421,2730
2026,Zacatecas,32,Miguel Auza,32029,12577,13095,25672
2026,Zacatecas,32,Momax,32030,1277,1382,2659
2026,Zacatecas,32,Monte Escobedo,32031,5074,5213,10287
2026,Zacatecas,32,Morelos,32032,6767,6827,13594
2026,Zacatecas,32,Moyahua de Estrada,32033,2063,2359,4422
2026,Zacatecas,32,Nochistlán de Mejía,32034,14636,16136,30772
2026,Zacatecas,32,Noria de Ángeles,32035,9033,9296,18329
2026,Zacatecas,32,Ojocaliente,32036,22808,23770,46578
2026,Zacatecas,32,Pinos,32038,38769,40551,79320
2026,Zacatecas,32,Pánuco,32037,9733,9698,19431
2026,Zacatecas,32,Río Grande,32039,33987,36055,70042
2026,Zacatecas,32,Sain Alto,32040,11778,12387,24165
2026,Zacatecas,32,Santa María de la Paz,32058,1451,1485,2936
2026,Zacatecas,32,Sombrerete,32042,33325,34341,67666
2026,Zacatecas,32,Susticacán,32043,727,796,1523
2026,Zacatecas,32,Tabasco,32044,8242,8696,16938
2026,Zacatecas,32,Tepechitlán,32045,4609,5041,9650
2026,Zacatecas,32,Tepetongo,32046,3879,4139,8018
2026,Zacatecas,32,Teúl de González Ortega,32047,2595,2744,5339
2026,Zacatecas,32,Tlaltenango de Sánchez Román,32048,14334,15011,29345
2026,Zacatecas,32,Trancoso,32057,10377,10626,21003
2026,Zacatecas,32,Trinidad García de la Cadena,32011,1548,1613,3161
2026,Zacatecas,32,Valparaíso,32049,17968,18577,36545
2026,Zacatecas,32,Vetagrande,32050,5387,5520,10907
2026,Zacatecas,32,Villa García,32052,10326,10478,20804
2026,Zacatecas,32,Villa González Ortega,32053,7032,7426,14458
2026,Zacatecas,32,Villa Hidalgo,32054,10308,10443,20751
2026,Zacatecas,32,Villa de Cos,32051,19350,19072,38422
2026,Zacatecas,32,Villanueva,32055,16302,17017,33319
2026,Zacatecas,32,Zacatecas,32056,77936,82911,160847
2027,Aguascalientes,01,Aguascalientes,01001,512799,534350,1047149
2027,Aguascalientes,01,Asientos,01002,27308,27455,54763
2027,Aguascalientes,01,Calvillo,01003,32681,33822,66503
2027,Aguascalientes,01,Cosío,01004,8959,9216,18175
2027,Aguascalientes,01,El Llano,01010,11995,11688,23683
2027,Aguascalientes,01,Jesús María,01005,70848,69829,140677
2027,Aguascalientes,01,Pabellón de Arteaga,01006,26246,27419,53665
2027,Aguascalientes,01,Rincón de Romos,01007,31027,31272,62299
2027,Aguascalientes,01,San Francisco de los Romo,01011,27813,27814,55627
2027,Aguascalientes,01,San José de Gracia,01008,5115,5375,10490
2027,Aguascalientes,01,Tepezalá,01009,12233,12490,24723
2027,Baja California,02,Ensenada,02001,295029,296801,591830
2027,Baja California,02,Mexicali,02002,602287,608815,1211102
2027,Baja California,02,Playas de Rosarito,02005,59512,59234,118746
2027,Baja California,02,Tecate,02003,63916,61048,124964
2027,Baja California,02,Tijuana,02004,971455,981118,1952573
2027,Baja California Sur,03,Comondú,03001,48761,47615,96376
2027,Baja California Sur,03,La Paz,03003,170462,173242,343704
2027,Baja California Sur,03,Loreto,03009,13034,12004,25038
2027,Baja California Sur,03,Los Cabos,03008,191690,181048,372738
2027,Baja California Sur,03,Mulegé,03002,39198,36692,75890
2027,Campeche,04,Calakmul,04010,17638,16865,34503
2027,Campeche,04,Calkiní,04001,34537,35808,70345
2027,Campeche,04,Campeche,04002,170314,183663,353977
2027,Campeche,04,Candelaria,04011,27367,26438,53805
2027,Campeche,04,Carmen,04003,151960,152887,304847
2027,Campeche,04,Champotón,04004,56338,55557,111895
2027,Campeche,04,Escárcega,04009,34831,35267,70098
2027,Campeche,04,Hecelchakán,04005,19121,19242,38363
2027,Campeche,04,Hopelchén,04006,25237,24037,49274
2027,Campeche,04,Palizada,04007,5549,5427,10976
2027,Campeche,04,Tenabo,04008,6774,6446,13220
2027,Chiapas,07,Acacoyagua,07001,10970,10845,21815
2027,Chiapas,07,Acala,07002,18847,19292,38139
2027,Chiapas,07,Acapetahua,07003,17250,17199,34449
2027,Chiapas,07,Aldama,07113,3754,4082,7836
2027,Chiapas,07,Altamirano,07004,19669,19501,39170
2027,Chiapas,07,Amatenango de la Frontera,07006,18147,19117,37264
2027,Chiapas,07,Amatenango del Valle,07007,5607,6111,11718
2027,Chiapas,07,Amatán,07005,11850,11513,23363
2027,Chiapas,07,Angel Albino Corzo,07008,16737,16869,33606
2027,Chiapas,07,Arriaga,07009,23636,25460,49096
2027,Chiapas,07,Bejucal de Ocampo,07010,4567,4540,9107
2027,Chiapas,07,Bella Vista,07011,12082,12173,24255
2027,Chiapas,07,Benemérito de las Américas,07114,12158,11886,24044
2027,Chiapas,07,Berriozábal,07012,31333,31736,63069
2027,Chiapas,07,Bochil,07013,20429,20912,41341
2027,Chiapas,07,Cacahoatán,07015,27097,28492,55589
2027,Chiapas,07,Catazajá,07016,10620,10525,21145
2027,Chiapas,07,Chalchihuitán,07022,9574,9753,19327
2027,Chiapas,07,Chamula,07023,47861,56269,104130
2027,Chiapas,07,Chanal,07024,7250,7292,14542
2027,Chiapas,07,Chapultenango,07025,4489,4472,8961
2027,Chiapas,07,Chenalhó,07026,23519,24043,47562
2027,Chiapas,07,Chiapa de Corzo,07027,60292,62832,123124
2027,Chiapas,07,Chiapilla,07028,3595,3483,7078
2027,Chiapas,07,Chicoasén,07029,3027,3047,6074
2027,Chiapas,07,Chicomuselo,07030,21007,21238,42245
2027,Chiapas,07,Chilón,07031,75343,77154,152497
2027,Chiapas,07,Cintalapa,07017,51254,52255,103509
2027,Chiapas,07,Coapilla,07018,5400,5559,10959
2027,Chiapas,07,Comitán de Domínguez,07019,89168,98351,187519
2027,Chiapas,07,Copainalá,07021,12837,13470,26307
2027,Chiapas,07,El Bosque,07014,12958,13855,26813
2027,Chiapas,07,El Porvenir,07070,8423,8525,16948
2027,Chiapas,07,Escuintla,07032,18801,19324,38125
2027,Chiapas,07,Francisco León,07033,4556,4395,8951
2027,Chiapas,07,Frontera Comalapa,07034,43437,45709,89146
2027,Chiapas,07,Frontera Hidalgo,07035,8514,8988,17502
2027,Chiapas,07,Huehuetán,07037,20529,21639,42168
2027,Chiapas,07,Huitiupán,07039,13666,13501,27167
2027,Chiapas,07,Huixtla,07040,31514,33957,65471
2027,Chiapas,07,Huixtán,07038,13841,14373,28214
2027,Chiapas,07,Ixhuatán,07042,6678,6830,13508
2027,Chiapas,07,Ixtacomitán,07043,6356,6480,12836
2027,Chiapas,07,Ixtapa,07044,16070,16320,32390
2027,Chiapas,07,Ixtapangajoya,07045,3320,3239,6559
2027,Chiapas,07,Jiquipilas,07046,23736,24657,48393
2027,Chiapas,07,Jitotol,07047,12407,12130,24537
2027,Chiapas,07,Juárez,07048,12873,13257,26130
2027,Chiapas,07,La Concordia,07020,27871,27461,55332
2027,Chiapas,07,La Grandeza,07036,4210,4330,8540
2027,Chiapas,07,La Independencia,07041,26725,27715,54440
2027,Chiapas,07,La Libertad,07050,2943,3052,5995
2027,Chiapas,07,La Trinitaria,07099,46477,48586,95063
2027,Chiapas,07,Larráinzar,07049,13787,14298,28085
2027,Chiapas,07,Las Margaritas,07052,73398,74763,148161
2027,Chiapas,07,Las Rosas,07075,16609,17070,33679
2027,Chiapas,07,Mapastepec,07051,28293,29214,57507
2027,Chiapas,07,Maravilla Tenejapa,07115,7656,7430,15086
2027,Chiapas,07,Marqués de Comillas,07116,6951,6746,13697
2027,Chiapas,07,Mazapa de Madero,07053,4651,4841,9492
2027,Chiapas,07,Mazatán,07054,17405,18021,35426
2027,Chiapas,07,Metapa,07055,3283,3569,6852
2027,Chiapas,07,Mitontic,07056,7099,7171,14270
2027,Chiapas,07,Montecristo de Guerrero,07117,4526,4436,8962
2027,Chiapas,07,Motozintla,07057,42867,44517,87384
2027,Chiapas,07,Nicolás Ruíz,07058,2616,2472,5088
2027,Chiapas,07,Ocosingo,07059,129353,130379,259732
2027,Chiapas,07,Ocotepec,07060,7223,7579,14802
2027,Chiapas,07,Ocozocoautla de Espinosa,07061,54023,55637,109660
2027,Chiapas,07,Ostuacán,07062,11058,10913,21971
2027,Chiapas,07,Osumacinta,07063,2226,2232,4458
2027,Chiapas,07,Oxchuc,07064,28115,27932,56047
2027,Chiapas,07,Palenque,07065,70434,72591,143025
2027,Chiapas,07,Pantelhó,07066,12824,13044,25868
2027,Chiapas,07,Pantepec,07067,7234,7374,14608
2027,Chiapas,07,Pichucalco,07068,18670,19191,37861
2027,Chiapas,07,Pijijiapan,07069,31851,32762,64613
2027,Chiapas,07,Pueblo Nuevo Solistahuacán,07072,18001,19642,37643
2027,Chiapas,07,Rayón,07073,5677,5802,11479
2027,Chiapas,07,Reforma,07074,27120,27578,54698
2027,Chiapas,07,Sabanilla,07076,15976,15817,31793
2027,Chiapas,07,Salto de Agua,07077,37307,37761,75068
2027,Chiapas,07,San Andrés Duraznal,07118,3202,3375,6577
2027,Chiapas,07,San Cristóbal de las Casas,07078,119230,133160,252390
2027,Chiapas,07,San Fernando,07079,23997,23520,47517
2027,Chiapas,07,San Juan Cancuc,07112,20265,21173,41438
2027,Chiapas,07,San Lucas,07110,4285,4313,8598
2027,Chiapas,07,Santiago el Pinar,07119,2142,2098,4240
2027,Chiapas,07,Siltepec,07080,21649,20937,42586
2027,Chiapas,07,Simojovel,07081,25942,26441,52383
2027,Chiapas,07,Sitalá,07082,8407,8517,16924
2027,Chiapas,07,Socoltenango,07083,10991,11041,22032
2027,Chiapas,07,Solosuchiapa,07084,4783,4729,9512
2027,Chiapas,07,Soyaló,07085,6444,6405,12849
2027,Chiapas,07,Suchiapa,07086,14586,14639,29225
2027,Chiapas,07,Suchiate,07087,22592,23652,46244
2027,Chiapas,07,Sunuapa,07088,1445,1424,2869
2027,Chiapas,07,Tapachula,07089,202653,222558,425211
2027,Chiapas,07,Tapalapa,07090,2307,2434,4741
2027,Chiapas,07,Tapilula,07091,7607,8039,15646
2027,Chiapas,07,Tecpatán,07092,24742,25075,49817
2027,Chiapas,07,Tenejapa,07093,24950,26425,51375
2027,Chiapas,07,Teopisca,07094,24930,26424,51354
2027,Chiapas,07,Tila,07096,46755,46753,93508
2027,Chiapas,07,Tonalá,07097,53247,54957,108204
2027,Chiapas,07,Totolapa,07098,4331,4285,8616
2027,Chiapas,07,Tumbalá,07100,19848,20916,40764
2027,Chiapas,07,Tuxtla Chico,07102,24803,26461,51264
2027,Chiapas,07,Tuxtla Gutiérrez,07101,344070,382398,726468
2027,Chiapas,07,Tuzantán,07103,19192,19745,38937
2027,Chiapas,07,Tzimol,07104,9106,9549,18655
2027,Chiapas,07,Unión Juárez,07105,9119,9622,18741
2027,Chiapas,07,Venustiano Carranza,07106,38595,39062,77657
2027,Chiapas,07,Villa Comaltitlán,07071,17142,17514,34656
2027,Chiapas,07,Villa Corzo,07107,46166,47830,93996
2027,Chiapas,07,Villaflores,07108,62232,65272,127504
2027,Chiapas,07,Yajalón,07109,22229,23339,45568
2027,Chiapas,07,Zinacantán,07111,22722,25981,48703
2027,Chihuahua,08,Ahumada,08001,6966,6819,13785
2027,Chihuahua,08,Aldama,08002,14014,14141,28155
2027,Chihuahua,08,Allende,08003,5319,5199,10518
2027,Chihuahua,08,Aquiles Serdán,08004,10349,10025,20374
2027,Chihuahua,08,Ascensión,08005,13989,13684,27673
2027,Chihuahua,08,Bachíniva,08006,3877,3728,7605
2027,Chihuahua,08,Balleza,08007,9491,9208,18699
2027,Chihuahua,08,Batopilas,08008,6572,6586,13158
2027,Chihuahua,08,Bocoyna,08009,15213,15892,31105
2027,Chihuahua,08,Buenaventura,08010,13466,13153,26619
2027,Chihuahua,08,Camargo,08011,29297,30429,59726
2027,Chihuahua,08,Carichí,08012,5618,5469,11087
2027,Chihuahua,08,Casas Grandes,08013,6829,6496,13325
2027,Chihuahua,08,Chihuahua,08019,491955,521823,1013778
2027,Chihuahua,08,Chínipas,08020,4739,4293,9032
2027,Chihuahua,08,Coronado,08014,1389,1279,2668
2027,Chihuahua,08,Coyame del Sotol,08015,1134,926,2060
2027,Chihuahua,08,Cuauhtémoc,08017,94216,100605,194821
2027,Chihuahua,08,Cusihuiriachi,08018,2923,2698,5621
2027,Chihuahua,08,Delicias,08021,83901,88527,172428
2027,Chihuahua,08,Dr. Belisario Domínguez,08022,1691,1630,3321
2027,Chihuahua,08,El Tule,08064,1049,1008,2057
2027,Chihuahua,08,Galeana,08023,3739,3739,7478
2027,Chihuahua,08,Gran Morelos,08026,1644,1583,3227
2027,Chihuahua,08,Guachochi,08027,25297,26555,51852
2027,Chihuahua,08,Guadalupe,08028,2450,2495,4945
2027,Chihuahua,08,Guadalupe y Calvo,08029,30569,29954,60523
2027,Chihuahua,08,Guazapares,08030,4716,4505,9221
2027,Chihuahua,08,Guerrero,08031,23275,22885,46160
2027,Chihuahua,08,Gómez Farías,08025,5365,5320,10685
2027,Chihuahua,08,Hidalgo del Parral,08032,60721,64941,125662
2027,Chihuahua,08,Huejotitán,08033,613,613,1226
2027,Chihuahua,08,Ignacio Zaragoza,08034,4224,4135,8359
2027,Chihuahua,08,Janos,08035,6669,6099,12768
2027,Chihuahua,08,Jiménez,08036,24233,24708,48941
2027,Chihuahua,08,Julimes,08038,2747,2662,5409
2027,Chihuahua,08,Juárez,08037,757933,762375,1520308
2027,Chihuahua,08,La Cruz,08016,2375,2256,4631
2027,Chihuahua,08,López,08039,2506,2321,4827
2027,Chihuahua,08,Madera,08040,16735,16532,33267
2027,Chihuahua,08,Maguarichi,08041,917,864,1781
2027,Chihuahua,08,Manuel Benavides,08042,973,821,1794
2027,Chihuahua,08,Matachí,08043,1864,1845,3709
2027,Chihuahua,08,Matamoros,08044,2742,2630,5372
2027,Chihuahua,08,Meoqui,08045,25556,26125,51681
2027,Chihuahua,08,Morelos,08046,4298,4221,8519
2027,Chihuahua,08,Moris,08047,3037,2857,5894
2027,Chihuahua,08,Namiquipa,08048,14756,14072,28828
2027,Chihuahua,08,Nonoava,08049,1602,1512,3114
2027,Chihuahua,08,Nuevo Casas Grandes,08050,35191,36846,72037
2027,Chihuahua,08,Ocampo,08051,4411,4103,8514
2027,Chihuahua,08,Ojinaga,08052,16430,16226,32656
2027,Chihuahua,08,Praxedis G. Guerrero,08053,2683,2625,5308
2027,Chihuahua,08,Riva Palacio,08054,4524,4341,8865
2027,Chihuahua,08,Rosales,08055,10001,9840,19841
2027,Chihuahua,08,Rosario,08056,1270,1200,2470
2027,Chihuahua,08,San Francisco de Borja,08057,1462,1371,2833
2027,Chihuahua,08,San Francisco de Conchos,08058,1614,1514,3128
2027,Chihuahua,08,San Francisco del Oro,08059,3172,3164,6336
2027,Chihuahua,08,Santa Bárbara,08060,6387,6518,12905
2027,Chihuahua,08,Santa Isabel,08024,2372,2419,4791
2027,Chihuahua,08,Satevó,08061,1989,1868,3857
2027,Chihuahua,08,Saucillo,08062,18623,18446,37069
2027,Chihuahua,08,Temósachic,08063,4023,3845,7868
2027,Chihuahua,08,Urique,08065,11997,11606,23603
2027,Chihuahua,08,Uruachi,08066,3387,3207,6594
2027,Chihuahua,08,Valle de Zaragoza,08067,3294,3137,6431
2027,Ciudad de México,09,Azcapotzalco,09002,190496,216064,406560
2027,Ciudad de México,09,Benito Juárez,09014,203945,241171,445116
2027,Ciudad de México,09,Coyoacán,09003,289469,329531,619000
2027,Ciudad de México,09,Cuajimalpa de Morelos,09004,93281,100025,193306
2027,Ciudad de México,09,Cuauhtémoc,09015,260031,289842,549873
2027,Ciudad de México,09,Gustavo A. Madero,09005,556574,605861,1162435
2027,Ciudad de México,09,Iztacalco,09006,185160,206541,391701
2027,Ciudad de México,09,Iztapalapa,09007,848929,902375,1751304
2027,Ciudad de México,09,La Magdalena Contreras,09008,115023,124132,239155
2027,Ciudad de México,09,Miguel Hidalgo,09016,176394,206184,382578
2027,Ciudad de México,09,Milpa Alta,09009,65472,68241,133713
2027,Ciudad de México,09,Tlalpan,09012,319157,348477,667634
2027,Ciudad de México,09,Tláhuac,09011,168994,181519,350513
2027,Ciudad de México,09,Venustiano Carranza,09017,202607,229519,432126
2027,Ciudad de México,09,Xochimilco,09013,196111,205437,401548
2027,Ciudad de México,09,Álvaro Obregón,09010,354043,388713,742756
2027,Coahuila,05,Abasolo,05001,650,637,1287
2027,Coahuila,05,Acuña,05002,86665,85945,172610
2027,Coahuila,05,Allende,05003,13255,13573,26828
2027,Coahuila,05,Arteaga,05004,14313,13629,27942
2027,Coahuila,05,Candela,05005,1140,1037,2177
2027,Coahuila,05,Castaños,05006,16760,16678,33438
2027,Coahuila,05,Cuatro Ciénegas,05007,8106,7934,16040
2027,Coahuila,05,Escobedo,05008,1899,1807,3706
2027,Coahuila,05,Francisco I. Madero,05009,35455,35493,70948
2027,Coahuila,05,Frontera,05010,48122,47652,95774
2027,Coahuila,05,General Cepeda,05011,7825,7154,14979
2027,Coahuila,05,Guerrero,05012,1145,1018,2163
2027,Coahuila,05,Hidalgo,05013,1027,984,2011
2027,Coahuila,05,Jiménez,05014,6051,5832,11883
2027,Coahuila,05,Juárez,05015,997,903,1900
2027,Coahuila,05,Lamadrid,05016,1152,1081,2233
2027,Coahuila,05,Matamoros,05017,64964,64663,129627
2027,Coahuila,05,Monclova,05018,136318,138542,274860
2027,Coahuila,05,Morelos,05019,5244,5115,10359
2027,Coahuila,05,Múzquiz,05020,42064,41166,83230
2027,Coahuila,05,Nadadores,05021,3962,3889,7851
2027,Coahuila,05,Nava,05022,18278,17305,35583
2027,Coahuila,05,Ocampo,05023,6403,5891,12294
2027,Coahuila,05,Parras,05024,26925,25735,52660
2027,Coahuila,05,Piedras Negras,05025,95649,94899,190548
2027,Coahuila,05,Progreso,05026,2095,1944,4039
2027,Coahuila,05,Ramos Arizpe,05027,57753,55293,113046
2027,Coahuila,05,Sabinas,05028,38137,37977,76114
2027,Coahuila,05,Sacramento,05029,1463,1413,2876
2027,Coahuila,05,Saltillo,05030,470032,473588,943620
2027,Coahuila,05,San Buenaventura,05031,14283,14272,28555
2027,Coahuila,05,San Juan de Sabinas,05032,25583,26744,52327
2027,Coahuila,05,San Pedro,05033,64782,64900,129682
2027,Coahuila,05,Sierra Mojada,05034,4604,4222,8826
2027,Coahuila,05,Torreón,05035,396675,416524,813199
2027,Coahuila,05,Viesca,05036,13403,12838,26241
2027,Coahuila,05,Villa Unión,05037,3833,3632,7465
2027,Coahuila,05,Zaragoza,05038,7744,7673,15417
2027,Colima,06,Armería,06001,18225,17795,36020
2027,Colima,06,Colima,06002,91689,96800,188489
2027,Colima,06,Comala,06003,13298,13077,26375
2027,Colima,06,Coquimatlán,06004,12430,12062,24492
2027,Colima,06,Cuauhtémoc,06005,18516,18178,36694
2027,Colima,06,Ixtlahuacán,06006,3459,3362,6821
2027,Colima,06,Manzanillo,06007,113289,110108,223397
2027,Colima,06,Minatitlán,06008,5640,5127,10767
2027,Colima,06,Tecomán,06009,74809,72959,147768
2027,Colima,06,Villa de Álvarez,06010,80315,83923,164238
2027,Durango,10,Canatlán,10001,18369,18842,37211
2027,Durango,10,Canelas,10002,2638,2416,5054
2027,Durango,10,Coneto de Comonfort,10003,2457,2464,4921
2027,Durango,10,Cuencamé,10004,20066,19718,39784
2027,Durango,10,Durango,10005,353988,379597,733585
2027,Durango,10,El Oro,10018,6664,6755,13419
2027,Durango,10,General Simón Bolívar,10006,5731,5806,11537
2027,Durango,10,Guadalupe Victoria,10008,19832,20208,40040
2027,Durango,10,Guanaceví,10009,5738,5375,11113
2027,Durango,10,Gómez Palacio,10007,191526,196246,387772
2027,Durango,10,Hidalgo,10010,2272,2212,4484
2027,Durango,10,Indé,10011,3012,2973,5985
2027,Durango,10,Lerdo,10012,86130,87122,173252
2027,Durango,10,Mapimí,10013,15002,14949,29951
2027,Durango,10,Mezquital,10014,20559,21257,41816
2027,Durango,10,Nazas,10015,7450,7444,14894
2027,Durango,10,Nombre de Dios,10016,11167,11200,22367
2027,Durango,10,Nuevo Ideal,10039,15270,15436,30706
2027,Durango,10,Ocampo,10017,5760,5537,11297
2027,Durango,10,Otáez,10019,2963,2727,5690
2027,Durango,10,Peñón Blanco,10021,6197,6095,12292
2027,Durango,10,Poanas,10022,14201,14488,28689
2027,Durango,10,Pueblo Nuevo,10023,27083,27302,54385
2027,Durango,10,Pánuco de Coronado,10020,6842,7006,13848
2027,Durango,10,Rodeo,10024,7808,7752,15560
2027,Durango,10,San Bernardo,10025,2019,1794,3813
2027,Durango,10,San Dimas,10026,10771,10116,20887
2027,Durango,10,San Juan de Guadalupe,10027,3102,3211,6313
2027,Durango,10,San Juan del Río,10028,7118,7231,14349
2027,Durango,10,San Luis del Cordero,10029,1233,1199,2432
2027,Durango,10,San Pedro del Gallo,10030,935,853,1788
2027,Durango,10,Santa Clara,10031,4024,4013,8037
2027,Durango,10,Santiago Papasquiaro,10032,27004,27032,54036
2027,Durango,10,Súchil,10033,3412,3700,7112
2027,Durango,10,Tamazula,10034,14527,13253,27780
2027,Durango,10,Tepehuanes,10035,6128,6185,12313
2027,Durango,10,Tlahualilo,10036,13625,13397,27022
2027,Durango,10,Topia,10037,5413,5029,10442
2027,Durango,10,Vicente Guerrero,10038,11892,12604,24496
2027,Estado de México,15,Acambay de Ruíz Castañeda,15001,35951,37965,73916
2027,Estado de México,15,Acolman,15002,100205,100047,200252
2027,Estado de México,15,Aculco,15003,27474,27949,55423
2027,Estado de México,15,Almoloya de Alquisiras,15004,7920,8536,16456
2027,Estado de México,15,Almoloya de Juárez,15005,98669,100586,199255
2027,Estado de México,15,Almoloya del Río,15006,6274,6708,12982
2027,Estado de México,15,Amanalco,15007,13386,13845,27231
2027,Estado de México,15,Amatepec,15008,15058,15789,30847
2027,Estado de México,15,Amecameca,15009,27992,29919,57911
2027,Estado de México,15,Apaxco,15010,16554,16926,33480
2027,Estado de México,15,Atenco,15011,36804,37652,74456
2027,Estado de México,15,Atizapán,15012,6410,6761,13171
2027,Estado de México,15,Atizapán de Zaragoza,15013,286043,303618,589661
2027,Estado de México,15,Atlacomulco,15014,54250,58977,113227
2027,Estado de México,15,Atlautla,15015,17146,17786,34932
2027,Estado de México,15,Axapusco,15016,16051,16143,32194
2027,Estado de México,15,Ayapango,15017,5842,6059,11901
2027,Estado de México,15,Calimaya,15018,31511,32920,64431
2027,Estado de México,15,Capulhuac,15019,19571,20760,40331
2027,Estado de México,15,Chalco,15025,212977,220692,433669
2027,Estado de México,15,Chapa de Mota,15026,15739,16371,32110
2027,Estado de México,15,Chapultepec,15027,6898,7066,13964
2027,Estado de México,15,Chiautla,15028,16760,17330,34090
2027,Estado de México,15,Chicoloapan,15029,116533,123674,240207
2027,Estado de México,15,Chiconcuac,15030,14548,14915,29463
2027,Estado de México,15,Chimalhuacán,15031,367250,379221,746471
2027,Estado de México,15,Coacalco de Berriozábal,15020,156813,169621,326434
2027,Estado de México,15,Coatepec Harinas,15021,21348,22781,44129
2027,Estado de México,15,Cocotitlán,15022,8054,8436,16490
2027,Estado de México,15,Coyotepec,15023,22795,23222,46017
2027,Estado de México,15,Cuautitlán,15024,91770,93772,185542
2027,Estado de México,15,Cuautitlán Izcalli,15121,298160,313979,612139
2027,Estado de México,15,Donato Guerra,15032,18502,19122,37624
2027,Estado de México,15,Ecatepec de Morelos,15033,891957,916088,1808045
2027,Estado de México,15,Ecatzingo,15034,5212,5350,10562
2027,Estado de México,15,El Oro,15064,20338,21729,42067
2027,Estado de México,15,Huehuetoca,15035,77849,79663,157512
2027,Estado de México,15,Hueypoxtla,15036,25157,24565,49722
2027,Estado de México,15,Huixquilucan,15037,149358,160067,309425
2027,Estado de México,15,Isidro Fabela,15038,6582,6655,13237
2027,Estado de México,15,Ixtapaluca,15039,281970,291716,573686
2027,Estado de México,15,Ixtapan de la Sal,15040,19666,21060,40726
2027,Estado de México,15,Ixtapan del Oro,15041,3933,3826,7759
2027,Estado de México,15,Ixtlahuaca,15042,83326,89244,172570
2027,Estado de México,15,Jaltenco,15044,14855,15778,30633
2027,Estado de México,15,Jilotepec,15045,49753,51209,100962
2027,Estado de México,15,Jilotzingo,15046,10655,11226,21881
2027,Estado de México,15,Jiquipilco,15047,40708,43235,83943
2027,Estado de México,15,Jocotitlán,15048,36205,38662,74867
2027,Estado de México,15,Joquicingo,15049,7651,7920,15571
2027,Estado de México,15,Juchitepec,15050,14236,14616,28852
2027,Estado de México,15,La Paz,15070,161198,164912,326110
2027,Estado de México,15,Lerma,15051,84055,86230,170285
2027,Estado de México,15,Luvianos,15123,15753,15951,31704
2027,Estado de México,15,Malinalco,15052,15585,15940,31525
2027,Estado de México,15,Melchor Ocampo,15053,32057,33339,65396
2027,Estado de México,15,Metepec,15054,126955,135078,262033
2027,Estado de México,15,Mexicaltzingo,15055,7093,7543,14636
2027,Estado de México,15,Morelos,15056,16303,17637,33940
2027,Estado de México,15,Naucalpan de Juárez,15057,476859,506192,983051
2027,Estado de México,15,Nextlalpan,15059,22952,23399,46351
2027,Estado de México,15,Nezahualcóyotl,15058,592904,639302,1232206
2027,Estado de México,15,Nicolás Romero,15060,229504,238794,468298
2027,Estado de México,15,Nopaltepec,15061,5153,5166,10319
2027,Estado de México,15,Ocoyoacac,15062,37536,38767,76303
2027,Estado de México,15,Ocuilan,15063,19047,19690,38737
2027,Estado de México,15,Otumba,15065,20431,20111,40542
2027,Estado de México,15,Otzoloapan,15066,2219,2156,4375
2027,Estado de México,15,Otzolotepec,15067,47092,48192,95284
2027,Estado de México,15,Ozumba,15068,15967,17177,33144
2027,Estado de México,15,Papalotla,15069,2239,2356,4595
2027,Estado de México,15,Polotitlán,15071,7960,8251,16211
2027,Estado de México,15,Rayón,15072,7668,7881,15549
2027,Estado de México,15,San Antonio la Isla,15073,16856,17196,34052
2027,Estado de México,15,San Felipe del Progreso,15074,68824,76875,145699
2027,Estado de México,15,San José del Rincón,15124,50180,51246,101426
2027,Estado de México,15,San Martín de las Pirámides,15075,15367,15668,31035
2027,Estado de México,15,San Mateo Atenco,15076,41650,43012,84662
2027,Estado de México,15,San Simón de Guerrero,15077,3359,3551,6910
2027,Estado de México,15,Santo Tomás,15078,5394,5508,10902
2027,Estado de México,15,Soyaniquilpan de Juárez,15079,7647,7751,15398
2027,Estado de México,15,Sultepec,15080,14295,15774,30069
2027,Estado de México,15,Tecámac,15081,262438,274428,536866
2027,Estado de México,15,Tejupilco,15082,40806,43857,84663
2027,Estado de México,15,Temamatla,15083,7034,7384,14418
2027,Estado de México,15,Temascalapa,15084,22053,22012,44065
2027,Estado de México,15,Temascalcingo,15085,34317,37132,71449
2027,Estado de México,15,Temascaltepec,15086,17830,18465,36295
2027,Estado de México,15,Temoaya,15087,55871,59001,114872
2027,Estado de México,15,Tenancingo,15088,54464,57395,111859
2027,Estado de México,15,Tenango del Aire,15089,7086,7241,14327
2027,Estado de México,15,Tenango del Valle,15090,47765,49602,97367
2027,Estado de México,15,Teoloyucan,15091,35207,35961,71168
2027,Estado de México,15,Teotihuacán,15092,31773,32747,64520
2027,Estado de México,15,Tepetlaoxtoc,15093,17489,17719,35208
2027,Estado de México,15,Tepetlixpa,15094,11136,11396,22532
2027,Estado de México,15,Tepotzotlán,15095,54585,56426,111011
2027,Estado de México,15,Tequixquiac,15096,20991,21141,42132
2027,Estado de México,15,Texcaltitlán,15097,10359,10940,21299
2027,Estado de México,15,Texcalyacac,15098,2984,3068,6052
2027,Estado de México,15,Texcoco,15099,134734,143184,277918
2027,Estado de México,15,Tezoyuca,15100,24820,25009,49829
2027,Estado de México,15,Tianguistenco,15101,42427,44682,87109
2027,Estado de México,15,Timilpan,15102,8641,9336,17977
2027,Estado de México,15,Tlalmanalco,15103,26450,28417,54867
2027,Estado de México,15,Tlalnepantla de Baz,15104,400104,428323,828427
2027,Estado de México,15,Tlatlaya,15105,20151,20856,41007
2027,Estado de México,15,Toluca,15106,485578,520449,1006027
2027,Estado de México,15,Tonanitla,15125,5478,5609,11087
2027,Estado de México,15,Tonatico,15107,7141,7609,14750
2027,Estado de México,15,Tultepec,15108,83058,85999,169057
2027,Estado de México,15,Tultitlán,15109,285429,296318,581747
2027,Estado de México,15,Valle de Bravo,15110,36156,37494,73650
2027,Estado de México,15,Valle de Chalco Solidaridad,15122,217374,224334,441708
2027,Estado de México,15,Villa Guerrero,15113,37480,38424,75904
2027,Estado de México,15,Villa Victoria,15114,57732,58435,116167
2027,Estado de México,15,Villa de Allende,15111,28077,29287,57364
2027,Estado de México,15,Villa del Carbón,15112,26795,26471,53266
2027,Estado de México,15,Xalatlaco,15043,16642,17501,34143
2027,Estado de México,15,Xonacatlán,15115,28797,28510,57307
2027,Estado de México,15,Zacazonapan,15116,2287,2245,4532
2027,Estado de México,15,Zacualpan,15117,8261,9063,17324
2027,Estado de México,15,Zinacantepec,15118,105582,108199,213781
2027,Estado de México,15,Zumpahuacán,15119,8995,9788,18783
2027,Estado de México,15,Zumpango,15120,112216,119615,231831
2027,Guanajuato,11,Abasolo,11001,49060,51807,100867
2027,Guanajuato,11,Acámbaro,11002,61532,66381,127913
2027,Guanajuato,11,Apaseo el Alto,11004,36999,38696,75695
2027,Guanajuato,11,Apaseo el Grande,11005,50689,53687,104376
2027,Guanajuato,11,Atarjea,11006,2909,3002,5911
2027,Guanajuato,11,Celaya,11007,270991,287032,558023
2027,Guanajuato,11,Comonfort,11009,43240,47881,91121
2027,Guanajuato,11,Coroneo,11010,6519,7280,13799
2027,Guanajuato,11,Cortazar,11011,52082,55132,107214
2027,Guanajuato,11,Cuerámaro,11012,15313,16458,31771
2027,Guanajuato,11,Doctor Mora,11013,12823,13797,26620
2027,Guanajuato,11,Dolores Hidalgo Cuna de la Independencia Nacional,11014,78864,87907,166771
2027,Guanajuato,11,Guanajuato,11015,102084,106628,208712
2027,Guanajuato,11,Huanímaro,11016,11457,12601,24058
2027,Guanajuato,11,Irapuato,11017,313362,329601,642963
2027,Guanajuato,11,Jaral del Progreso,11018,21696,22214,43910
2027,Guanajuato,11,Jerécuaro,11019,25337,28832,54169
2027,Guanajuato,11,León,11020,870934,886745,1757679
2027,Guanajuato,11,Manuel Doblado,11008,20782,22416,43198
2027,Guanajuato,11,Moroleón,11021,27933,30636,58569
2027,Guanajuato,11,Ocampo,11022,12617,13393,26010
2027,Guanajuato,11,Pueblo Nuevo,11024,6470,7114,13584
2027,Guanajuato,11,Purísima del Rincón,11025,45212,44937,90149
2027,Guanajuato,11,Pénjamo,11023,80965,88137,169102
2027,Guanajuato,11,Romita,11026,32104,33555,65659
2027,Guanajuato,11,Salamanca,11027,151717,159782,311499
2027,Guanajuato,11,Salvatierra,11028,54880,60198,115078
2027,Guanajuato,11,San Diego de la Unión,11029,20365,23330,43695
2027,Guanajuato,11,San Felipe,11030,60388,63761,124149
2027,Guanajuato,11,San Francisco del Rincón,11031,64068,67245,131313
2027,Guanajuato,11,San José Iturbide,11032,42520,44921,87441
2027,Guanajuato,11,San Luis de la Paz,11033,63256,69487,132743
2027,Guanajuato,11,San Miguel de Allende,11003,92813,99967,192780
2027,Guanajuato,11,Santa Catarina,11034,2806,3091,5897
2027,Guanajuato,11,Santa Cruz de Juventino Rosas,11035,44946,47941,92887
2027,Guanajuato,11,Santiago Maravatío,11036,3870,4245,8115
2027,Guanajuato,11,Silao de la Victoria,11037,104257,106675,210932
2027,Guanajuato,11,Tarandacuao,11038,6703,7369,14072
2027,Guanajuato,11,Tarimoro,11039,19091,19962,39053
2027,Guanajuato,11,Tierra Blanca,11040,10207,10969,21176
2027,Guanajuato,11,Uriangato,11041,34574,36846,71420
2027,Guanajuato,11,Valle de Santiago,11042,77879,85389,163268
2027,Guanajuato,11,Victoria,11043,10724,11990,22714
2027,Guanajuato,11,Villagrán,11044,32292,33644,65936
2027,Guanajuato,11,Xichú,11045,6236,6827,13063
2027,Guanajuato,11,Yuriria,11046,37924,41475,79399
2027,Guerrero,12,Acapulco de Juárez,12001,412255,446399,858654
2027,Guerrero,12,Acatepec,12076,18406,19379,37785
2027,Guerrero,12,Ahuacuotzingo,12002,12941,14668,27609
2027,Guerrero,12,Ajuchitlán del Progreso,12003,19058,20223,39281
2027,Guerrero,12,Alcozauca de Guerrero,12004,9509,10815,20324
2027,Guerrero,12,Alpoyeca,12005,3348,3729,7077
2027,Guerrero,12,Apaxtla,12006,5779,6247,12026
2027,Guerrero,12,Arcelia,12007,16090,17095,33185
2027,Guerrero,12,Atenango del Río,12008,4417,4768,9185
2027,Guerrero,12,Atlamajalcingo del Monte,12009,2468,2746,5214
2027,Guerrero,12,Atlixtac,12010,13565,14470,28035
2027,Guerrero,12,Atoyac de Álvarez,12011,31416,32588,64004
2027,Guerrero,12,Ayutla de los Libres,12012,34399,35845,70244
2027,Guerrero,12,Azoyú,12013,6647,7018,13665
2027,Guerrero,12,Benito Juárez,12014,8107,8536,16643
2027,Guerrero,12,Buenavista de Cuéllar,12015,6886,7250,14136
2027,Guerrero,12,Chilapa de Álvarez,12028,63811,71025,134836
2027,Guerrero,12,Chilpancingo de los Bravo,12029,138370,150786,289156
2027,Guerrero,12,Coahuayutla de José María Izazaga,12016,6517,6182,12699
2027,Guerrero,12,Cochoapa el Grande,12078,8844,9782,18626
2027,Guerrero,12,Cocula,12017,7012,7484,14496
2027,Guerrero,12,Copala,12018,7382,7636,15018
2027,Guerrero,12,Copalillo,12019,7236,7918,15154
2027,Guerrero,12,Copanatoyac,12020,9916,10923,20839
2027,Guerrero,12,Coyuca de Benítez,12021,39510,41002,80512
2027,Guerrero,12,Coyuca de Catalán,12022,20729,20277,41006
2027,Guerrero,12,Cuajinicuilapa,12023,14308,14198,28506
2027,Guerrero,12,Cualác,12024,3844,4079,7923
2027,Guerrero,12,Cuautepec,12025,8356,8385,16741
2027,Guerrero,12,Cuetzala del Progreso,12026,4506,4738,9244
2027,Guerrero,12,Cutzamala de Pinzón,12027,10450,10825,21275
2027,Guerrero,12,Eduardo Neri,12075,26485,27614,54099
2027,Guerrero,12,Florencio Villarreal,12030,10781,11024,21805
2027,Guerrero,12,General Canuto A. Neri,12031,2968,3213,6181
2027,Guerrero,12,General Heliodoro Castillo,12032,18848,18814,37662
2027,Guerrero,12,Huamuxtitlán,12033,7606,8541,16147
2027,Guerrero,12,Huitzuco de los Figueroa,12034,19231,20758,39989
2027,Guerrero,12,Iguala de la Independencia,12035,77928,83946,161874
2027,Guerrero,12,Igualapa,12036,5724,5897,11621
2027,Guerrero,12,Iliatenco,12081,5384,5975,11359
2027,Guerrero,12,Ixcateopan de Cuauhtémoc,12037,3173,3523,6696
2027,Guerrero,12,José Joaquín de Herrera,12079,8879,9071,17950
2027,Guerrero,12,Juan R. Escudero,12039,12807,13436,26243
2027,Guerrero,12,Juchitán,12080,4051,3982,8033
2027,Guerrero,12,La Unión de Isidoro Montes de Oca,12068,14103,13441,27544
2027,Guerrero,12,Leonardo Bravo,12040,13434,13688,27122
2027,Guerrero,12,Malinaltepec,12041,13135,14832,27967
2027,Guerrero,12,Marquelia,12077,7177,7274,14451
2027,Guerrero,12,Metlatónoc,12043,8721,10048,18769
2027,Guerrero,12,Mochitlán,12044,6672,6955,13627
2027,Guerrero,12,Mártir de Cuilapan,12042,9403,10301,19704
2027,Guerrero,12,Olinalá,12045,12845,13784,26629
2027,Guerrero,12,Ometepec,12046,34373,36136,70509
2027,Guerrero,12,Pedro Ascencio Alquisiras,12047,3327,3856,7183
2027,Guerrero,12,Petatlán,12048,22759,23230,45989
2027,Guerrero,12,Pilcaya,12049,6642,7024,13666
2027,Guerrero,12,Pungarabato,12050,18839,20107,38946
2027,Guerrero,12,Quechultenango,12051,18273,19045,37318
2027,Guerrero,12,San Luis Acatlán,12052,22081,22698,44779
2027,Guerrero,12,San Marcos,12053,25581,26364,51945
2027,Guerrero,12,San Miguel Totolapan,12054,13871,14442,28313
2027,Guerrero,12,Taxco de Alarcón,12055,55032,60205,115237
2027,Guerrero,12,Tecoanapa,12056,23678,24358,48036
2027,Guerrero,12,Teloloapan,12058,28765,32321,61086
2027,Guerrero,12,Tepecoacuilco de Trujano,12059,16559,17966,34525
2027,Guerrero,12,Tetipac,12060,7466,7855,15321
2027,Guerrero,12,Tixtla de Guerrero,12061,21791,23643,45434
2027,Guerrero,12,Tlacoachistlahuaca,12062,11471,12929,24400
2027,Guerrero,12,Tlacoapa,12063,5033,5605,10638
2027,Guerrero,12,Tlalchapa,12064,6737,6744,13481
2027,Guerrero,12,Tlalixtaquilla de Maldonado,12065,3767,4060,7827
2027,Guerrero,12,Tlapa de Comonfort,12066,44768,49799,94567
2027,Guerrero,12,Tlapehuala,12067,11152,11977,23129
2027,Guerrero,12,Técpan de Galeana,12057,34348,34883,69231
2027,Guerrero,12,Xalpatláhuac,12069,5661,6627,12288
2027,Guerrero,12,Xochihuehuetlán,12070,3575,4042,7617
2027,Guerrero,12,Xochistlahuaca,12071,14691,15590,30281
2027,Guerrero,12,Zapotitlán Tablas,12072,6515,7170,13685
2027,Guerrero,12,Zihuatanejo de Azueta,12038,65168,66939,132107
2027,Guerrero,12,Zirándaro,12073,9408,9008,18416
2027,Guerrero,12,Zitlala,12074,11418,12787,24205
2027,Hidalgo,13,Acatlán,13001,11380,12164,23544
2027,Hidalgo,13,Acaxochitlán,13002,23500,25523,49023
2027,Hidalgo,13,Actopan,13003,31208,34637,65845
2027,Hidalgo,13,Agua Blanca de Iturbide,13004,4920,5462,10382
2027,Hidalgo,13,Ajacuba,13005,10535,10940,21475
2027,Hidalgo,13,Alfajayucan,13006,11767,12403,24170
2027,Hidalgo,13,Almoloya,13007,6999,7077,14076
2027,Hidalgo,13,Apan,13008,24744,26883,51627
2027,Hidalgo,13,Atitalaquia,13010,17105,17481,34586
2027,Hidalgo,13,Atlapexco,13011,11184,12146,23330
2027,Hidalgo,13,Atotonilco de Tula,13013,21518,22673,44191
2027,Hidalgo,13,Atotonilco el Grande,13012,15101,16766,31867
2027,Hidalgo,13,Calnali,13014,9765,10597,20362
2027,Hidalgo,13,Cardonal,13015,10389,11226,21615
2027,Hidalgo,13,Chapantongo,13017,7829,8230,16059
2027,Hidalgo,13,Chapulhuacán,13018,13766,13568,27334
2027,Hidalgo,13,Chilcuautla,13019,10420,10702,21122
2027,Hidalgo,13,Cuautepec de Hinojosa,13016,31893,34906,66799
2027,Hidalgo,13,El Arenal,13009,10386,11274,21660
2027,Hidalgo,13,Eloxochitlán,13020,1558,1768,3326
2027,Hidalgo,13,Emiliano Zapata,13021,8105,9003,17108
2027,Hidalgo,13,Epazoyucan,13022,8435,8931,17366
2027,Hidalgo,13,Francisco I. Madero,13023,20111,21863,41974
2027,Hidalgo,13,Huasca de Ocampo,13024,9799,10674,20473
2027,Hidalgo,13,Huautla,13025,12008,13276,25284
2027,Hidalgo,13,Huazalingo,13026,7806,8287,16093
2027,Hidalgo,13,Huehuetla,13027,14225,15166,29391
2027,Hidalgo,13,Huejutla de Reyes,13028,72705,75680,148385
2027,Hidalgo,13,Huichapan,13029,25759,27865,53624
2027,Hidalgo,13,Ixmiquilpan,13030,50579,56623,107202
2027,Hidalgo,13,Jacala de Ledezma,13031,7529,8362,15891
2027,Hidalgo,13,Jaltocán,13032,6800,7013,13813
2027,Hidalgo,13,Juárez Hidalgo,13033,1790,1961,3751
2027,Hidalgo,13,La Misión,13040,5857,5999,11856
2027,Hidalgo,13,Lolotla,13034,5332,5632,10964
2027,Hidalgo,13,Metepec,13035,6267,7081,13348
2027,Hidalgo,13,Metztitlán,13037,11464,12669,24133
2027,Hidalgo,13,Mineral de la Reforma,13051,96185,105887,202072
2027,Hidalgo,13,Mineral del Chico,13038,5115,5415,10530
2027,Hidalgo,13,Mineral del Monte,13039,8155,8946,17101
2027,Hidalgo,13,Mixquiahuala de Juárez,13041,25968,27854,53822
2027,Hidalgo,13,Molango de Escamilla,13042,6643,6945,13588
2027,Hidalgo,13,Nicolás Flores,13043,3803,4266,8069
2027,Hidalgo,13,Nopala de Villagrán,13044,9694,10014,19708
2027,Hidalgo,13,Omitlán de Juárez,13045,5466,5917,11383
2027,Hidalgo,13,Pachuca de Soto,13048,141038,156112,297150
2027,Hidalgo,13,Pacula,13047,2722,3112,5834
2027,Hidalgo,13,Pisaflores,13049,9960,9905,19865
2027,Hidalgo,13,Progreso de Obregón,13050,12977,14441,27418
2027,Hidalgo,13,San Agustín Metzquititlán,13036,5401,5868,11269
2027,Hidalgo,13,San Agustín Tlaxiaca,13052,20702,21623,42325
2027,Hidalgo,13,San Bartolo Tutotepec,13053,10612,10940,21552
2027,Hidalgo,13,San Felipe Orizatlán,13046,21750,22686,44436
2027,Hidalgo,13,San Salvador,13054,19795,21202,40997
2027,Hidalgo,13,Santiago Tulantepec de Lugo Guerrero,13056,20438,22340,42778
2027,Hidalgo,13,Santiago de Anaya,13055,9727,10154,19881
2027,Hidalgo,13,Singuilucan,13057,9286,9481,18767
2027,Hidalgo,13,Tasquillo,13058,8721,10173,18894
2027,Hidalgo,13,Tecozautla,13059,21019,22561,43580
2027,Hidalgo,13,Tenango de Doria,13060,10006,11056,21062
2027,Hidalgo,13,Tepeapulco,13061,30783,32757,63540
2027,Hidalgo,13,Tepehuacán de Guerrero,13062,17644,17139,34783
2027,Hidalgo,13,Tepeji del Río de Ocampo,13063,49299,50596,99895
2027,Hidalgo,13,Tepetitlán,13064,6259,6599,12858
2027,Hidalgo,13,Tetepango,13065,6674,6698,13372
2027,Hidalgo,13,Tezontepec de Aldama,13067,30195,30846,61041
2027,Hidalgo,13,Tianguistengo,13068,8482,8876,17358
2027,Hidalgo,13,Tizayuca,13069,73402,75388,148790
2027,Hidalgo,13,Tlahuelilpan,13070,10928,11304,22232
2027,Hidalgo,13,Tlahuiltepa,13071,5995,5988,11983
2027,Hidalgo,13,Tlanalapa,13072,5847,6228,12075
2027,Hidalgo,13,Tlanchinol,13073,22293,22650,44943
2027,Hidalgo,13,Tlaxcoapan,13074,16179,16558,32737
2027,Hidalgo,13,Tolcayuca,13075,9251,9803,19054
2027,Hidalgo,13,Tula de Allende,13076,61951,65712,127663
2027,Hidalgo,13,Tulancingo de Bravo,13077,85929,95533,181462
2027,Hidalgo,13,Villa de Tezontepec,13066,6997,7320,14317
2027,Hidalgo,13,Xochiatipan,13078,10907,11674,22581
2027,Hidalgo,13,Xochicoatlán,13079,4503,4656,9159
2027,Hidalgo,13,Yahualica,13080,13605,14285,27890
2027,Hidalgo,13,Zacualtipán de Ángeles,13081,19293,21069,40362
2027,Hidalgo,13,Zapotlán de Juárez,13082,10448,11316,21764
2027,Hidalgo,13,Zempoala,13083,26857,28440,55297
2027,Hidalgo,13,Zimapán,13084,21304,24596,45900
2027,Jalisco,14,Acatic,14001,11953,12424,24377
2027,Jalisco,14,Acatlán de Juárez,14002,12696,12394,25090
2027,Jalisco,14,Ahualulco de Mercado,14003,12991,13374,26365
2027,Jalisco,14,Amacueca,14004,3059,3190,6249
2027,Jalisco,14,Amatitán,14005,8629,8688,17317
2027,Jalisco,14,Ameca,14006,34422,35706,70128
2027,Jalisco,14,Arandas,14008,40269,43375,83644
2027,Jalisco,14,Atemajac de Brizuela,14010,3715,3754,7469
2027,Jalisco,14,Atengo,14011,3340,3104,6444
2027,Jalisco,14,Atenguillo,14012,2268,2358,4626
2027,Jalisco,14,Atotonilco el Alto,14013,33919,34943,68862
2027,Jalisco,14,Atoyac,14014,4524,4854,9378
2027,Jalisco,14,Autlán de Navarro,14015,34451,35603,70054
2027,Jalisco,14,Ayotlán,14016,21031,21859,42890
2027,Jalisco,14,Ayutla,14017,7244,7182,14426
2027,Jalisco,14,Bolaños,14019,4384,4373,8757
2027,Jalisco,14,Cabo Corrientes,14020,6199,5680,11879
2027,Jalisco,14,Casimiro Castillo,14021,12583,12506,25089
2027,Jalisco,14,Cañadas de Obregón,14117,2398,2502,4900
2027,Jalisco,14,Chapala,14030,28688,30167,58855
2027,Jalisco,14,Chimaltitán,14031,1848,1889,3737
2027,Jalisco,14,Chiquilistlán,14032,3479,3410,6889
2027,Jalisco,14,Cihuatlán,14022,23815,23161,46976
2027,Jalisco,14,Cocula,14024,14996,15675,30671
2027,Jalisco,14,Colotlán,14025,9952,10636,20588
2027,Jalisco,14,Concepción de Buenos Aires,14026,3616,3473,7089
2027,Jalisco,14,Cuautitlán de García Barragán,14027,10229,9940,20169
2027,Jalisco,14,Cuautla,14028,1234,1318,2552
2027,Jalisco,14,Cuquío,14029,10050,10854,20904
2027,Jalisco,14,Degollado,14033,11908,12564,24472
2027,Jalisco,14,Ejutla,14034,1170,1084,2254
2027,Jalisco,14,El Arenal,14009,11127,11169,22296
2027,Jalisco,14,El Grullo,14037,13690,14500,28190
2027,Jalisco,14,El Limón,14054,3263,3263,6526
2027,Jalisco,14,El Salto,14070,105188,105680,210868
2027,Jalisco,14,Encarnación de Díaz,14035,29434,31431,60865
2027,Jalisco,14,Etzatlán,14036,11066,11604,22670
2027,Jalisco,14,Guachinango,14038,2540,2436,4976
2027,Jalisco,14,Guadalajara,14039,779935,831177,1611112
2027,Jalisco,14,Gómez Farías,14079,7898,8425,16323
2027,Jalisco,14,Hostotipaquillo,14040,6307,5456,11763
2027,Jalisco,14,Huejuquilla el Alto,14042,4924,5310,10234
2027,Jalisco,14,Huejúcar,14041,3281,3587,6868
2027,Jalisco,14,Ixtlahuacán de los Membrillos,14044,32058,32515,64573
2027,Jalisco,14,Ixtlahuacán del Río,14045,10614,11214,21828
2027,Jalisco,14,Jalostotitlán,14046,18929,19353,38282
2027,Jalisco,14,Jamay,14047,14143,14087,28230
2027,Jalisco,14,Jesús María,14048,10057,11844,21901
2027,Jalisco,14,Jilotlán de los Dolores,14049,5512,5225,10737
2027,Jalisco,14,Jocotepec,14050,26108,26407,52515
2027,Jalisco,14,Juanacatlán,14051,10318,10243,20561
2027,Jalisco,14,Juchitlán,14052,3189,3351,6540
2027,Jalisco,14,La Barca,14018,36066,38206,74272
2027,Jalisco,14,La Huerta,14043,14331,13697,28028
2027,Jalisco,14,La Manzanilla de la Paz,14057,2108,2244,4352
2027,Jalisco,14,Lagos de Moreno,14053,90812,94416,185228
2027,Jalisco,14,Magdalena,14055,12805,12770,25575
2027,Jalisco,14,Mascota,14058,8372,8619,16991
2027,Jalisco,14,Mazamitla,14059,7680,8303,15983
2027,Jalisco,14,Mexticacán,14060,2680,3137,5817
2027,Jalisco,14,Mezquitic,14061,10593,11237,21830
2027,Jalisco,14,Mixtlán,14062,2061,2028,4089
2027,Jalisco,14,Ocotlán,14063,55140,57057,112197
2027,Jalisco,14,Ojuelos de Jalisco,14064,17463,18317,35780
2027,Jalisco,14,Pihuamo,14065,6608,6509,13117
2027,Jalisco,14,Poncitlán,14066,28564,29254,57818
2027,Jalisco,14,Puerto Vallarta,14067,159238,155388,314626
2027,Jalisco,14,Quitupan,14069,4584,5072,9656
2027,Jalisco,14,San Cristóbal de la Barranca,14071,1707,1694,3401
2027,Jalisco,14,San Diego de Alejandría,14072,3975,4240,8215
2027,Jalisco,14,San Gabriel,14113,9259,9574,18833
2027,Jalisco,14,San Ignacio Cerro Gordo,14125,10350,10962,21312
2027,Jalisco,14,San Juan de los Lagos,14073,38981,39398,78379
2027,Jalisco,14,San Juanito de Escobedo,14007,5405,5303,10708
2027,Jalisco,14,San Julián,14074,8674,9528,18202
2027,Jalisco,14,San Marcos,14075,2190,2137,4327
2027,Jalisco,14,San Martín Hidalgo,14077,15704,16374,32078
2027,Jalisco,14,San Martín de Bolaños,14076,1715,1721,3436
2027,Jalisco,14,San Miguel el Alto,14078,18226,19150,37376
2027,Jalisco,14,San Pedro Tlaquepaque,14098,369922,373311,743233
2027,Jalisco,14,San Sebastián del Oeste,14080,3417,3056,6473
2027,Jalisco,14,Santa María de los Ángeles,14081,1771,1942,3713
2027,Jalisco,14,Santa María del Oro,14056,1180,1169,2349
2027,Jalisco,14,Sayula,14082,20111,21593,41704
2027,Jalisco,14,Tala,14083,45644,46092,91736
2027,Jalisco,14,Talpa de Allende,14084,8669,8518,17187
2027,Jalisco,14,Tamazula de Gordiano,14085,21789,22826,44615
2027,Jalisco,14,Tapalpa,14086,10623,11027,21650
2027,Jalisco,14,Tecalitlán,14087,9315,9716,19031
2027,Jalisco,14,Techaluta de Montenegro,14089,2146,2198,4344
2027,Jalisco,14,Tecolotlán,14088,9993,9984,19977
2027,Jalisco,14,Tenamaxtlán,14090,4017,4030,8047
2027,Jalisco,14,Teocaltiche,14091,22630,24643,47273
2027,Jalisco,14,Teocuitatlán de Corona,14092,5999,6198,12197
2027,Jalisco,14,Tepatitlán de Morelos,14093,77995,80753,158748
2027,Jalisco,14,Tequila,14094,23265,23582,46847
2027,Jalisco,14,Teuchitlán,14095,5523,5683,11206
2027,Jalisco,14,Tizapán el Alto,14096,11825,12341,24166
2027,Jalisco,14,Tlajomulco de Zúñiga,14097,343031,347637,690668
2027,Jalisco,14,Tolimán,14099,5863,5900,11763
2027,Jalisco,14,Tomatlán,14100,20712,19527,40239
2027,Jalisco,14,Tonalá,14101,299997,301091,601088
2027,Jalisco,14,Tonaya,14102,3444,3581,7025
2027,Jalisco,14,Tonila,14103,4558,4573,9131
2027,Jalisco,14,Totatiche,14104,2612,2647,5259
2027,Jalisco,14,Tototlán,14105,13072,13332,26404
2027,Jalisco,14,Tuxcacuesco,14106,2586,2458,5044
2027,Jalisco,14,Tuxcueca,14107,3449,3665,7114
2027,Jalisco,14,Tuxpan,14108,19381,20566,39947
2027,Jalisco,14,Unión de San Antonio,14109,9949,10591,20540
2027,Jalisco,14,Unión de Tula,14110,7566,8026,15592
2027,Jalisco,14,Valle de Guadalupe,14111,3988,4015,8003
2027,Jalisco,14,Valle de Juárez,14112,3099,3270,6369
2027,Jalisco,14,Villa Corona,14114,10208,10447,20655
2027,Jalisco,14,Villa Guerrero,14115,3142,3247,6389
2027,Jalisco,14,Villa Hidalgo,14116,11184,11914,23098
2027,Jalisco,14,Villa Purificación,14068,6525,6031,12556
2027,Jalisco,14,Yahualica de González Gallo,14118,12221,13399,25620
2027,Jalisco,14,Zacoalco de Torres,14119,16217,16442,32659
2027,Jalisco,14,Zapopan,14120,741728,768442,1510170
2027,Jalisco,14,Zapotiltic,14121,16481,17084,33565
2027,Jalisco,14,Zapotitlán de Vadillo,14122,4042,3999,8041
2027,Jalisco,14,Zapotlanejo,14124,37778,38575,76353
2027,Jalisco,14,Zapotlán del Rey,14123,10293,10289,20582
2027,Jalisco,14,Zapotlán el Grande,14023,58898,62107,121005
2027,Michoacán,16,Acuitzio,16001,6055,6511,12566
2027,Michoacán,16,Aguililla,16002,7927,7729,15656
2027,Michoacán,16,Angamacutiro,16004,8122,8825,16947
2027,Michoacán,16,Angangueo,16005,5964,6327,12291
2027,Michoacán,16,Apatzingán,16006,68640,69522,138162
2027,Michoacán,16,Aporo,16007,1729,1843,3572
2027,Michoacán,16,Aquila,16008,13759,13388,27147
2027,Michoacán,16,Ario,16009,19662,20707,40369
2027,Michoacán,16,Arteaga,16010,11822,11922,23744
2027,Michoacán,16,Briseñas,16011,6143,6441,12584
2027,Michoacán,16,Buenavista,16012,26547,25139,51686
2027,Michoacán,16,Carácuaro,16013,5042,4987,10029
2027,Michoacán,16,Charapan,16021,6405,7193,13598
2027,Michoacán,16,Charo,16022,12343,11791,24134
2027,Michoacán,16,Chavinda,16023,5623,5891,11514
2027,Michoacán,16,Cherán,16024,10040,10787,20827
2027,Michoacán,16,Chilchota,16025,20662,22249,42911
2027,Michoacán,16,Chinicuila,16026,2725,2468,5193
2027,Michoacán,16,Chucándiro,16027,2255,2564,4819
2027,Michoacán,16,Churintzio,16028,2779,3125,5904
2027,Michoacán,16,Churumuco,16029,8343,8279,16622
2027,Michoacán,16,Coahuayana,16014,8297,7634,15931
2027,Michoacán,16,Coalcomán de Vázquez Pallares,16015,9453,9550,19003
2027,Michoacán,16,Coeneo,16016,10924,12517,23441
2027,Michoacán,16,Cojumatlán de Régules,16074,5659,5872,11531
2027,Michoacán,16,Contepec,16017,18152,18944,37096
2027,Michoacán,16,Copándaro,16018,4752,5206,9958
2027,Michoacán,16,Cotija,16019,9779,10702,20481
2027,Michoacán,16,Cuitzeo,16020,15695,17206,32901
2027,Michoacán,16,Ecuandureo,16030,6493,7563,14056
2027,Michoacán,16,Epitacio Huerta,16031,9000,9315,18315
2027,Michoacán,16,Erongarícuaro,16032,8159,8756,16915
2027,Michoacán,16,Gabriel Zamora,16033,12466,12475,24941
2027,Michoacán,16,Hidalgo,16034,65188,68312,133500
2027,Michoacán,16,Huandacareo,16036,6231,7113,13344
2027,Michoacán,16,Huaniqueo,16037,4296,4964,9260
2027,Michoacán,16,Huetamo,16038,21761,22821,44582
2027,Michoacán,16,Huiramba,16039,4730,4887,9617
2027,Michoacán,16,Indaparapeo,16040,8950,9326,18276
2027,Michoacán,16,Irimbo,16041,7929,8597,16526
2027,Michoacán,16,Ixtlán,16042,7060,7197,14257
2027,Michoacán,16,Jacona,16043,36451,38470,74921
2027,Michoacán,16,Jiménez,16044,6914,7457,14371
2027,Michoacán,16,Jiquilpan,16045,17436,19137,36573
2027,Michoacán,16,José Sixto Verduzco,16113,14029,15315,29344
2027,Michoacán,16,Jungapeo,16047,11512,11568,23080
2027,Michoacán,16,Juárez,16046,7824,8147,15971
2027,Michoacán,16,La Huacana,16035,18600,18703,37303
2027,Michoacán,16,La Piedad,16069,55346,60326,115672
2027,Michoacán,16,Lagunillas,16048,3046,3118,6164
2027,Michoacán,16,Los Reyes,16075,37507,39244,76751
2027,Michoacán,16,Lázaro Cárdenas,16052,99095,98162,197257
2027,Michoacán,16,Madero,16049,9878,9589,19467
2027,Michoacán,16,Maravatío,16050,46718,49962,96680
2027,Michoacán,16,Marcos Castellanos,16051,7406,7904,15310
2027,Michoacán,16,Morelia,16053,412772,446336,859108
2027,Michoacán,16,Morelos,16054,3849,4507,8356
2027,Michoacán,16,Múgica,16055,24578,25063,49641
2027,Michoacán,16,Nahuatzen,16056,15089,15924,31013
2027,Michoacán,16,Nocupétaro,16057,4422,4446,8868
2027,Michoacán,16,Nuevo Parangaricutiro,16058,10650,10952,21602
2027,Michoacán,16,Nuevo Urecho,16059,4455,4421,8876
2027,Michoacán,16,Numarán,16060,5162,5665,10827
2027,Michoacán,16,Ocampo,16061,12932,12942,25874
2027,Michoacán,16,Pajacuarán,16062,10264,10954,21218
2027,Michoacán,16,Panindícuaro,16063,8352,9291,17643
2027,Michoacán,16,Paracho,16065,19684,21428,41112
2027,Michoacán,16,Parácuaro,16064,14786,14302,29088
2027,Michoacán,16,Penjamillo,16067,8924,10151,19075
2027,Michoacán,16,Peribán,16068,15384,15141,30525
2027,Michoacán,16,Puruándiro,16071,34995,38584,73579
2027,Michoacán,16,Purépero,16070,8240,8602,16842
2027,Michoacán,16,Pátzcuaro,16066,48967,53079,102046
2027,Michoacán,16,Queréndaro,16072,7353,7629,14982
2027,Michoacán,16,Quiroga,16073,14614,15960,30574
2027,Michoacán,16,Sahuayo,16076,41574,43471,85045
2027,Michoacán,16,Salvador Escalante,16079,26162,27471,53633
2027,Michoacán,16,San Lucas,16077,9918,10053,19971
2027,Michoacán,16,Santa Ana Maya,16078,6539,7387,13926
2027,Michoacán,16,Senguio,16080,10108,10693,20801
2027,Michoacán,16,Susupuato,16081,4770,4744,9514
2027,Michoacán,16,Tacámbaro,16082,41547,43208,84755
2027,Michoacán,16,Tancítaro,16083,17136,16576,33712
2027,Michoacán,16,Tangamandapio,16084,15516,16504,32020
2027,Michoacán,16,Tangancícuaro,16085,18115,19174,37289
2027,Michoacán,16,Tanhuato,16086,8350,8712,17062
2027,Michoacán,16,Taretan,16087,8073,8197,16270
2027,Michoacán,16,Tarímbaro,16088,60817,65470,126287
2027,Michoacán,16,Tepalcatepec,16089,13260,12935,26195
2027,Michoacán,16,Tingambato,16090,8028,8464,16492
2027,Michoacán,16,Tingüindín,16091,7797,8402,16199
2027,Michoacán,16,Tiquicheo de Nicolás Romero,16092,7257,7358,14615
2027,Michoacán,16,Tlalpujahua,16093,14891,16519,31410
2027,Michoacán,16,Tlazazalca,16094,3537,3754,7291
2027,Michoacán,16,Tocumbo,16095,6680,6767,13447
2027,Michoacán,16,Tumbiscatío,16096,3605,3453,7058
2027,Michoacán,16,Turicato,16097,16497,17199,33696
2027,Michoacán,16,Tuxpan,16098,14216,15146,29362
2027,Michoacán,16,Tuzantla,16099,8279,8286,16565
2027,Michoacán,16,Tzintzuntzan,16100,7569,8312,15881
2027,Michoacán,16,Tzitzio,16101,4721,4568,9289
2027,Michoacán,16,Uruapan,16102,178515,190233,368748
2027,Michoacán,16,Venustiano Carranza,16103,13552,14101,27653
2027,Michoacán,16,Villamar,16104,8988,9576,18564
2027,Michoacán,16,Vista Hermosa,16105,11246,11668,22914
2027,Michoacán,16,Yurécuaro,16106,16912,17720,34632
2027,Michoacán,16,Zacapu,16107,40101,43266,83367
2027,Michoacán,16,Zamora,16108,105312,111393,216705
2027,Michoacán,16,Zinapécuaro,16110,24986,26889,51875
2027,Michoacán,16,Zináparo,16109,1704,1968,3672
2027,Michoacán,16,Ziracuaretiro,16111,9438,9569,19007
2027,Michoacán,16,Zitácuaro,16112,85070,93041,178111
2027,Michoacán,16,Álvaro Obregón,16003,11713,12372,24085
2027,Morelos,17,Amacuzac,17001,9888,10290,20178
2027,Morelos,17,Atlatlahucan,17002,12822,13172,25994
2027,Morelos,17,Axochiapan,17003,20261,20526,40787
2027,Morelos,17,Ayala,17004,47044,49920,96964
2027,Morelos,17,Coatlán del Río,17005,5664,5760,11424
2027,Morelos,17,Cuautla,17006,107749,115114,222863
2027,Morelos,17,Cuernavaca,17007,200879,227159,428038
2027,Morelos,17,Emiliano Zapata,17008,56022,57470,113492
2027,Morelos,17,Huitzilac,17009,10783,10821,21604
2027,Morelos,17,Jantetelco,17010,9663,9994,19657
2027,Morelos,17,Jiutepec,17011,116060,123093,239153
2027,Morelos,17,Jojutla,17012,31960,34073,66033
2027,Morelos,17,Jonacatepec,17013,8680,9264,17944
2027,Morelos,17,Mazatepec,17014,5625,5822,11447
2027,Morelos,17,Miacatlán,17015,14801,15366,30167
2027,Morelos,17,Ocuituco,17016,10425,10576,21001
2027,Morelos,17,Puente de Ixtla,17017,37035,38341,75376
2027,Morelos,17,Temixco,17018,64249,66648,130897
2027,Morelos,17,Temoac,17033,8868,9262,18130
2027,Morelos,17,Tepalcingo,17019,15269,15715,30984
2027,Morelos,17,Tepoztlán,17020,27333,28115,55448
2027,Morelos,17,Tetecala,17021,4489,4490,8979
2027,Morelos,17,Tetela del Volcán,17022,11441,11917,23358
2027,Morelos,17,Tlalnepantla,17023,4163,4030,8193
2027,Morelos,17,Tlaltizapán de Zapata,17024,29097,30301,59398
2027,Morelos,17,Tlaquiltenango,17025,19295,19727,39022
2027,Morelos,17,Tlayacapan,17026,10111,10231,20342
2027,Morelos,17,Totolapan,17027,6700,6832,13532
2027,Morelos,17,Xochitepec,17028,39798,39148,78946
2027,Morelos,17,Yautepec,17029,56952,59810,116762
2027,Morelos,17,Yecapixtla,17030,29717,30217,59934
2027,Morelos,17,Zacatepec,17031,20297,21893,42190
2027,Morelos,17,Zacualpan,17032,5400,5570,10970
2027,Nayarit,18,Acaponeta,18001,22129,22012,44141
2027,Nayarit,18,Ahuacatlán,18002,9590,9428,19018
2027,Nayarit,18,Amatlán de Cañas,18003,7253,6943,14196
2027,Nayarit,18,Bahía de Banderas,18020,97506,93349,190855
2027,Nayarit,18,Compostela,18004,44967,44492,89459
2027,Nayarit,18,Del Nayar,18009,24140,24038,48178
2027,Nayarit,18,Huajicori,18005,7415,7155,14570
2027,Nayarit,18,Ixtlán del Río,18006,16811,17883,34694
2027,Nayarit,18,Jala,18007,10772,10926,21698
2027,Nayarit,18,La Yesca,18019,8205,7682,15887
2027,Nayarit,18,Rosamorada,18010,20799,19787,40586
2027,Nayarit,18,Ruíz,18011,14910,14453,29363
2027,Nayarit,18,San Blas,18012,27993,24882,52875
2027,Nayarit,18,San Pedro Lagunillas,18013,4632,4482,9114
2027,Nayarit,18,Santa María del Oro,18014,14023,13620,27643
2027,Nayarit,18,Santiago Ixcuintla,18015,59705,57422,117127
2027,Nayarit,18,Tecuala,18016,24220,23419,47639
2027,Nayarit,18,Tepic,18017,236070,248019,484089
2027,Nayarit,18,Tuxpan,18018,18385,18477,36862
2027,Nayarit,18,Xalisco,18008,32968,34171,67139
2027,Nuevo León,19,Abasolo,19001,1533,1532,3065
2027,Nuevo León,19,Agualeguas,19002,1340,1271,2611
2027,Nuevo León,19,Allende,19004,21069,20822,41891
2027,Nuevo León,19,Anáhuac,19005,10844,10940,21784
2027,Nuevo León,19,Apodaca,19006,358958,352035,710993
2027,Nuevo León,19,Aramberri,19007,10093,9836,19929
2027,Nuevo León,19,Bustamante,19008,2443,2428,4871
2027,Nuevo León,19,Cadereyta Jiménez,19009,58330,55930,114260
2027,Nuevo León,19,Cerralvo,19011,4664,4368,9032
2027,Nuevo León,19,China,19013,6834,6501,13335
2027,Nuevo León,19,Ciénega de Flores,19012,28277,27133,55410
2027,Nuevo León,19,Doctor Arroyo,19014,21323,20707,42030
2027,Nuevo León,19,Doctor Coss,19015,1099,1068,2167
2027,Nuevo León,19,Doctor González,19016,1849,1748,3597
2027,Nuevo León,19,El Carmen,19010,26468,25856,52324
2027,Nuevo León,19,Galeana,19017,25284,24616,49900
2027,Nuevo León,19,García,19018,166895,164142,331037
2027,Nuevo León,19,General Bravo,19020,3532,3366,6898
2027,Nuevo León,19,General Escobedo,19021,248772,247616,496388
2027,Nuevo León,19,General Terán,19022,9175,9208,18383
2027,Nuevo León,19,General Treviño,19023,625,656,1281
2027,Nuevo León,19,General Zaragoza,19024,3757,3500,7257
2027,Nuevo León,19,General Zuazua,19025,50939,49871,100810
2027,Nuevo León,19,Guadalupe,19026,388591,381374,769965
2027,Nuevo León,19,Hidalgo,19047,8503,8429,16932
2027,Nuevo León,19,Higueras,19028,968,899,1867
2027,Nuevo León,19,Hualahuises,19029,4290,4319,8609
2027,Nuevo León,19,Iturbide,19030,2297,2124,4421
2027,Nuevo León,19,Juárez,19031,219283,212839,432122
2027,Nuevo León,19,Lampazos de Naranjo,19032,3263,3166,6429
2027,Nuevo León,19,Linares,19033,48604,48573,97177
2027,Nuevo León,19,Los Aldamas,19003,945,929,1874
2027,Nuevo León,19,Los Herreras,19027,1160,1187,2347
2027,Nuevo León,19,Los Ramones,19042,2798,2745,5543
2027,Nuevo León,19,Marín,19034,3416,3209,6625
2027,Nuevo León,19,Melchor Ocampo,19035,638,610,1248
2027,Nuevo León,19,Mier y Noriega,19036,4214,4107,8321
2027,Nuevo León,19,Mina,19037,3251,3092,6343
2027,Nuevo León,19,Montemorelos,19038,37385,37204,74589
2027,Nuevo León,19,Monterrey,19039,609772,639283,1249055
2027,Nuevo León,19,Parás,19040,619,596,1215
2027,Nuevo León,19,Pesquería,19041,62842,62050,124892
2027,Nuevo León,19,Rayones,19043,1760,1633,3393
2027,Nuevo León,19,Sabinas Hidalgo,19044,21073,21890,42963
2027,Nuevo León,19,Salinas Victoria,19045,34577,32853,67430
2027,Nuevo León,19,San Nicolás de los Garza,19046,251645,262558,514203
2027,Nuevo León,19,San Pedro Garza García,19019,71675,80044,151719
2027,Nuevo León,19,Santa Catarina,19048,173879,171842,345721
2027,Nuevo León,19,Santiago,19049,25899,25674,51573
2027,Nuevo León,19,Vallecillo,19050,1195,1026,2221
2027,Nuevo León,19,Villaldama,19051,2567,2560,5127
2027,Oaxaca,20,Abejones,20001,441,597,1038
2027,Oaxaca,20,Acatlán de Pérez Figueroa,20002,24192,25193,49385
2027,Oaxaca,20,Asunción Cacalotepec,20003,1089,1176,2265
2027,Oaxaca,20,Asunción Cuyotepeji,20004,503,573,1076
2027,Oaxaca,20,Asunción Ixtaltepec,20005,8287,8418,16705
2027,Oaxaca,20,Asunción Nochixtlán,20006,9563,10785,20348
2027,Oaxaca,20,Asunción Ocotlán,20007,1153,1430,2583
2027,Oaxaca,20,Asunción Tlacolulita,20008,417,444,861
2027,Oaxaca,20,Ayoquezco de Aldama,20398,2204,2459,4663
2027,Oaxaca,20,Ayotzintepec,20009,3806,3850,7656
2027,Oaxaca,20,Calihualá,20011,601,639,1240
2027,Oaxaca,20,Candelaria Loxicha,20012,5428,5687,11115
2027,Oaxaca,20,Capulálpam de Méndez,20247,768,940,1708
2027,Oaxaca,20,Chahuites,20025,6213,6288,12501
2027,Oaxaca,20,Chalcatongo de Hidalgo,20026,4637,5299,9936
2027,Oaxaca,20,Chiquihuitlán de Benito Juárez,20027,1156,1402,2558
2027,Oaxaca,20,Ciudad Ixtepec,20014,15276,16670,31946
2027,Oaxaca,20,Ciénega de Zimatlán,20013,1588,1739,3327
2027,Oaxaca,20,Coatecas Altas,20015,2196,2543,4739
2027,Oaxaca,20,Coicoyán de las Flores,20016,4945,5610,10555
2027,Oaxaca,20,Concepción Buenavista,20018,421,450,871
2027,Oaxaca,20,Concepción Pápalo,20019,1606,1619,3225
2027,Oaxaca,20,Constancia del Rosario,20020,1913,2203,4116
2027,Oaxaca,20,Cosolapa,20021,8074,8737,16811
2027,Oaxaca,20,Cosoltepec,20022,386,459,845
2027,Oaxaca,20,Cuilápam de Guerrero,20023,11541,12215,23756
2027,Oaxaca,20,Cuyamecalco Villa de Zaragoza,20024,1990,1970,3960
2027,Oaxaca,20,El Barrio de la Soledad,20010,7449,8079,15528
2027,Oaxaca,20,El Espinal,20030,4681,4914,9595
2027,Oaxaca,20,Eloxochitlán de Flores Magón,20029,2157,2439,4596
2027,Oaxaca,20,Fresnillo de Trujano,20032,546,592,1138
2027,Oaxaca,20,Guadalupe Etla,20033,1393,1557,2950
2027,Oaxaca,20,Guadalupe de Ramírez,20034,691,706,1397
2027,Oaxaca,20,Guelatao de Juárez,20035,288,293,581
2027,Oaxaca,20,Guevea de Humboldt,20036,2741,2858,5599
2027,Oaxaca,20,Heroica Ciudad de Ejutla de Crespo,20028,10916,12227,23143
2027,Oaxaca,20,Heroica Ciudad de Huajuapan de León,20039,39754,44403,84157
2027,Oaxaca,20,Heroica Ciudad de Juchitán de Zaragoza,20043,51898,54827,106725
2027,Oaxaca,20,Heroica Ciudad de Tlaxiaco,20397,20502,23336,43838
2027,Oaxaca,20,Huautepec,20040,3037,3527,6564
2027,Oaxaca,20,Huautla de Jiménez,20041,15359,17830,33189
2027,Oaxaca,20,Ixpantepec Nieves,20065,561,711,1272
2027,Oaxaca,20,Ixtlán de Juárez,20042,4317,4468,8785
2027,Oaxaca,20,La Compañía,20017,1696,1868,3564
2027,Oaxaca,20,La Pe,20069,1365,1459,2824
2027,Oaxaca,20,La Reforma,20076,1628,1775,3403
2027,Oaxaca,20,La Trinidad Vista Hermosa,20556,127,154,281
2027,Oaxaca,20,Loma Bonita,20044,22220,24342,46562
2027,Oaxaca,20,Magdalena Apasco,20045,4605,5133,9738
2027,Oaxaca,20,Magdalena Jaltepec,20046,1615,1893,3508
2027,Oaxaca,20,Magdalena Mixtepec,20048,681,714,1395
2027,Oaxaca,20,Magdalena Ocotlán,20049,602,648,1250
2027,Oaxaca,20,Magdalena Peñasco,20050,1720,2001,3721
2027,Oaxaca,20,Magdalena Teitipac,20051,2354,2518,4872
2027,Oaxaca,20,Magdalena Tequisistlán,20052,3259,3418,6677
2027,Oaxaca,20,Magdalena Tlacotepec,20053,662,722,1384
2027,Oaxaca,20,Magdalena Yodocono de Porfirio Díaz,20562,815,867,1682
2027,Oaxaca,20,Magdalena Zahuatlán,20054,213,238,451
2027,Oaxaca,20,Mariscala de Juárez,20055,1870,2028,3898
2027,Oaxaca,20,Matías Romero Avendaño,20057,20327,21734,42061
2027,Oaxaca,20,Mazatlán Villa de Flores,20058,6869,7030,13899
2027,Oaxaca,20,Mesones Hidalgo,20037,2159,2543,4702
2027,Oaxaca,20,Miahuatlán de Porfirio Díaz,20059,22528,24831,47359
2027,Oaxaca,20,Mixistlán de la Reforma,20060,1318,1467,2785
2027,Oaxaca,20,Monjas,20061,1372,1615,2987
2027,Oaxaca,20,Mártires de Tacubaya,20056,753,816,1569
2027,Oaxaca,20,Natividad,20062,335,385,720
2027,Oaxaca,20,Nazareno Etla,20063,2104,2318,4422
2027,Oaxaca,20,Nejapa de Madero,20064,3980,4131,8111
2027,Oaxaca,20,Nuevo Zoquiápam,20504,840,904,1744
2027,Oaxaca,20,Oaxaca de Juárez,20067,123366,142516,265882
2027,Oaxaca,20,Ocotlán de Morelos,20068,11356,12369,23725
2027,Oaxaca,20,Pinotepa de Don Luis,20070,3658,3771,7429
2027,Oaxaca,20,Pluma Hidalgo,20071,1528,1583,3111
2027,Oaxaca,20,Putla Villa de Guerrero,20073,16828,18980,35808
2027,Oaxaca,20,Reforma de Pineda,20075,1491,1598,3089
2027,Oaxaca,20,Reyes Etla,20077,2080,2209,4289
2027,Oaxaca,20,Rojas de Cuauhtémoc,20078,574,653,1227
2027,Oaxaca,20,Salina Cruz,20079,46133,50037,96170
2027,Oaxaca,20,San Agustín Amatengo,20080,756,859,1615
2027,Oaxaca,20,San Agustín Atenango,20081,884,1018,1902
2027,Oaxaca,20,San Agustín Chayuco,20082,1984,2172,4156
2027,Oaxaca,20,San Agustín Etla,20084,2133,2357,4490
2027,Oaxaca,20,San Agustín Loxicha,20085,12941,13451,26392
2027,Oaxaca,20,San Agustín Tlacotepec,20086,440,597,1037
2027,Oaxaca,20,San Agustín Yatareni,20087,2244,2539,4783
2027,Oaxaca,20,San Agustín de las Juntas,20083,5142,5361,10503
2027,Oaxaca,20,San Andrés Cabecera Nueva,20088,1473,1510,2983
2027,Oaxaca,20,San Andrés Dinicuiti,20089,1107,1170,2277
2027,Oaxaca,20,San Andrés Huaxpaltepec,20090,3190,3374,6564
2027,Oaxaca,20,San Andrés Huayápam,20091,2775,3054,5829
2027,Oaxaca,20,San Andrés Ixtlahuaca,20092,833,939,1772
2027,Oaxaca,20,San Andrés Lagunas,20093,250,291,541
2027,Oaxaca,20,San Andrés Nuxiño,20094,884,974,1858
2027,Oaxaca,20,San Andrés Paxtlán,20095,2298,2301,4599
2027,Oaxaca,20,San Andrés Sinaxtla,20096,381,441,822
2027,Oaxaca,20,San Andrés Solaga,20097,918,983,1901
2027,Oaxaca,20,San Andrés Teotilálpam,20098,2245,2463,4708
2027,Oaxaca,20,San Andrés Tepetlapa,20099,255,291,546
2027,Oaxaca,20,San Andrés Yaá,20100,235,277,512
2027,Oaxaca,20,San Andrés Zabache,20101,345,432,777
2027,Oaxaca,20,San Andrés Zautla,20102,2429,2596,5025
2027,Oaxaca,20,San Antonino Castillo Velasco,20103,3152,3474,6626
2027,Oaxaca,20,San Antonino Monte Verde,20105,3518,4110,7628
2027,Oaxaca,20,San Antonino el Alto,20104,1428,1463,2891
2027,Oaxaca,20,San Antonio Acutla,20106,124,153,277
2027,Oaxaca,20,San Antonio Huitepec,20108,2181,2575,4756
2027,Oaxaca,20,San Antonio Nanahuatípam,20109,662,669,1331
2027,Oaxaca,20,San Antonio Sinicahua,20110,773,902,1675
2027,Oaxaca,20,San Antonio Tepetlapa,20111,2200,2365,4565
2027,Oaxaca,20,San Antonio de la Cal,20107,12418,13870,26288
2027,Oaxaca,20,San Baltazar Chichicápam,20112,1303,1483,2786
2027,Oaxaca,20,San Baltazar Loxicha,20113,1542,1607,3149
2027,Oaxaca,20,San Baltazar Yatzachi el Bajo,20114,341,392,733
2027,Oaxaca,20,San Bartolo Coyotepec,20115,4995,5585,10580
2027,Oaxaca,20,San Bartolo Soyaltepec,20121,323,402,725
2027,Oaxaca,20,San Bartolo Yautepec,20122,357,364,721
2027,Oaxaca,20,San Bartolomé Ayautla,20116,2314,2483,4797
2027,Oaxaca,20,San Bartolomé Loxicha,20117,1194,1246,2440
2027,Oaxaca,20,San Bartolomé Quialana,20118,1090,1540,2630
2027,Oaxaca,20,San Bartolomé Yucuañe,20119,173,248,421
2027,Oaxaca,20,San Bartolomé Zoogocho,20120,143,194,337
2027,Oaxaca,20,San Bernardo Mixtepec,20123,1408,1503,2911
2027,Oaxaca,20,San Blas Atempa,20124,9654,9614,19268
2027,Oaxaca,20,San Carlos Yautepec,20125,6610,6470,13080
2027,Oaxaca,20,San Cristóbal Amatlán,20126,2607,2975,5582
2027,Oaxaca,20,San Cristóbal Amoltepec,20127,530,637,1167
2027,Oaxaca,20,San Cristóbal Lachirioag,20128,679,729,1408
2027,Oaxaca,20,San Cristóbal Suchixtlahuaca,20129,197,210,407
2027,Oaxaca,20,San Dionisio Ocotepec,20131,5405,6077,11482
2027,Oaxaca,20,San Dionisio Ocotlán,20132,622,635,1257
2027,Oaxaca,20,San Dionisio del Mar,20130,2813,2694,5507
2027,Oaxaca,20,San Esteban Atatlahuca,20133,1965,2075,4040
2027,Oaxaca,20,San Felipe Jalapa de Díaz,20134,14138,15163,29301
2027,Oaxaca,20,San Felipe Tejalápam,20135,4070,4447,8517
2027,Oaxaca,20,San Felipe Usila,20136,5898,6404,12302
2027,Oaxaca,20,San Francisco Cahuacuá,20137,1780,1819,3599
2027,Oaxaca,20,San Francisco Cajonos,20138,238,263,501
2027,Oaxaca,20,San Francisco Chapulapa,20139,1055,1137,2192
2027,Oaxaca,20,San Francisco Chindúa,20140,427,453,880
2027,Oaxaca,20,San Francisco Huehuetlán,20142,527,661,1188
2027,Oaxaca,20,San Francisco Ixhuatán,20143,4801,4843,9644
2027,Oaxaca,20,San Francisco Jaltepetongo,20144,536,565,1101
2027,Oaxaca,20,San Francisco Lachigoló,20145,2356,2438,4794
2027,Oaxaca,20,San Francisco Logueche,20146,1436,1667,3103
2027,Oaxaca,20,San Francisco Nuxaño,20147,211,202,413
2027,Oaxaca,20,San Francisco Ozolotepec,20148,969,1030,1999
2027,Oaxaca,20,San Francisco Sola,20149,871,965,1836
2027,Oaxaca,20,San Francisco Telixtlahuaca,20150,6696,7232,13928
2027,Oaxaca,20,San Francisco Teopan,20151,188,169,357
2027,Oaxaca,20,San Francisco Tlapancingo,20152,1070,1355,2425
2027,Oaxaca,20,San Francisco del Mar,20141,4211,4093,8304
2027,Oaxaca,20,San Gabriel Mixtepec,20153,2534,2687,5221
2027,Oaxaca,20,San Ildefonso Amatlán,20154,1252,1436,2688
2027,Oaxaca,20,San Ildefonso Sola,20155,523,513,1036
2027,Oaxaca,20,San Ildefonso Villa Alta,20156,1798,1907,3705
2027,Oaxaca,20,San Jacinto Amilpas,20157,8954,9903,18857
2027,Oaxaca,20,San Jacinto Tlacotepec,20158,1104,1161,2265
2027,Oaxaca,20,San Jerónimo Coatlán,20159,2684,2840,5524
2027,Oaxaca,20,San Jerónimo Silacayoapilla,20160,721,743,1464
2027,Oaxaca,20,San Jerónimo Sosola,20161,1346,1521,2867
2027,Oaxaca,20,San Jerónimo Taviche,20162,975,1055,2030
2027,Oaxaca,20,San Jerónimo Tecóatl,20163,818,925,1743
2027,Oaxaca,20,San Jerónimo Tlacochahuaya,20550,2845,3188,6033
2027,Oaxaca,20,San Jorge Nuchita,20164,1380,1662,3042
2027,Oaxaca,20,San José Ayuquila,20165,772,891,1663
2027,Oaxaca,20,San José Chiltepec,20166,6390,6708,13098
2027,Oaxaca,20,San José Estancia Grande,20168,560,569,1129
2027,Oaxaca,20,San José Independencia,20169,1883,2021,3904
2027,Oaxaca,20,San José Lachiguiri,20170,1643,2048,3691
2027,Oaxaca,20,San José Tenango,20171,9283,10119,19402
2027,Oaxaca,20,San José del Peñasco,20167,1108,1159,2267
2027,Oaxaca,20,San José del Progreso,20072,3510,3713,7223
2027,Oaxaca,20,San Juan Achiutla,20172,223,238,461
2027,Oaxaca,20,San Juan Atepec,20173,781,872,1653
2027,Oaxaca,20,San Juan Bautista Atatlahuca,20175,835,886,1721
2027,Oaxaca,20,San Juan Bautista Coixtlahuaca,20176,1366,1529,2895
2027,Oaxaca,20,San Juan Bautista Cuicatlán,20177,5250,5583,10833
2027,Oaxaca,20,San Juan Bautista Guelache,20178,3913,4386,8299
2027,Oaxaca,20,San Juan Bautista Jayacatlán,20179,833,818,1651
2027,Oaxaca,20,San Juan Bautista Lo de Soto,20180,1398,1427,2825
2027,Oaxaca,20,San Juan Bautista Suchitepec,20181,231,268,499
2027,Oaxaca,20,San Juan Bautista Tlachichilco,20183,686,791,1477
2027,Oaxaca,20,San Juan Bautista Tlacoatzintepec,20182,1080,1194,2274
2027,Oaxaca,20,San Juan Bautista Tuxtepec,20184,84234,91299,175533
2027,Oaxaca,20,San Juan Bautista Valle Nacional,20559,11634,12519,24153
2027,Oaxaca,20,San Juan Cacahuatepec,20185,4677,4909,9586
2027,Oaxaca,20,San Juan Chicomezúchil,20191,174,202,376
2027,Oaxaca,20,San Juan Chilateca,20192,777,904,1681
2027,Oaxaca,20,San Juan Cieneguilla,20186,309,339,648
2027,Oaxaca,20,San Juan Coatzóspam,20187,1111,1102,2213
2027,Oaxaca,20,San Juan Colorado,20188,5133,5477,10610
2027,Oaxaca,20,San Juan Comaltepec,20189,1476,1540,3016
2027,Oaxaca,20,San Juan Cotzocón,20190,12374,13012,25386
2027,Oaxaca,20,San Juan Diuxi,20195,579,607,1186
2027,Oaxaca,20,San Juan Evangelista Analco,20196,226,246,472
2027,Oaxaca,20,San Juan Guelavía,20197,1742,1864,3606
2027,Oaxaca,20,San Juan Guichicovi,20198,15161,17074,32235
2027,Oaxaca,20,San Juan Ihualtepec,20199,316,372,688
2027,Oaxaca,20,San Juan Juquila Mixes,20200,1951,2187,4138
2027,Oaxaca,20,San Juan Juquila Vijanos,20201,992,1092,2084
2027,Oaxaca,20,San Juan Lachao,20202,2451,2621,5072
2027,Oaxaca,20,San Juan Lachigalla,20203,1669,1820,3489
2027,Oaxaca,20,San Juan Lajarcia,20204,325,393,718
2027,Oaxaca,20,San Juan Lalana,20205,8724,9154,17878
2027,Oaxaca,20,San Juan Mazatlán,20207,9835,9890,19725
2027,Oaxaca,20,San Juan Mixtepec Distrito 08,20208,3539,4054,7593
2027,Oaxaca,20,San Juan Mixtepec Distrito 26,20209,294,433,727
2027,Oaxaca,20,San Juan Ozolotepec,20211,1394,1382,2776
2027,Oaxaca,20,San Juan Petlapa,20212,1493,1591,3084
2027,Oaxaca,20,San Juan Quiahije,20213,1916,2190,4106
2027,Oaxaca,20,San Juan Quiotepec,20214,1078,1128,2206
2027,Oaxaca,20,San Juan Sayultepec,20215,407,483,890
2027,Oaxaca,20,San Juan Tabaá,20216,693,763,1456
2027,Oaxaca,20,San Juan Tamazola,20217,1537,1628,3165
2027,Oaxaca,20,San Juan Teita,20218,335,350,685
2027,Oaxaca,20,San Juan Teitipac,20219,1370,1502,2872
2027,Oaxaca,20,San Juan Tepeuxila,20220,1455,1377,2832
2027,Oaxaca,20,San Juan Teposcolula,20221,655,695,1350
2027,Oaxaca,20,San Juan Yaeé,20222,764,866,1630
2027,Oaxaca,20,San Juan Yatzona,20223,216,280,496
2027,Oaxaca,20,San Juan Yucuita,20224,298,349,647
2027,Oaxaca,20,San Juan de los Cués,20206,1287,1311,2598
2027,Oaxaca,20,San Juan del Estado,20193,1401,1521,2922
2027,Oaxaca,20,San Juan del Río,20194,647,767,1414
2027,Oaxaca,20,San Juan Ñumí,20210,2930,3363,6293
2027,Oaxaca,20,San Lorenzo,20225,3129,3374,6503
2027,Oaxaca,20,San Lorenzo Albarradas,20226,1539,1485,3024
2027,Oaxaca,20,San Lorenzo Cacaotepec,20227,8301,9016,17317
2027,Oaxaca,20,San Lorenzo Cuaunecuiltitla,20228,452,415,867
2027,Oaxaca,20,San Lorenzo Texmelúcan,20229,3983,4659,8642
2027,Oaxaca,20,San Lorenzo Victoria,20230,531,560,1091
2027,Oaxaca,20,San Lucas Camotlán,20231,1530,1642,3172
2027,Oaxaca,20,San Lucas Ojitlán,20232,10313,10980,21293
2027,Oaxaca,20,San Lucas Quiaviní,20233,789,1110,1899
2027,Oaxaca,20,San Lucas Zoquiápam,20234,3840,4084,7924
2027,Oaxaca,20,San Luis Amatlán,20235,1807,2147,3954
2027,Oaxaca,20,San Marcial Ozolotepec,20236,763,837,1600
2027,Oaxaca,20,San Marcos Arteaga,20237,655,753,1408
2027,Oaxaca,20,San Martín Huamelúlpam,20239,526,625,1151
2027,Oaxaca,20,San Martín Itunyoso,20240,1004,1283,2287
2027,Oaxaca,20,San Martín Lachilá,20241,530,658,1188
2027,Oaxaca,20,San Martín Peras,20242,5993,6488,12481
2027,Oaxaca,20,San Martín Tilcajete,20243,890,1076,1966
2027,Oaxaca,20,San Martín Toxpalan,20244,1981,2095,4076
2027,Oaxaca,20,San Martín Zacatepec,20245,687,716,1403
2027,Oaxaca,20,San Martín de los Cansecos,20238,459,474,933
2027,Oaxaca,20,San Mateo Cajonos,20246,310,377,687
2027,Oaxaca,20,San Mateo Etlatongo,20250,598,639,1237
2027,Oaxaca,20,San Mateo Nejápam,20251,577,638,1215
2027,Oaxaca,20,San Mateo Peñasco,20252,1072,1229,2301
2027,Oaxaca,20,San Mateo Piñas,20253,1033,1035,2068
2027,Oaxaca,20,San Mateo Río Hondo,20254,1660,1743,3403
2027,Oaxaca,20,San Mateo Sindihui,20255,1030,1150,2180
2027,Oaxaca,20,San Mateo Tlapiltepec,20256,111,131,242
2027,Oaxaca,20,San Mateo Yoloxochitlán,20249,1831,2023,3854
2027,Oaxaca,20,San Mateo Yucutindoo,20566,1603,1641,3244
2027,Oaxaca,20,San Mateo del Mar,20248,8250,7954,16204
2027,Oaxaca,20,San Melchor Betaza,20257,523,609,1132
2027,Oaxaca,20,San Miguel Achiutla,20258,397,445,842
2027,Oaxaca,20,San Miguel Ahuehuetitlán,20259,1218,1353,2571
2027,Oaxaca,20,San Miguel Aloápam,20260,1089,1234,2323
2027,Oaxaca,20,San Miguel Amatitlán,20261,3803,4277,8080
2027,Oaxaca,20,San Miguel Amatlán,20262,517,548,1065
2027,Oaxaca,20,San Miguel Chicahua,20264,1039,1284,2323
2027,Oaxaca,20,San Miguel Chimalapa,20265,3783,3577,7360
2027,Oaxaca,20,San Miguel Coatlán,20263,1596,1861,3457
2027,Oaxaca,20,San Miguel Ejutla,20268,500,584,1084
2027,Oaxaca,20,San Miguel Huautla,20270,557,650,1207
2027,Oaxaca,20,San Miguel Mixtepec,20271,1664,1712,3376
2027,Oaxaca,20,San Miguel Panixtlahuaca,20272,2991,3703,6694
2027,Oaxaca,20,San Miguel Peras,20273,1713,1837,3550
2027,Oaxaca,20,San Miguel Piedras,20274,667,719,1386
2027,Oaxaca,20,San Miguel Quetzaltepec,20275,4460,4394,8854
2027,Oaxaca,20,San Miguel Santa Flor,20276,389,386,775
2027,Oaxaca,20,San Miguel Soyaltepec,20278,20152,21466,41618
2027,Oaxaca,20,San Miguel Suchixtepec,20279,1382,1525,2907
2027,Oaxaca,20,San Miguel Tecomatlán,20281,181,159,340
2027,Oaxaca,20,San Miguel Tenango,20282,400,385,785
2027,Oaxaca,20,San Miguel Tequixtepec,20283,531,582,1113
2027,Oaxaca,20,San Miguel Tilquiápam,20284,1442,1841,3283
2027,Oaxaca,20,San Miguel Tlacamama,20285,1928,1983,3911
2027,Oaxaca,20,San Miguel Tlacotepec,20286,1562,1801,3363
2027,Oaxaca,20,San Miguel Tulancingo,20287,139,216,355
2027,Oaxaca,20,San Miguel Yotao,20288,298,335,633
2027,Oaxaca,20,San Miguel del Puerto,20266,4377,4450,8827
2027,Oaxaca,20,San Miguel del Río,20267,148,144,292
2027,Oaxaca,20,San Miguel el Grande,20269,2187,2494,4681
2027,Oaxaca,20,San Nicolás,20289,577,695,1272
2027,Oaxaca,20,San Nicolás Hidalgo,20290,505,587,1092
2027,Oaxaca,20,San Pablo Coatlán,20291,2192,2297,4489
2027,Oaxaca,20,San Pablo Cuatro Venados,20292,699,791,1490
2027,Oaxaca,20,San Pablo Etla,20293,9404,10445,19849
2027,Oaxaca,20,San Pablo Huitzo,20294,3669,4152,7821
2027,Oaxaca,20,San Pablo Huixtepec,20295,4869,5356,10225
2027,Oaxaca,20,San Pablo Macuiltianguis,20296,488,511,999
2027,Oaxaca,20,San Pablo Tijaltepec,20297,1146,1373,2519
2027,Oaxaca,20,San Pablo Villa de Mitla,20298,6586,7194,13780
2027,Oaxaca,20,San Pablo Yaganiza,20299,538,612,1150
2027,Oaxaca,20,San Pedro Amuzgos,20300,3380,3866,7246
2027,Oaxaca,20,San Pedro Apóstol,20301,777,915,1692
2027,Oaxaca,20,San Pedro Atoyac,20302,2225,2503,4728
2027,Oaxaca,20,San Pedro Cajonos,20303,542,672,1214
2027,Oaxaca,20,San Pedro Comitancillo,20305,2232,2440,4672
2027,Oaxaca,20,San Pedro Coxcaltepec Cántaros,20304,385,432,817
2027,Oaxaca,20,San Pedro Huamelula,20307,5281,5310,10591
2027,Oaxaca,20,San Pedro Huilotepec,20308,1688,1707,3395
2027,Oaxaca,20,San Pedro Ixcatlán,20309,5893,6219,12112
2027,Oaxaca,20,San Pedro Ixtlahuaca,20310,4734,5011,9745
2027,Oaxaca,20,San Pedro Jaltepetongo,20311,294,332,626
2027,Oaxaca,20,San Pedro Jicayán,20312,6246,6876,13122
2027,Oaxaca,20,San Pedro Jocotipac,20313,391,469,860
2027,Oaxaca,20,San Pedro Juchatengo,20314,824,903,1727
2027,Oaxaca,20,San Pedro Mixtepec Distrito 22,20318,25781,26995,52776
2027,Oaxaca,20,San Pedro Mixtepec Distrito 26,20319,562,603,1165
2027,Oaxaca,20,San Pedro Molinos,20320,345,384,729
2027,Oaxaca,20,San Pedro Mártir,20315,790,987,1777
2027,Oaxaca,20,San Pedro Mártir Quiechapa,20316,355,402,757
2027,Oaxaca,20,San Pedro Mártir Yucuxaco,20317,620,729,1349
2027,Oaxaca,20,San Pedro Nopala,20321,372,412,784
2027,Oaxaca,20,San Pedro Ocopetatillo,20322,402,475,877
2027,Oaxaca,20,San Pedro Ocotepec,20323,1078,1161,2239
2027,Oaxaca,20,San Pedro Pochutla,20324,24868,25680,50548
2027,Oaxaca,20,San Pedro Quiatoni,20325,5661,5984,11645
2027,Oaxaca,20,San Pedro Sochiápam,20326,2628,2708,5336
2027,Oaxaca,20,San Pedro Tapanatepec,20327,7827,7989,15816
2027,Oaxaca,20,San Pedro Taviche,20328,630,644,1274
2027,Oaxaca,20,San Pedro Teozacoalco,20329,642,686,1328
2027,Oaxaca,20,San Pedro Teutila,20330,2221,2302,4523
2027,Oaxaca,20,San Pedro Tidaá,20331,467,546,1013
2027,Oaxaca,20,San Pedro Topiltepec,20332,193,217,410
2027,Oaxaca,20,San Pedro Totolápam,20333,1366,1520,2886
2027,Oaxaca,20,San Pedro Yaneri,20335,471,505,976
2027,Oaxaca,20,San Pedro Yucunama,20341,108,139,247
2027,Oaxaca,20,San Pedro Yólox,20336,875,950,1825
2027,Oaxaca,20,San Pedro el Alto,20306,1816,1919,3735
2027,Oaxaca,20,San Pedro y San Pablo Ayutla,20337,2563,3076,5639
2027,Oaxaca,20,San Pedro y San Pablo Teposcolula,20339,2133,2379,4512
2027,Oaxaca,20,San Pedro y San Pablo Tequixtepec,20340,872,1077,1949
2027,Oaxaca,20,San Raymundo Jalpan,20342,1788,2148,3936
2027,Oaxaca,20,San Sebastián Abasolo,20343,1017,1102,2119
2027,Oaxaca,20,San Sebastián Coatlán,20344,1396,1488,2884
2027,Oaxaca,20,San Sebastián Ixcapa,20345,2195,2239,4434
2027,Oaxaca,20,San Sebastián Nicananduta,20346,691,898,1589
2027,Oaxaca,20,San Sebastián Río Hondo,20347,1924,1953,3877
2027,Oaxaca,20,San Sebastián Tecomaxtlahuaca,20348,4230,4714,8944
2027,Oaxaca,20,San Sebastián Teitipac,20349,978,1156,2134
2027,Oaxaca,20,San Sebastián Tutla,20350,8900,10380,19280
2027,Oaxaca,20,San Simón Almolongas,20351,1425,1630,3055
2027,Oaxaca,20,San Simón Zahuatlán,20352,2179,2227,4406
2027,Oaxaca,20,San Vicente Coatlán,20534,1896,2239,4135
2027,Oaxaca,20,San Vicente Lachixío,20535,1341,1545,2886
2027,Oaxaca,20,San Vicente Nuñú,20536,219,258,477
2027,Oaxaca,20,Santa Ana,20353,1140,1212,2352
2027,Oaxaca,20,Santa Ana Ateixtlahuaca,20354,275,277,552
2027,Oaxaca,20,Santa Ana Cuauhtémoc,20355,378,399,777
2027,Oaxaca,20,Santa Ana Tavela,20357,430,470,900
2027,Oaxaca,20,Santa Ana Tlapacoyan,20358,1092,1185,2277
2027,Oaxaca,20,Santa Ana Yareni,20359,465,522,987
2027,Oaxaca,20,Santa Ana Zegache,20360,1934,2180,4114
2027,Oaxaca,20,Santa Ana del Valle,20356,1110,1162,2272
2027,Oaxaca,20,Santa Catalina Quierí,20361,439,554,993
2027,Oaxaca,20,Santa Catarina Cuixtla,20362,726,913,1639
2027,Oaxaca,20,Santa Catarina Ixtepeji,20363,1363,1467,2830
2027,Oaxaca,20,Santa Catarina Juquila,20364,8035,8568,16603
2027,Oaxaca,20,Santa Catarina Lachatao,20365,579,628,1207
2027,Oaxaca,20,Santa Catarina Loxicha,20366,1983,2059,4042
2027,Oaxaca,20,Santa Catarina Mechoacán,20367,2355,2412,4767
2027,Oaxaca,20,Santa Catarina Minas,20368,1038,1071,2109
2027,Oaxaca,20,Santa Catarina Quiané,20369,1036,1078,2114
2027,Oaxaca,20,Santa Catarina Quioquitani,20074,281,306,587
2027,Oaxaca,20,Santa Catarina Tayata,20370,328,391,719
2027,Oaxaca,20,Santa Catarina Ticuá,20371,523,652,1175
2027,Oaxaca,20,Santa Catarina Yosonotú,20372,829,1016,1845
2027,Oaxaca,20,Santa Catarina Zapoquila,20373,196,221,417
2027,Oaxaca,20,Santa Cruz Acatepec,20374,797,878,1675
2027,Oaxaca,20,Santa Cruz Amilpas,20375,6585,7638,14223
2027,Oaxaca,20,Santa Cruz Itundujia,20377,5898,6422,12320
2027,Oaxaca,20,Santa Cruz Mixtepec,20378,1828,1995,3823
2027,Oaxaca,20,Santa Cruz Nundaco,20379,1446,1712,3158
2027,Oaxaca,20,Santa Cruz Papalutla,20380,1139,1203,2342
2027,Oaxaca,20,Santa Cruz Tacache de Mina,20381,1388,1533,2921
2027,Oaxaca,20,Santa Cruz Tacahua,20382,561,637,1198
2027,Oaxaca,20,Santa Cruz Tayata,20383,320,333,653
2027,Oaxaca,20,Santa Cruz Xitla,20384,2455,2693,5148
2027,Oaxaca,20,Santa Cruz Xoxocotlán,20385,48236,54276,102512
2027,Oaxaca,20,Santa Cruz Zenzontepec,20386,9357,9795,19152
2027,Oaxaca,20,Santa Cruz de Bravo,20376,193,211,404
2027,Oaxaca,20,Santa Gertrudis,20387,1511,1609,3120
2027,Oaxaca,20,Santa Inés Yatzeche,20389,430,569,999
2027,Oaxaca,20,Santa Inés de Zaragoza,20569,829,948,1777
2027,Oaxaca,20,Santa Inés del Monte,20388,1233,1285,2518
2027,Oaxaca,20,Santa Lucía Miahuatlán,20391,1753,1851,3604
2027,Oaxaca,20,Santa Lucía Monteverde,20392,3301,3627,6928
2027,Oaxaca,20,Santa Lucía Ocotlán,20393,1879,2221,4100
2027,Oaxaca,20,Santa Lucía del Camino,20390,25365,27806,53171
2027,Oaxaca,20,Santa Magdalena Jicotlán,20047,46,61,107
2027,Oaxaca,20,Santa María Alotepec,20394,1493,1528,3021
2027,Oaxaca,20,Santa María Apazco,20395,845,1087,1932
2027,Oaxaca,20,Santa María Atzompa,20399,18566,19953,38519
2027,Oaxaca,20,Santa María Camotlán,20400,836,969,1805
2027,Oaxaca,20,Santa María Chachoápam,20404,381,432,813
2027,Oaxaca,20,Santa María Chilchotla,20406,10497,10926,21423
2027,Oaxaca,20,Santa María Chimalapa,20407,4846,4678,9524
2027,Oaxaca,20,Santa María Colotepec,20401,12784,12971,25755
2027,Oaxaca,20,Santa María Cortijo,20402,554,585,1139
2027,Oaxaca,20,Santa María Coyotepec,20403,1591,1768,3359
2027,Oaxaca,20,Santa María Ecatepec,20410,1800,1835,3635
2027,Oaxaca,20,Santa María Guelacé,20411,400,489,889
2027,Oaxaca,20,Santa María Guienagati,20412,1651,1656,3307
2027,Oaxaca,20,Santa María Huatulco,20413,23405,24199,47604
2027,Oaxaca,20,Santa María Huazolotitlán,20414,6081,6215,12296
2027,Oaxaca,20,Santa María Ipalapa,20415,2547,2791,5338
2027,Oaxaca,20,Santa María Ixcatlán,20416,256,287,543
2027,Oaxaca,20,Santa María Jacatepec,20417,4682,5189,9871
2027,Oaxaca,20,Santa María Jalapa del Marqués,20418,6936,7325,14261
2027,Oaxaca,20,Santa María Jaltianguis,20419,255,314,569
2027,Oaxaca,20,Santa María Lachixío,20420,957,1125,2082
2027,Oaxaca,20,Santa María Mixtequilla,20421,2447,2589,5036
2027,Oaxaca,20,Santa María Nativitas,20422,297,363,660
2027,Oaxaca,20,Santa María Nduayaco,20423,273,279,552
2027,Oaxaca,20,Santa María Ozolotepec,20424,1946,2073,4019
2027,Oaxaca,20,Santa María Petapa,20427,8526,9154,17680
2027,Oaxaca,20,Santa María Peñoles,20426,4361,4624,8985
2027,Oaxaca,20,Santa María Pápalo,20425,1126,1128,2254
2027,Oaxaca,20,Santa María Quiegolani,20428,1044,1027,2071
2027,Oaxaca,20,Santa María Sola,20429,768,829,1597
2027,Oaxaca,20,Santa María Tataltepec,20430,209,228,437
2027,Oaxaca,20,Santa María Tecomavaca,20431,870,929,1799
2027,Oaxaca,20,Santa María Temaxcalapa,20432,490,510,1000
2027,Oaxaca,20,Santa María Temaxcaltepec,20433,1241,1422,2663
2027,Oaxaca,20,Santa María Teopoxco,20434,2074,2384,4458
2027,Oaxaca,20,Santa María Tepantlali,20435,1974,2054,4028
2027,Oaxaca,20,Santa María Texcatitlán,20436,510,558,1068
2027,Oaxaca,20,Santa María Tlahuitoltepec,20437,4708,5102,9810
2027,Oaxaca,20,Santa María Tlalixtac,20438,878,925,1803
2027,Oaxaca,20,Santa María Tonameca,20439,13380,13514,26894
2027,Oaxaca,20,Santa María Totolapilla,20440,427,465,892
2027,Oaxaca,20,Santa María Xadani,20441,4715,4641,9356
2027,Oaxaca,20,Santa María Yalina,20442,139,164,303
2027,Oaxaca,20,Santa María Yavesía,20443,250,311,561
2027,Oaxaca,20,Santa María Yolotepec,20444,213,230,443
2027,Oaxaca,20,Santa María Yosoyúa,20445,880,872,1752
2027,Oaxaca,20,Santa María Yucuhiti,20446,3206,3534,6740
2027,Oaxaca,20,Santa María Zacatepec,20447,8083,9038,17121
2027,Oaxaca,20,Santa María Zaniza,20448,1115,1172,2287
2027,Oaxaca,20,Santa María Zoquitlán,20449,1630,1668,3298
2027,Oaxaca,20,Santa María del Rosario,20408,281,264,545
2027,Oaxaca,20,Santa María del Tule,20409,4540,5236,9776
2027,Oaxaca,20,Santa María la Asunción,20396,1539,1974,3513
2027,Oaxaca,20,Santiago Amoltepec,20450,6333,6780,13113
2027,Oaxaca,20,Santiago Apoala,20451,465,549,1014
2027,Oaxaca,20,Santiago Apóstol,20452,1914,2365,4279
2027,Oaxaca,20,Santiago Astata,20453,2123,2138,4261
2027,Oaxaca,20,Santiago Atitlán,20454,1606,1558,3164
2027,Oaxaca,20,Santiago Ayuquililla,20455,1383,1523,2906
2027,Oaxaca,20,Santiago Cacaloxtepec,20456,839,908,1747
2027,Oaxaca,20,Santiago Camotlán,20457,1667,1679,3346
2027,Oaxaca,20,Santiago Chazumba,20459,2188,2749,4937
2027,Oaxaca,20,Santiago Choápam,20460,2637,2818,5455
2027,Oaxaca,20,Santiago Comaltepec,20458,497,549,1046
2027,Oaxaca,20,Santiago Huajolotitlán,20462,2070,2446,4516
2027,Oaxaca,20,Santiago Huauclilla,20463,275,308,583
2027,Oaxaca,20,Santiago Ihuitlán Plumas,20464,171,218,389
2027,Oaxaca,20,Santiago Ixcuintepec,20465,844,868,1712
2027,Oaxaca,20,Santiago Ixtayutla,20466,6543,6892,13435
2027,Oaxaca,20,Santiago Jamiltepec,20467,9768,10606,20374
2027,Oaxaca,20,Santiago Jocotepec,20468,7277,7447,14724
2027,Oaxaca,20,Santiago Juxtlahuaca,20469,18226,20146,38372
2027,Oaxaca,20,Santiago Lachiguiri,20470,2496,2541,5037
2027,Oaxaca,20,Santiago Lalopa,20471,264,279,543
2027,Oaxaca,20,Santiago Laollaga,20472,1863,1882,3745
2027,Oaxaca,20,Santiago Laxopa,20473,673,756,1429
2027,Oaxaca,20,Santiago Llano Grande,20474,1759,1789,3548
2027,Oaxaca,20,Santiago Matatlán,20475,4969,5629,10598
2027,Oaxaca,20,Santiago Miltepec,20476,230,232,462
2027,Oaxaca,20,Santiago Minas,20477,728,741,1469
2027,Oaxaca,20,Santiago Nacaltepec,20478,926,1028,1954
2027,Oaxaca,20,Santiago Nejapilla,20479,122,112,234
2027,Oaxaca,20,Santiago Niltepec,20066,2914,2959,5873
2027,Oaxaca,20,Santiago Nundiche,20480,480,528,1008
2027,Oaxaca,20,Santiago Nuyoó,20481,886,993,1879
2027,Oaxaca,20,Santiago Pinotepa Nacional,20482,27777,29142,56919
2027,Oaxaca,20,Santiago Suchilquitongo,20483,5471,5876,11347
2027,Oaxaca,20,Santiago Tamazola,20484,2246,2554,4800
2027,Oaxaca,20,Santiago Tapextla,20485,1673,1602,3275
2027,Oaxaca,20,Santiago Tenango,20487,1104,1104,2208
2027,Oaxaca,20,Santiago Tepetlapa,20488,59,73,132
2027,Oaxaca,20,Santiago Tetepec,20489,2581,2601,5182
2027,Oaxaca,20,Santiago Texcalcingo,20490,1573,1696,3269
2027,Oaxaca,20,Santiago Textitlán,20491,2292,2299,4591
2027,Oaxaca,20,Santiago Tilantongo,20492,1442,1708,3150
2027,Oaxaca,20,Santiago Tillo,20493,277,320,597
2027,Oaxaca,20,Santiago Tlazoyaltepec,20494,2310,2740,5050
2027,Oaxaca,20,Santiago Xanica,20495,1609,1591,3200
2027,Oaxaca,20,Santiago Xiacuí,20496,1084,1192,2276
2027,Oaxaca,20,Santiago Yaitepec,20497,2074,2466,4540
2027,Oaxaca,20,Santiago Yaveo,20498,3747,3699,7446
2027,Oaxaca,20,Santiago Yolomécatl,20499,1060,1245,2305
2027,Oaxaca,20,Santiago Yosondúa,20500,4307,4840,9147
2027,Oaxaca,20,Santiago Yucuyachi,20501,494,542,1036
2027,Oaxaca,20,Santiago Zacatepec,20502,2785,2881,5666
2027,Oaxaca,20,Santiago Zoochila,20503,201,219,420
2027,Oaxaca,20,Santiago del Río,20461,299,329,628
2027,Oaxaca,20,Santo Domingo Albarradas,20506,394,448,842
2027,Oaxaca,20,Santo Domingo Armenta,20507,1831,1827,3658
2027,Oaxaca,20,Santo Domingo Chihuitán,20508,817,848,1665
2027,Oaxaca,20,Santo Domingo Ingenio,20505,4368,4404,8772
2027,Oaxaca,20,Santo Domingo Ixcatlán,20510,291,357,648
2027,Oaxaca,20,Santo Domingo Nuxaá,20511,1649,1750,3399
2027,Oaxaca,20,Santo Domingo Ozolotepec,20512,403,437,840
2027,Oaxaca,20,Santo Domingo Petapa,20513,5008,4919,9927
2027,Oaxaca,20,Santo Domingo Roayaga,20514,523,568,1091
2027,Oaxaca,20,Santo Domingo Tehuantepec,20515,34271,36198,70469
2027,Oaxaca,20,Santo Domingo Teojomulco,20516,2616,2727,5343
2027,Oaxaca,20,Santo Domingo Tepuxtepec,20517,2863,3267,6130
2027,Oaxaca,20,Santo Domingo Tlatayápam,20518,69,80,149
2027,Oaxaca,20,Santo Domingo Tomaltepec,20519,1589,1634,3223
2027,Oaxaca,20,Santo Domingo Tonaltepec,20521,116,147,263
2027,Oaxaca,20,Santo Domingo Tonalá,20520,3519,3940,7459
2027,Oaxaca,20,Santo Domingo Xagacía,20522,594,678,1272
2027,Oaxaca,20,Santo Domingo Yanhuitlán,20523,806,908,1714
2027,Oaxaca,20,Santo Domingo Yodohino,20524,160,168,328
2027,Oaxaca,20,Santo Domingo Zanatepec,20525,6562,6637,13199
2027,Oaxaca,20,Santo Domingo de Morelos,20509,5512,6099,11611
2027,Oaxaca,20,Santo Tomás Jalieza,20530,1826,2009,3835
2027,Oaxaca,20,Santo Tomás Mazaltepec,20531,1392,1507,2899
2027,Oaxaca,20,Santo Tomás Ocotepec,20532,1900,2178,4078
2027,Oaxaca,20,Santo Tomás Tamazulapan,20533,1178,1255,2433
2027,Oaxaca,20,Santos Reyes Nopala,20526,9076,9687,18763
2027,Oaxaca,20,Santos Reyes Pápalo,20527,1326,1438,2764
2027,Oaxaca,20,Santos Reyes Tepejillo,20528,463,608,1071
2027,Oaxaca,20,Santos Reyes Yucuná,20529,663,673,1336
2027,Oaxaca,20,Silacayoápam,20537,3473,3961,7434
2027,Oaxaca,20,Sitio de Xitlapehua,20538,349,392,741
2027,Oaxaca,20,Soledad Etla,20539,3026,3177,6203
2027,Oaxaca,20,Tamazulápam del Espíritu Santo,20031,3581,4373,7954
2027,Oaxaca,20,Tanetze de Zaragoza,20541,861,932,1793
2027,Oaxaca,20,Taniche,20542,410,490,900
2027,Oaxaca,20,Tataltepec de Valdés,20543,2977,3140,6117
2027,Oaxaca,20,Teococuilco de Marcos Pérez,20544,462,549,1011
2027,Oaxaca,20,Teotitlán de Flores Magón,20545,5046,5661,10707
2027,Oaxaca,20,Teotitlán del Valle,20546,3014,3337,6351
2027,Oaxaca,20,Teotongo,20547,485,576,1061
2027,Oaxaca,20,Tepelmeme Villa de Morelos,20548,810,972,1782
2027,Oaxaca,20,Tlacolula de Matamoros,20551,11855,13405,25260
2027,Oaxaca,20,Tlacotepec Plumas,20552,234,259,493
2027,Oaxaca,20,Tlalixtac de Cabrera,20553,5370,5951,11321
2027,Oaxaca,20,Totontepec Villa de Morelos,20554,2769,3004,5773
2027,Oaxaca,20,Trinidad Zaachila,20555,1532,1712,3244
2027,Oaxaca,20,Unión Hidalgo,20557,8240,8700,16940
2027,Oaxaca,20,Valerio Trujano,20558,693,839,1532
2027,Oaxaca,20,Villa Díaz Ordaz,20560,3388,4004,7392
2027,Oaxaca,20,Villa Hidalgo,20038,1000,1114,2114
2027,Oaxaca,20,Villa Sola de Vega,20277,6432,6578,13010
2027,Oaxaca,20,Villa Talea de Castro,20280,1190,1308,2498
2027,Oaxaca,20,Villa Tejúpam de la Unión,20486,1288,1390,2678
2027,Oaxaca,20,Villa Tezoatlán de Segura y Luna,20549,5470,6449,11919
2027,Oaxaca,20,Villa de Chilapa de Díaz,20405,1043,1323,2366
2027,Oaxaca,20,Villa de Etla,20338,5663,6273,11936
2027,Oaxaca,20,Villa de Tamazulápam del Progreso,20540,3910,4431,8341
2027,Oaxaca,20,Villa de Tututepec de Melchor Ocampo,20334,23796,24704,48500
2027,Oaxaca,20,Villa de Zaachila,20565,23250,25485,48735
2027,Oaxaca,20,Yaxe,20561,1453,1570,3023
2027,Oaxaca,20,Yogana,20563,635,743,1378
2027,Oaxaca,20,Yutanduchi de Guerrero,20564,594,662,1256
2027,Oaxaca,20,Zapotitlán Lagunas,20567,1602,1799,3401
2027,Oaxaca,20,Zapotitlán Palmas,20568,707,858,1565
2027,Oaxaca,20,Zimatlán de Álvarez,20570,10121,11493,21614
2027,Oaxaca,20,Ánimas Trujano,20174,2072,2304,4376
2027,Puebla,21,Acajete,21001,35183,37473,72656
2027,Puebla,21,Acateno,21002,5266,5179,10445
2027,Puebla,21,Acatlán,21003,18624,21583,40207
2027,Puebla,21,Acatzingo,21004,32197,33306,65503
2027,Puebla,21,Acteopan,21005,1587,1758,3345
2027,Puebla,21,Ahuacatlán,21006,8415,9369,17784
2027,Puebla,21,Ahuatlán,21007,1742,1883,3625
2027,Puebla,21,Ahuazotepec,21008,6324,6506,12830
2027,Puebla,21,Ahuehuetitla,21009,948,1088,2036
2027,Puebla,21,Ajalpan,21010,35622,37517,73139
2027,Puebla,21,Albino Zertuche,21011,942,1102,2044
2027,Puebla,21,Aljojuca,21012,3578,3898,7476
2027,Puebla,21,Altepexi,21013,11650,12225,23875
2027,Puebla,21,Amixtlán,21014,2643,2908,5551
2027,Puebla,21,Amozoc,21015,65042,67638,132680
2027,Puebla,21,Aquixtla,21016,4918,4949,9867
2027,Puebla,21,Atempan,21017,14730,16579,31309
2027,Puebla,21,Atexcal,21018,2061,2219,4280
2027,Puebla,21,Atlequizayan,21080,1403,1565,2968
2027,Puebla,21,Atlixco,21019,72571,80870,153441
2027,Puebla,21,Atoyatempan,21020,3787,3997,7784
2027,Puebla,21,Atzala,21021,708,774,1482
2027,Puebla,21,Atzitzihuacán,21022,6509,7359,13868
2027,Puebla,21,Atzitzintla,21023,5089,5152,10241
2027,Puebla,21,Axutla,21024,516,595,1111
2027,Puebla,21,Ayotoxco de Guerrero,21025,4753,4872,9625
2027,Puebla,21,Calpan,21026,7820,8598,16418
2027,Puebla,21,Caltepec,21027,2080,2403,4483
2027,Puebla,21,Camocuautla,21028,1464,1488,2952
2027,Puebla,21,Caxhuacan,21029,1988,2185,4173
2027,Puebla,21,Cañada Morelos,21099,10432,11067,21499
2027,Puebla,21,Chalchicomula de Sesma,21045,25697,27821,53518
2027,Puebla,21,Chapulco,21046,4185,4479,8664
2027,Puebla,21,Chiautla,21047,10993,11672,22665
2027,Puebla,21,Chiautzingo,21048,10919,11947,22866
2027,Puebla,21,Chichiquila,21050,13773,14710,28483
2027,Puebla,21,Chiconcuautla,21049,9031,9440,18471
2027,Puebla,21,Chietla,21051,18970,20249,39219
2027,Puebla,21,Chigmecatitlán,21052,627,746,1373
2027,Puebla,21,Chignahuapan,21053,34675,35694,70369
2027,Puebla,21,Chignautla,21054,18334,19386,37720
2027,Puebla,21,Chila,21055,2468,2753,5221
2027,Puebla,21,Chila de la Sal,21056,815,881,1696
2027,Puebla,21,Chilchotla,21058,10973,10953,21926
2027,Puebla,21,Chinantla,21059,1211,1371,2582
2027,Puebla,21,Coatepec,21030,411,457,868
2027,Puebla,21,Coatzingo,21031,1580,1754,3334
2027,Puebla,21,Cohetzala,21032,788,781,1569
2027,Puebla,21,Cohuecan,21033,2635,2845,5480
2027,Puebla,21,Coronango,21034,22533,23239,45772
2027,Puebla,21,Coxcatlán,21035,10983,12101,23084
2027,Puebla,21,Coyomeapan,21036,7344,8090,15434
2027,Puebla,21,Coyotepec,21037,1240,1460,2700
2027,Puebla,21,Cuapiaxtla de Madero,21038,5614,5636,11250
2027,Puebla,21,Cuautempan,21039,5047,5414,10461
2027,Puebla,21,Cuautinchán,21040,5703,5733,11436
2027,Puebla,21,Cuautlancingo,21041,66530,69927,136457
2027,Puebla,21,Cuayuca de Andrade,21042,1738,1862,3600
2027,Puebla,21,Cuetzalan del Progreso,21043,26217,27591,53808
2027,Puebla,21,Cuyoaco,21044,8465,9156,17621
2027,Puebla,21,Domingo Arenas,21060,3994,4413,8407
2027,Puebla,21,Eloxochitlán,21061,6780,7226,14006
2027,Puebla,21,Epatlán,21062,2662,2810,5472
2027,Puebla,21,Esperanza,21063,8122,8610,16732
2027,Puebla,21,Francisco Z. Mena,21064,9804,9625,19429
2027,Puebla,21,General Felipe Ángeles,21065,11065,12006,23071
2027,Puebla,21,Guadalupe,21066,3054,3540,6594
2027,Puebla,21,Guadalupe Victoria,21067,9270,9759,19029
2027,Puebla,21,Hermenegildo Galeana,21068,4300,4377,8677
2027,Puebla,21,Honey,21057,4304,4626,8930
2027,Puebla,21,Huaquechula,21069,13148,14839,27987
2027,Puebla,21,Huatlatlauca,21070,3402,4106,7508
2027,Puebla,21,Huauchinango,21071,55875,61911,117786
2027,Puebla,21,Huehuetla,21072,10425,10726,21151
2027,Puebla,21,Huehuetlán el Chico,21073,4699,4909,9608
2027,Puebla,21,Huehuetlán el Grande,21150,3994,4233,8227
2027,Puebla,21,Huejotzingo,21074,40705,42453,83158
2027,Puebla,21,Hueyapan,21075,6823,7257,14080
2027,Puebla,21,Hueytamalco,21076,14517,14836,29353
2027,Puebla,21,Hueytlalpan,21077,2992,3122,6114
2027,Puebla,21,Huitzilan de Serdán,21078,8422,8244,16666
2027,Puebla,21,Huitziltepec,21079,2974,3174,6148
2027,Puebla,21,Ixcamilpa de Guerrero,21081,1952,2146,4098
2027,Puebla,21,Ixcaquixtla,21082,4790,5257,10047
2027,Puebla,21,Ixtacamaxtitlán,21083,13604,13834,27438
2027,Puebla,21,Ixtepec,21084,3830,4051,7881
2027,Puebla,21,Izúcar de Matamoros,21085,41610,46278,87888
2027,Puebla,21,Jalpan,21086,6528,6982,13510
2027,Puebla,21,Jolalpan,21087,7090,7582,14672
2027,Puebla,21,Jonotla,21088,2531,2628,5159
2027,Puebla,21,Jopala,21089,7171,7451,14622
2027,Puebla,21,Juan C. Bonilla,21090,11560,12508,24068
2027,Puebla,21,Juan Galindo,21091,5634,6458,12092
2027,Puebla,21,Juan N. Méndez,21092,2941,2996,5937
2027,Puebla,21,La Magdalena Tlatlauquitepec,21095,324,319,643
2027,Puebla,21,Lafragua,21093,4485,4604,9089
2027,Puebla,21,Libres,21094,18481,19420,37901
2027,Puebla,21,Los Reyes de Juárez,21118,14979,15364,30343
2027,Puebla,21,Mazapiltepec de Juárez,21096,1596,1611,3207
2027,Puebla,21,Mixtla,21097,1253,1398,2651
2027,Puebla,21,Molcaxac,21098,3244,3632,6876
2027,Puebla,21,Naupan,21100,5282,5794,11076
2027,Puebla,21,Nauzontla,21101,1859,2075,3934
2027,Puebla,21,Nealtican,21102,6629,7201,13830
2027,Puebla,21,Nicolás Bravo,21103,3399,3618,7017
2027,Puebla,21,Nopalucan,21104,17109,17485,34594
2027,Puebla,21,Ocotepec,21105,2612,2810,5422
2027,Puebla,21,Ocoyucan,21106,14875,16631,31506
2027,Puebla,21,Olintla,21107,6390,6707,13097
2027,Puebla,21,Oriental,21108,9965,10549,20514
2027,Puebla,21,Pahuatlán,21109,11834,12994,24828
2027,Puebla,21,Palmar de Bravo,21110,25374,25734,51108
2027,Puebla,21,Pantepec,21111,10150,10718,20868
2027,Puebla,21,Petlalcingo,21112,5166,5881,11047
2027,Puebla,21,Piaxtla,21113,2454,2672,5126
2027,Puebla,21,Puebla,21114,861180,939243,1800423
2027,Puebla,21,Quecholac,21115,27747,28635,56382
2027,Puebla,21,Quimixtlán,21116,12062,12376,24438
2027,Puebla,21,Rafael Lara Grajales,21117,7434,7946,15380
2027,Puebla,21,San Andrés Cholula,21119,82293,83794,166087
2027,Puebla,21,San Antonio Cañada,21120,2888,3247,6135
2027,Puebla,21,San Diego la Mesa Tochimiltzingo,21121,677,675,1352
2027,Puebla,21,San Felipe Teotlalcingo,21122,5719,6072,11791
2027,Puebla,21,San Felipe Tepatlán,21123,2172,2238,4410
2027,Puebla,21,San Gabriel Chilac,21124,8379,9302,17681
2027,Puebla,21,San Gregorio Atzompa,21125,5022,5269,10291
2027,Puebla,21,San Jerónimo Tecuanipan,21126,3357,3669,7026
2027,Puebla,21,San Jerónimo Xayacatlán,21127,1838,2118,3956
2027,Puebla,21,San José Chiapa,21128,4878,4957,9835
2027,Puebla,21,San José Miahuatlán,21129,7208,7798,15006
2027,Puebla,21,San Juan Atenco,21130,1765,2029,3794
2027,Puebla,21,San Juan Atzompa,21131,509,480,989
2027,Puebla,21,San Martín Texmelucan,21132,82939,88655,171594
2027,Puebla,21,San Martín Totoltepec,21133,332,360,692
2027,Puebla,21,San Matías Tlalancaleca,21134,11316,11647,22963
2027,Puebla,21,San Miguel Ixitlán,21135,285,314,599
2027,Puebla,21,San Miguel Xoxtla,21136,6840,7204,14044
2027,Puebla,21,San Nicolás Buenos Aires,21137,5437,5656,11093
2027,Puebla,21,San Nicolás de los Ranchos,21138,6588,6802,13390
2027,Puebla,21,San Pablo Anicano,21139,1933,2105,4038
2027,Puebla,21,San Pedro Cholula,21140,71004,76943,147947
2027,Puebla,21,San Pedro Yeloixtlahuaca,21141,1811,1963,3774
2027,Puebla,21,San Salvador Huixcolotla,21144,8233,8338,16571
2027,Puebla,21,San Salvador el Seco,21142,16684,17523,34207
2027,Puebla,21,San Salvador el Verde,21143,17492,17966,35458
2027,Puebla,21,San Sebastián Tlacotepec,21145,7633,7750,15383
2027,Puebla,21,Santa Catarina Tlaltempan,21146,463,470,933
2027,Puebla,21,Santa Inés Ahuatempan,21147,3441,3788,7229
2027,Puebla,21,Santa Isabel Cholula,21148,4712,5101,9813
2027,Puebla,21,Santiago Miahuatlán,21149,13931,14668,28599
2027,Puebla,21,Santo Tomás Hueyotlipan,21151,4644,4983,9627
2027,Puebla,21,Soltepec,21152,6849,7135,13984
2027,Puebla,21,Tecali de Herrera,21153,12176,12739,24915
2027,Puebla,21,Tecamachalco,21154,41679,44032,85711
2027,Puebla,21,Tecomatlán,21155,3140,3281,6421
2027,Puebla,21,Tehuacán,21156,169299,188180,357479
2027,Puebla,21,Tehuitzingo,21157,6082,6793,12875
2027,Puebla,21,Tenampulco,21158,4041,4187,8228
2027,Puebla,21,Teopantlán,21159,1924,2393,4317
2027,Puebla,21,Teotlalco,21160,1757,1828,3585
2027,Puebla,21,Tepanco de López,21161,10924,12048,22972
2027,Puebla,21,Tepango de Rodríguez,21162,2175,2409,4584
2027,Puebla,21,Tepatlaxco de Hidalgo,21163,9487,9972,19459
2027,Puebla,21,Tepeaca,21164,43084,46714,89798
2027,Puebla,21,Tepemaxalco,21165,589,609,1198
2027,Puebla,21,Tepeojuma,21166,4526,5229,9755
2027,Puebla,21,Tepetzintla,21167,6168,6603,12771
2027,Puebla,21,Tepexco,21168,3690,3854,7544
2027,Puebla,21,Tepexi de Rodríguez,21169,11888,11997,23885
2027,Puebla,21,Tepeyahualco,21170,9454,9590,19044
2027,Puebla,21,Tepeyahualco de Cuauhtémoc,21171,1935,2093,4028
2027,Puebla,21,Tetela de Ocampo,21172,15436,16504,31940
2027,Puebla,21,Teteles de Ávila Castillo,21173,3004,3553,6557
2027,Puebla,21,Teziutlán,21174,52304,58300,110604
2027,Puebla,21,Tianguismanalco,21175,6946,7450,14396
2027,Puebla,21,Tilapa,21176,4657,4977,9634
2027,Puebla,21,Tlachichuca,21179,16133,16677,32810
2027,Puebla,21,Tlacotepec de Benito Juárez,21177,27617,29927,57544
2027,Puebla,21,Tlacuilotepec,21178,9239,9518,18757
2027,Puebla,21,Tlahuapan,21180,22306,22441,44747
2027,Puebla,21,Tlaltenango,21181,3925,3988,7913
2027,Puebla,21,Tlanepantla,21182,2644,2860,5504
2027,Puebla,21,Tlaola,21183,10791,11453,22244
2027,Puebla,21,Tlapacoya,21184,3559,3690,7249
2027,Puebla,21,Tlapanalá,21185,4556,4928,9484
2027,Puebla,21,Tlatlauquitepec,21186,28925,31912,60837
2027,Puebla,21,Tlaxco,21187,3036,3041,6077
2027,Puebla,21,Tochimilco,21188,9720,10664,20384
2027,Puebla,21,Tochtepec,21189,11411,12203,23614
2027,Puebla,21,Totoltepec de Guerrero,21190,641,775,1416
2027,Puebla,21,Tulcingo,21191,4945,5665,10610
2027,Puebla,21,Tuzamapan de Galeana,21192,3585,3735,7320
2027,Puebla,21,Tzicatlacoyan,21193,3946,4028,7974
2027,Puebla,21,Venustiano Carranza,21194,16082,17157,33239
2027,Puebla,21,Vicente Guerrero,21195,13057,14021,27078
2027,Puebla,21,Xayacatlán de Bravo,21196,826,992,1818
2027,Puebla,21,Xicotepec,21197,43807,47056,90863
2027,Puebla,21,Xicotlán,21198,649,716,1365
2027,Puebla,21,Xiutetelco,21199,21411,23043,44454
2027,Puebla,21,Xochiapulco,21200,1824,2020,3844
2027,Puebla,21,Xochiltepec,21201,1707,2039,3746
2027,Puebla,21,Xochitlán Todos Santos,21203,3437,3801,7238
2027,Puebla,21,Xochitlán de Vicente Suárez,21202,6811,7343,14154
2027,Puebla,21,Yaonáhuac,21204,4262,4682,8944
2027,Puebla,21,Yehualtepec,21205,13512,14122,27634
2027,Puebla,21,Zacapala,21206,2387,2658,5045
2027,Puebla,21,Zacapoaxtla,21207,29459,32431,61890
2027,Puebla,21,Zacatlán,21208,44240,48845,93085
2027,Puebla,21,Zapotitlán,21209,4407,5218,9625
2027,Puebla,21,Zapotitlán de Méndez,21210,3153,3180,6333
2027,Puebla,21,Zaragoza,21211,8412,9822,18234
2027,Puebla,21,Zautla,21212,9967,11381,21348
2027,Puebla,21,Zihuateutla,21213,7254,7620,14874
2027,Puebla,21,Zinacatepec,21214,9172,9989,19161
2027,Puebla,21,Zongozotla,21215,2761,2820,5581
2027,Puebla,21,Zoquiapan,21216,1288,1459,2747
2027,Puebla,21,Zoquitlán,21217,9907,10556,20463
2027,Querétaro,22,Amealco de Bonfil,22001,36691,38858,75549
2027,Querétaro,22,Arroyo Seco,22003,8221,8728,16949
2027,Querétaro,22,Cadereyta de Montes,22004,41175,44420,85595
2027,Querétaro,22,Colón,22005,38405,37602,76007
2027,Querétaro,22,Corregidora,22006,115105,121654,236759
2027,Querétaro,22,El Marqués,22011,101789,99430,201219
2027,Querétaro,22,Ezequiel Montes,22007,24582,26201,50783
2027,Querétaro,22,Huimilpan,22008,22400,24225,46625
2027,Querétaro,22,Jalpan de Serra,22009,15868,17339,33207
2027,Querétaro,22,Landa de Matamoros,22010,10930,11760,22690
2027,Querétaro,22,Pedro Escobedo,22012,42021,42548,84569
2027,Querétaro,22,Peñamiller,22013,12268,12524,24792
2027,Querétaro,22,Pinal de Amoles,22002,15188,16056,31244
2027,Querétaro,22,Querétaro,22014,539283,548152,1087435
2027,Querétaro,22,San Joaquín,22015,5404,6088,11492
2027,Querétaro,22,San Juan del Río,22016,164956,171213,336169
2027,Querétaro,22,Tequisquiapan,22017,43259,44918,88177
2027,Querétaro,22,Tolimán,22018,17105,17778,34883
2027,Quintana Roo,23,Bacalar,23010,26582,26276,52858
2027,Quintana Roo,23,Benito Juárez,23005,482755,476856,959611
2027,Quintana Roo,23,Cozumel,23001,59143,59174,118317
2027,Quintana Roo,23,Felipe Carrillo Puerto,23002,54828,54424,109252
2027,Quintana Roo,23,Isla Mujeres,23003,14522,13318,27840
2027,Quintana Roo,23,José María Morelos,23006,25892,24304,50196
2027,Quintana Roo,23,Lázaro Cárdenas,23007,18903,18014,36917
2027,Quintana Roo,23,Othón P. Blanco,23004,152719,158977,311696
2027,Quintana Roo,23,Solidaridad,23008,140882,127445,268327
2027,Quintana Roo,23,Tulum,23009,22080,19781,41861
2027,San Luis Potosí,24,Ahualulco,24001,9298,10426,19724
2027,San Luis Potosí,24,Alaquines,24002,4545,4666,9211
2027,San Luis Potosí,24,Aquismón,24003,26387,25837,52224
2027,San Luis Potosí,24,Armadillo de los Infante,24004,2275,2341,4616
2027,San Luis Potosí,24,Axtla de Terrazas,24053,20120,20705,40825
2027,San Luis Potosí,24,Catorce,24006,5532,5342,10874
2027,San Luis Potosí,24,Cedral,24007,10248,10727,20975
2027,San Luis Potosí,24,Cerritos,24008,11654,12488,24142
2027,San Luis Potosí,24,Cerro de San Pedro,24009,2521,2450,4971
2027,San Luis Potosí,24,Charcas,24015,11270,11680,22950
2027,San Luis Potosí,24,Ciudad Fernández,24011,24037,25363,49400
2027,San Luis Potosí,24,Ciudad Valles,24013,94955,101825,196780
2027,San Luis Potosí,24,Ciudad del Maíz,24010,19348,19469,38817
2027,San Luis Potosí,24,Coxcatlán,24014,8441,8353,16794
2027,San Luis Potosí,24,Cárdenas,24005,9972,10868,20840
2027,San Luis Potosí,24,Ebano,24016,23579,24437,48016
2027,San Luis Potosí,24,El Naranjo,24058,12178,12042,24220
2027,San Luis Potosí,24,Guadalcázar,24017,14788,14521,29309
2027,San Luis Potosí,24,Huehuetlán,24018,8525,8821,17346
2027,San Luis Potosí,24,Lagunillas,24019,3072,3178,6250
2027,San Luis Potosí,24,Matehuala,24020,52870,56099,108969
2027,San Luis Potosí,24,Matlapa,24057,16452,16650,33102
2027,San Luis Potosí,24,Mexquitic de Carmona,24021,29616,32118,61734
2027,San Luis Potosí,24,Moctezuma,24022,10187,11047,21234
2027,San Luis Potosí,24,Rayón,24023,8501,8930,17431
2027,San Luis Potosí,24,Rioverde,24024,50442,53494,103936
2027,San Luis Potosí,24,Salinas,24025,16560,17818,34378
2027,San Luis Potosí,24,San Antonio,24026,5094,4943,10037
2027,San Luis Potosí,24,San Ciro de Acosta,24027,5565,5934,11499
2027,San Luis Potosí,24,San Luis Potosí,24028,435408,468599,904007
2027,San Luis Potosí,24,San Martín Chalchicuautla,24029,11506,11699,23205
2027,San Luis Potosí,24,San Nicolás Tolentino,24030,2772,3062,5834
2027,San Luis Potosí,24,San Vicente Tancuayalab,24034,8067,8079,16146
2027,San Luis Potosí,24,Santa Catarina,24031,6159,6502,12661
2027,San Luis Potosí,24,Santa María del Río,24032,20688,22672,43360
2027,San Luis Potosí,24,Santo Domingo,24033,6605,6628,13233
2027,San Luis Potosí,24,Soledad de Graciano Sánchez,24035,167574,176215,343789
2027,San Luis Potosí,24,Tamasopo,24036,16770,16406,33176
2027,San Luis Potosí,24,Tamazunchale,24037,51869,52984,104853
2027,San Luis Potosí,24,Tampacán,24038,8533,8384,16917
2027,San Luis Potosí,24,Tampamolón Corona,24039,8271,8483,16754
2027,San Luis Potosí,24,Tamuín,24040,21039,21552,42591
2027,San Luis Potosí,24,Tancanhuitz,24012,11031,11419,22450
2027,San Luis Potosí,24,Tanlajás,24041,10703,10510,21213
2027,San Luis Potosí,24,Tanquián de Escobedo,24042,8141,8549,16690
2027,San Luis Potosí,24,Tierra Nueva,24043,4673,5341,10014
2027,San Luis Potosí,24,Vanegas,24044,4237,4158,8395
2027,San Luis Potosí,24,Venado,24045,7868,8158,16026
2027,San Luis Potosí,24,Villa Hidalgo,24051,8151,8277,16428
2027,San Luis Potosí,24,Villa Juárez,24052,5622,5760,11382
2027,San Luis Potosí,24,Villa de Arista,24056,8236,8290,16526
2027,San Luis Potosí,24,Villa de Arriaga,24046,9628,9774,19402
2027,San Luis Potosí,24,Villa de Guadalupe,24047,5459,5448,10907
2027,San Luis Potosí,24,Villa de Ramos,24049,19590,20546,40136
2027,San Luis Potosí,24,Villa de Reyes,24050,26495,26676,53171
2027,San Luis Potosí,24,Villa de la Paz,24048,2958,2933,5891
2027,San Luis Potosí,24,Xilitla,24054,27522,28534,56056
2027,San Luis Potosí,24,Zaragoza,24055,13833,14199,28032
2027,Sinaloa,25,Ahome,25001,247689,257282,504971
2027,Sinaloa,25,Angostura,25002,27285,27159,54444
2027,Sinaloa,25,Badiraguato,25003,17413,16097,33510
2027,Sinaloa,25,Choix,25007,18514,17505,36019
2027,Sinaloa,25,Concordia,25004,15692,15287,30979
2027,Sinaloa,25,Cosalá,25005,9118,8675,17793
2027,Sinaloa,25,Culiacán,25006,491735,511860,1003595
2027,Sinaloa,25,El Fuerte,25010,57902,56798,114700
2027,Sinaloa,25,Elota,25008,31385,29124,60509
2027,Sinaloa,25,Escuinapa,25009,33546,32567,66113
2027,Sinaloa,25,Guasave,25011,165413,168341,333754
2027,Sinaloa,25,Mazatlán,25012,278337,286005,564342
2027,Sinaloa,25,Mocorito,25013,26604,25148,51752
2027,Sinaloa,25,Navolato,25018,85733,82133,167866
2027,Sinaloa,25,Rosario,25014,30875,29852,60727
2027,Sinaloa,25,Salvador Alvarado,25015,44551,46747,91298
2027,Sinaloa,25,San Ignacio,25016,12097,11183,23280
2027,Sinaloa,25,Sinaloa,25017,50896,49539,100435
2027,Sonora,26,Aconchi,26001,1748,1593,3341
2027,Sonora,26,Agua Prieta,26002,46888,46302,93190
2027,Sonora,26,Alamos,26003,15831,14822,30653
2027,Sonora,26,Altar,26004,5522,5508,11030
2027,Sonora,26,Arivechi,26005,741,709,1450
2027,Sonora,26,Arizpe,26006,1692,1607,3299
2027,Sonora,26,Atil,26007,360,344,704
2027,Sonora,26,Bacadéhuachi,26008,712,647,1359
2027,Sonora,26,Bacanora,26009,537,475,1012
2027,Sonora,26,Bacerac,26010,881,835,1716
2027,Sonora,26,Bacoachi,26011,975,969,1944
2027,Sonora,26,Banámichi,26013,1018,995,2013
2027,Sonora,26,Bavispe,26015,971,865,1836
2027,Sonora,26,Baviácora,26014,2104,1989,4093
2027,Sonora,26,Benito Juárez,26071,12930,12926,25856
2027,Sonora,26,Benjamín Hill,26016,2980,3127,6107
2027,Sonora,26,Bácum,26012,13621,13429,27050
2027,Sonora,26,Caborca,26017,49958,49181,99139
2027,Sonora,26,Cajeme,26018,247946,260609,508555
2027,Sonora,26,Cananea,26019,20237,20772,41009
2027,Sonora,26,Carbó,26020,2967,2727,5694
2027,Sonora,26,Cucurpe,26022,668,532,1200
2027,Sonora,26,Cumpas,26023,3780,3746,7526
2027,Sonora,26,Divisaderos,26024,467,455,922
2027,Sonora,26,Empalme,26025,32707,33002,65709
2027,Sonora,26,Etchojoa,26026,37588,36342,73930
2027,Sonora,26,Fronteras,26027,5060,4891,9951
2027,Sonora,26,General Plutarco Elías Calles,26070,10042,9873,19915
2027,Sonora,26,Granados,26028,663,649,1312
2027,Sonora,26,Guaymas,26029,92761,94177,186938
2027,Sonora,26,Hermosillo,26030,501034,515761,1016795
2027,Sonora,26,Huachinera,26031,817,764,1581
2027,Sonora,26,Huatabampo,26033,47255,47273,94528
2027,Sonora,26,Huásabas,26032,594,524,1118
2027,Sonora,26,Huépac,26034,624,603,1227
2027,Sonora,26,Imuris,26035,7460,7375,14835
2027,Sonora,26,La Colorada,26021,1346,1072,2418
2027,Sonora,26,Magdalena,26036,18192,18483,36675
2027,Sonora,26,Mazatán,26037,791,677,1468
2027,Sonora,26,Moctezuma,26038,2907,2997,5904
2027,Sonora,26,Naco,26039,3591,3575,7166
2027,Sonora,26,Nacozari de García,26041,7666,7570,15236
2027,Sonora,26,Navojoa,26042,93758,98183,191941
2027,Sonora,26,Nogales,26043,133843,134444,268287
2027,Sonora,26,Nácori Chico,26040,1279,1162,2441
2027,Sonora,26,Onavas,26044,298,258,556
2027,Sonora,26,Opodepe,26045,1750,1542,3292
2027,Sonora,26,Oquitoa,26046,226,255,481
2027,Sonora,26,Pitiquito,26047,5610,5277,10887
2027,Sonora,26,Puerto Peñasco,26048,39614,38395,78009
2027,Sonora,26,Quiriego,26049,1828,1579,3407
2027,Sonora,26,Rayón,26050,987,897,1884
2027,Sonora,26,Rosario,26051,3182,2912,6094
2027,Sonora,26,Sahuaripa,26052,3521,3271,6792
2027,Sonora,26,San Felipe de Jesús,26053,263,253,516
2027,Sonora,26,San Ignacio Río Muerto,26072,8727,8249,16976
2027,Sonora,26,San Javier,26054,439,329,768
2027,Sonora,26,San Luis Río Colorado,26055,111604,110447,222051
2027,Sonora,26,San Miguel de Horcasitas,26056,5726,4837,10563
2027,Sonora,26,San Pedro de la Cueva,26057,1007,872,1879
2027,Sonora,26,Santa Ana,26058,9533,9828,19361
2027,Sonora,26,Santa Cruz,26059,1065,1100,2165
2027,Sonora,26,Soyopa,26061,931,776,1707
2027,Sonora,26,Suaqui Grande,26062,737,618,1355
2027,Sonora,26,Sáric,26060,900,862,1762
2027,Sonora,26,Tepache,26063,964,881,1845
2027,Sonora,26,Trincheras,26064,1080,878,1958
2027,Sonora,26,Tubutama,26065,709,668,1377
2027,Sonora,26,Ures,26066,5487,5240,10727
2027,Sonora,26,Villa Hidalgo,26067,991,904,1895
2027,Sonora,26,Villa Pesqueira,26068,760,644,1404
2027,Sonora,26,Yécora,26069,3450,3384,6834
2027,Tabasco,27,Balancán,27001,34755,34802,69557
2027,Tabasco,27,Centla,27003,62675,63012,125687
2027,Tabasco,27,Centro,27004,386488,406435,792923
2027,Tabasco,27,Comalcalco,27005,114638,118559,233197
2027,Tabasco,27,Cunduacán,27006,77981,80541,158522
2027,Tabasco,27,Cárdenas,27002,144095,149799,293894
2027,Tabasco,27,Emiliano Zapata,27007,16915,18652,35567
2027,Tabasco,27,Huimanguillo,27008,105543,108113,213656
2027,Tabasco,27,Jalapa,27009,22324,22287,44611
2027,Tabasco,27,Jalpa de Méndez,27010,50137,50652,100789
2027,Tabasco,27,Jonuta,27011,17575,17532,35107
2027,Tabasco,27,Macuspana,27012,92567,96654,189221
2027,Tabasco,27,Nacajuca,27013,78340,81661,160001
2027,Tabasco,27,Paraíso,27014,54387,54951,109338
2027,Tabasco,27,Tacotalpa,27015,27945,27677,55622
2027,Tabasco,27,Teapa,27016,32711,34049,66760
2027,Tabasco,27,Tenosique,27017,33177,35161,68338
2027,Tamaulipas,28,Abasolo,28001,6946,6910,13856
2027,Tamaulipas,28,Aldama,28002,16589,16181,32770
2027,Tamaulipas,28,Altamira,28003,133640,135139,268779
2027,Tamaulipas,28,Antiguo Morelos,28004,5697,5638,11335
2027,Tamaulipas,28,Burgos,28005,2709,2502,5211
2027,Tamaulipas,28,Bustamante,28006,4756,4365,9121
2027,Tamaulipas,28,Camargo,28007,8625,8438,17063
2027,Tamaulipas,28,Casas,28008,2484,2225,4709
2027,Tamaulipas,28,Ciudad Madero,28009,113208,125249,238457
2027,Tamaulipas,28,Cruillas,28010,1066,1034,2100
2027,Tamaulipas,28,El Mante,28021,65489,69619,135108
2027,Tamaulipas,28,González,28012,24644,24779,49423
2027,Tamaulipas,28,Guerrero,28014,2678,2485,5163
2027,Tamaulipas,28,Gustavo Díaz Ordaz,28015,9072,8919,17991
2027,Tamaulipas,28,Gómez Farías,28011,5365,5104,10469
2027,Tamaulipas,28,Güémez,28013,9233,8513,17746
2027,Tamaulipas,28,Hidalgo,28016,13676,12970,26646
2027,Tamaulipas,28,Jaumave,28017,8910,8586,17496
2027,Tamaulipas,28,Jiménez,28018,4512,4509,9021
2027,Tamaulipas,28,Llera,28019,9986,9533,19519
2027,Tamaulipas,28,Mainero,28020,1522,1464,2986
2027,Tamaulipas,28,Matamoros,28022,278529,289267,567796
2027,Tamaulipas,28,Mier,28024,2237,2310,4547
2027,Tamaulipas,28,Miguel Alemán,28025,15233,15403,30636
2027,Tamaulipas,28,Miquihuana,28026,2156,1968,4124
2027,Tamaulipas,28,Méndez,28023,2215,2015,4230
2027,Tamaulipas,28,Nuevo Laredo,28027,217632,218904,436536
2027,Tamaulipas,28,Nuevo Morelos,28028,2102,1908,4010
2027,Tamaulipas,28,Ocampo,28029,8158,7712,15870
2027,Tamaulipas,28,Padilla,28030,8057,7932,15989
2027,Tamaulipas,28,Palmillas,28031,1033,977,2010
2027,Tamaulipas,28,Reynosa,28032,355708,358102,713810
2027,Tamaulipas,28,Río Bravo,28033,70452,70489,140941
2027,Tamaulipas,28,San Carlos,28034,5382,4865,10247
2027,Tamaulipas,28,San Fernando,28035,31269,31021,62290
2027,Tamaulipas,28,San Nicolás,28036,623,546,1169
2027,Tamaulipas,28,Soto la Marina,28037,14349,13598,27947
2027,Tamaulipas,28,Tampico,28038,170535,187303,357838
2027,Tamaulipas,28,Tula,28039,16613,16685,33298
2027,Tamaulipas,28,Valle Hermoso,28040,35054,36304,71358
2027,Tamaulipas,28,Victoria,28041,188753,198375,387128
2027,Tamaulipas,28,Villagrán,28042,3699,3473,7172
2027,Tamaulipas,28,Xicoténcatl,28043,13557,13570,27127
2027,Tlaxcala,29,Acuamanala de Miguel Hidalgo,29022,3863,3829,7692
2027,Tlaxcala,29,Altzayanca,29004,10030,9952,19982
2027,Tlaxcala,29,Amaxac de Guerrero,29001,6412,6604,13016
2027,Tlaxcala,29,Apetatitlán de Antonio Carvajal,29002,8446,9039,17485
2027,Tlaxcala,29,Apizaco,29005,43020,47325,90345
2027,Tlaxcala,29,Atlangatepec,29003,3689,3815,7504
2027,Tlaxcala,29,Benito Juárez,29045,3390,3462,6852
2027,Tlaxcala,29,Calpulalpan,29006,27007,28327,55334
2027,Tlaxcala,29,Chiautempan,29010,40564,43569,84133
2027,Tlaxcala,29,Contla de Juan Cuamatzi,29018,21741,22277,44018
2027,Tlaxcala,29,Cuapiaxtla,29008,8694,8676,17370
2027,Tlaxcala,29,Cuaxomulco,29009,3043,3091,6134
2027,Tlaxcala,29,El Carmen Tequexquitla,29007,9581,9793,19374
2027,Tlaxcala,29,Emiliano Zapata,29046,2522,2614,5136
2027,Tlaxcala,29,Españita,29012,4995,5081,10076
2027,Tlaxcala,29,Huamantla,29013,52186,54283,106469
2027,Tlaxcala,29,Hueyotlipan,29014,8275,8422,16697
2027,Tlaxcala,29,Ixtacuixtla de Mariano Matamoros,29015,22222,23306,45528
2027,Tlaxcala,29,Ixtenco,29016,4052,4395,8447
2027,Tlaxcala,29,La Magdalena Tlaltelulco,29048,10208,11017,21225
2027,Tlaxcala,29,Lázaro Cárdenas,29047,1745,1758,3503
2027,Tlaxcala,29,Mazatecochco de José María Morelos,29017,6143,6228,12371
2027,Tlaxcala,29,Muñoz de Domingo Arenas,29011,2604,2586,5190
2027,Tlaxcala,29,Nanacamilpa de Mariano Arista,29021,10211,10644,20855
2027,Tlaxcala,29,Natívitas,29023,14322,15259,29581
2027,Tlaxcala,29,Panotla,29024,15045,16170,31215
2027,Tlaxcala,29,Papalotla de Xicohténcatl,29041,16874,17984,34858
2027,Tlaxcala,29,San Damián Texóloc,29049,3282,3297,6579
2027,Tlaxcala,29,San Francisco Tetlanohcan,29050,6036,6262,12298
2027,Tlaxcala,29,San Jerónimo Zacualpan,29051,2141,2360,4501
2027,Tlaxcala,29,San José Teacalco,29052,3381,3545,6926
2027,Tlaxcala,29,San Juan Huactzinco,29053,4135,4516,8651
2027,Tlaxcala,29,San Lorenzo Axocomanitla,29054,3149,3376,6525
2027,Tlaxcala,29,San Lucas Tecopilco,29055,1770,1863,3633
2027,Tlaxcala,29,San Pablo del Monte,29025,43485,43512,86997
2027,Tlaxcala,29,Sanctórum de Lázaro Cárdenas,29020,5835,5959,11794
2027,Tlaxcala,29,Santa Ana Nopalucan,29056,4432,4577,9009
2027,Tlaxcala,29,Santa Apolonia Teacalco,29057,2542,2817,5359
2027,Tlaxcala,29,Santa Catarina Ayometla,29058,4969,5362,10331
2027,Tlaxcala,29,Santa Cruz Quilehtla,29059,4112,4110,8222
2027,Tlaxcala,29,Santa Cruz Tlaxcala,29026,11712,12098,23810
2027,Tlaxcala,29,Santa Isabel Xiloxoxtla,29060,2804,2945,5749
2027,Tlaxcala,29,Tenancingo,29027,7457,7678,15135
2027,Tlaxcala,29,Teolocholco,29028,13523,14280,27803
2027,Tlaxcala,29,Tepetitla de Lardizábal,29019,11750,12617,24367
2027,Tlaxcala,29,Tepeyanco,29029,7885,8647,16532
2027,Tlaxcala,29,Terrenate,29030,8951,8808,17759
2027,Tlaxcala,29,Tetla de la Solidaridad,29031,18353,18783,37136
2027,Tlaxcala,29,Tetlatlahuca,29032,8322,8797,17119
2027,Tlaxcala,29,Tlaxcala,29033,52478,57852,110330
2027,Tlaxcala,29,Tlaxco,29034,23903,24739,48642
2027,Tlaxcala,29,Tocatlán,29035,3322,3383,6705
2027,Tlaxcala,29,Totolac,29036,12455,13611,26066
2027,Tlaxcala,29,Tzompantepec,29038,9794,10477,20271
2027,Tlaxcala,29,Xaloztoc,29039,13784,13667,27451
2027,Tlaxcala,29,Xaltocan,29040,6207,6644,12851
2027,Tlaxcala,29,Xicohtzinco,29042,7607,8409,16016
2027,Tlaxcala,29,Yauhquemehcan,29043,21715,22993,44708
2027,Tlaxcala,29,Zacatelco,29044,24746,27006,51752
2027,Tlaxcala,29,Ziltlaltépec de Trinidad Sánchez Santos,29037,4887,5316,10203
2027,Veracruz,30,Acajete,30001,4727,4573,9300
2027,Veracruz,30,Acatlán,30002,1693,1739,3432
2027,Veracruz,30,Acayucan,30003,44986,48497,93483
2027,Veracruz,30,Actopan,30004,23819,24541,48360
2027,Veracruz,30,Acula,30005,2999,2976,5975
2027,Veracruz,30,Acultzingo,30006,11973,12385,24358
2027,Veracruz,30,Agua Dulce,30204,25572,27139,52711
2027,Veracruz,30,Alpatláhuac,30008,5373,5401,10774
2027,Veracruz,30,Alto Lucero de Gutiérrez Barrios,30009,16265,16102,32367
2027,Veracruz,30,Altotonga,30010,33520,36037,69557
2027,Veracruz,30,Alvarado,30011,29216,30159,59375
2027,Veracruz,30,Amatitlán,30012,4364,4581,8945
2027,Veracruz,30,Amatlán de los Reyes,30014,23924,25816,49740
2027,Veracruz,30,Angel R. Cabada,30015,18219,19378,37597
2027,Veracruz,30,Apazapan,30017,2243,2272,4515
2027,Veracruz,30,Aquila,30018,970,1027,1997
2027,Veracruz,30,Astacinga,30019,3174,3590,6764
2027,Veracruz,30,Atlahuilco,30020,5579,5833,11412
2027,Veracruz,30,Atoyac,30021,12673,13358,26031
2027,Veracruz,30,Atzacan,30022,11239,11590,22829
2027,Veracruz,30,Atzalan,30023,27216,27348,54564
2027,Veracruz,30,Ayahualulco,30025,14112,14314,28426
2027,Veracruz,30,Banderilla,30026,12183,13592,25775
2027,Veracruz,30,Benito Juárez,30027,9228,9821,19049
2027,Veracruz,30,Boca del Río,30028,74773,85249,160022
2027,Veracruz,30,Calcahualco,30029,6725,6779,13504
2027,Veracruz,30,Camarón de Tejeda,30007,3565,3543,7108
2027,Veracruz,30,Camerino Z. Mendoza,30030,21666,24621,46287
2027,Veracruz,30,Carlos A. Carrillo,30208,13168,14442,27610
2027,Veracruz,30,Carrillo Puerto,30031,9016,9200,18216
2027,Veracruz,30,Castillo de Teayo,30157,10909,10677,21586
2027,Veracruz,30,Catemaco,30032,25776,27578,53354
2027,Veracruz,30,Cazones de Herrera,30033,12529,13332,25861
2027,Veracruz,30,Cerro Azul,30034,14156,16015,30171
2027,Veracruz,30,Chacaltianguis,30054,6726,7102,13828
2027,Veracruz,30,Chalma,30055,7264,7561,14825
2027,Veracruz,30,Chiconamel,30056,3466,3750,7216
2027,Veracruz,30,Chiconquiaco,30057,7503,7581,15084
2027,Veracruz,30,Chicontepec,30058,29885,31677,61562
2027,Veracruz,30,Chinameca,30059,8638,9029,17667
2027,Veracruz,30,Chinampa de Gorostiza,30060,8977,9253,18230
2027,Veracruz,30,Chocamán,30062,11325,11308,22633
2027,Veracruz,30,Chontla,30063,7846,7995,15841
2027,Veracruz,30,Chumatlán,30064,2030,2163,4193
2027,Veracruz,30,Citlaltépetl,30035,6345,6683,13028
2027,Veracruz,30,Coacoatzintla,30036,5453,5691,11144
2027,Veracruz,30,Coahuitlán,30037,4422,4590,9012
2027,Veracruz,30,Coatepec,30038,48455,52677,101132
2027,Veracruz,30,Coatzacoalcos,30039,168863,180166,349029
2027,Veracruz,30,Coatzintla,30040,30305,32083,62388
2027,Veracruz,30,Coetzala,30041,1204,1240,2444
2027,Veracruz,30,Colipa,30042,2978,3090,6068
2027,Veracruz,30,Comapa,30043,11149,10639,21788
2027,Veracruz,30,Cosamaloapan de Carpio,30045,30418,33340,63758
2027,Veracruz,30,Cosautlán de Carvajal,30046,8732,8823,17555
2027,Veracruz,30,Coscomatepec,30047,30427,31372,61799
2027,Veracruz,30,Cosoleacaque,30048,71359,76210,147569
2027,Veracruz,30,Cotaxtla,30049,11361,11320,22681
2027,Veracruz,30,Coxquihui,30050,8837,9268,18105
2027,Veracruz,30,Coyutla,30051,11589,12508,24097
2027,Veracruz,30,Cuichapa,30052,6327,6933,13260
2027,Veracruz,30,Cuitláhuac,30053,14685,15983,30668
2027,Veracruz,30,Córdoba,30044,110766,125467,236233
2027,Veracruz,30,El Higo,30205,10743,10881,21624
2027,Veracruz,30,Emiliano Zapata,30065,42560,45661,88221
2027,Veracruz,30,Espinal,30066,14413,15117,29530
2027,Veracruz,30,Filomeno Mata,30067,9803,9804,19607
2027,Veracruz,30,Fortín,30068,34437,38465,72902
2027,Veracruz,30,Gutiérrez Zamora,30069,12739,14420,27159
2027,Veracruz,30,Hidalgotitlán,30070,10557,10126,20683
2027,Veracruz,30,Huatusco,30071,31450,33827,65277
2027,Veracruz,30,Huayacocotla,30072,11250,12037,23287
2027,Veracruz,30,Hueyapan de Ocampo,30073,22893,24126,47019
2027,Veracruz,30,Huiloapan de Cuauhtémoc,30074,3788,4084,7872
2027,Veracruz,30,Ignacio de la Llave,30075,9145,10069,19214
2027,Veracruz,30,Ilamatlán,30076,6950,7678,14628
2027,Veracruz,30,Isla,30077,22721,23704,46425
2027,Veracruz,30,Ixcatepec,30078,7377,7431,14808
2027,Veracruz,30,Ixhuacán de los Reyes,30079,6178,6099,12277
2027,Veracruz,30,Ixhuatlancillo,30081,13489,14727,28216
2027,Veracruz,30,Ixhuatlán de Madero,30083,28612,30277,58889
2027,Veracruz,30,Ixhuatlán del Café,30080,12256,12294,24550
2027,Veracruz,30,Ixhuatlán del Sureste,30082,8513,8398,16911
2027,Veracruz,30,Ixmatlahuacan,30084,3139,3194,6333
2027,Veracruz,30,Ixtaczoquitlán,30085,35864,38097,73961
2027,Veracruz,30,Jalacingo,30086,22853,24031,46884
2027,Veracruz,30,Jalcomulco,30088,2819,2803,5622
2027,Veracruz,30,Jamapa,30090,6091,6398,12489
2027,Veracruz,30,Jesús Carranza,30091,15842,15873,31715
2027,Veracruz,30,Jilotepec,30093,8864,9300,18164
2027,Veracruz,30,José Azueta,30169,12225,12616,24841
2027,Veracruz,30,Juan Rodríguez Clara,30094,21131,21561,42692
2027,Veracruz,30,Juchique de Ferrer,30095,8602,8670,17272
2027,Veracruz,30,Jáltipan,30089,21823,23902,45725
2027,Veracruz,30,La Antigua,30016,14157,15291,29448
2027,Veracruz,30,La Perla,30127,14322,14854,29176
2027,Veracruz,30,Landero y Coss,30096,860,913,1773
2027,Veracruz,30,Las Choapas,30061,43102,44611,87713
2027,Veracruz,30,Las Minas,30107,1612,1563,3175
2027,Veracruz,30,Las Vigas de Ramírez,30132,10502,10622,21124
2027,Veracruz,30,Lerdo de Tejada,30097,10256,11840,22096
2027,Veracruz,30,Los Reyes,30137,3117,3162,6279
2027,Veracruz,30,Magdalena,30098,1617,1646,3263
2027,Veracruz,30,Maltrata,30099,9334,9930,19264
2027,Veracruz,30,Manlio Fabio Altamirano,30100,12719,13186,25905
2027,Veracruz,30,Mariano Escobedo,30101,18679,20143,38822
2027,Veracruz,30,Martínez de la Torre,30102,54576,59541,114117
2027,Veracruz,30,Mecatlán,30103,6434,6659,13093
2027,Veracruz,30,Mecayapan,30104,8891,9231,18122
2027,Veracruz,30,Medellín,30105,42036,45620,87656
2027,Veracruz,30,Miahuatlán,30106,2479,2558,5037
2027,Veracruz,30,Minatitlán,30108,83284,88841,172125
2027,Veracruz,30,Misantla,30109,34248,35983,70231
2027,Veracruz,30,Mixtla de Altamirano,30110,6246,6144,12390
2027,Veracruz,30,Moloacán,30111,9134,9647,18781
2027,Veracruz,30,Nanchital de Lázaro Cárdenas del Rio,30206,15699,16610,32309
2027,Veracruz,30,Naolinco,30112,11579,12106,23685
2027,Veracruz,30,Naranjal,30113,2364,2536,4900
2027,Veracruz,30,Naranjos Amatlán,30013,14885,16657,31542
2027,Veracruz,30,Nautla,30114,5983,6205,12188
2027,Veracruz,30,Nogales,30115,19604,21624,41228
2027,Veracruz,30,Oluta,30116,8583,9268,17851
2027,Veracruz,30,Omealca,30117,12626,13445,26071
2027,Veracruz,30,Orizaba,30118,64347,76693,141040
2027,Veracruz,30,Otatitlán,30119,2974,3255,6229
2027,Veracruz,30,Oteapan,30120,8638,8936,17574
2027,Veracruz,30,Ozuluama de Mascareñas,30121,13059,12533,25592
2027,Veracruz,30,Pajapan,30122,9326,9232,18558
2027,Veracruz,30,Papantla,30124,84855,86435,171290
2027,Veracruz,30,Paso de Ovejas,30126,18376,18555,36931
2027,Veracruz,30,Paso del Macho,30125,16990,17306,34296
2027,Veracruz,30,Perote,30128,38829,39405,78234
2027,Veracruz,30,Platón Sánchez,30129,9737,10189,19926
2027,Veracruz,30,Playa Vicente,30130,19732,21218,40950
2027,Veracruz,30,Poza Rica de Hidalgo,30131,107253,120077,227330
2027,Veracruz,30,Pueblo Viejo,30133,31231,31386,62617
2027,Veracruz,30,Puente Nacional,30134,12230,12589,24819
2027,Veracruz,30,Pánuco,30123,54568,55044,109612
2027,Veracruz,30,Rafael Delgado,30135,12209,12690,24899
2027,Veracruz,30,Rafael Lucio,30136,4237,4490,8727
2027,Veracruz,30,Río Blanco,30138,21670,24719,46389
2027,Veracruz,30,Saltabarranca,30139,3329,3567,6896
2027,Veracruz,30,San Andrés Tenejapan,30140,1527,1603,3130
2027,Veracruz,30,San Andrés Tuxtla,30141,85420,92290,177710
2027,Veracruz,30,San Juan Evangelista,30142,18164,18767,36931
2027,Veracruz,30,San Rafael,30211,15917,16614,32531
2027,Veracruz,30,Santiago Sochiapan,30212,7133,7641,14774
2027,Veracruz,30,Santiago Tuxtla,30143,30125,32429,62554
2027,Veracruz,30,Sayula de Alemán,30144,17379,17855,35234
2027,Veracruz,30,Sochiapa,30146,1941,1951,3892
2027,Veracruz,30,Soconusco,30145,8600,9027,17627
2027,Veracruz,30,Soledad Atzompa,30147,12142,12276,24418
2027,Veracruz,30,Soledad de Doblado,30148,14948,15261,30209
2027,Veracruz,30,Soteapan,30149,17928,18508,36436
2027,Veracruz,30,Tamalín,30150,6353,6331,12684
2027,Veracruz,30,Tamiahua,30151,12932,12922,25854
2027,Veracruz,30,Tampico Alto,30152,7156,6703,13859
2027,Veracruz,30,Tancoco,30153,3083,3295,6378
2027,Veracruz,30,Tantima,30154,7277,7062,14339
2027,Veracruz,30,Tantoyuca,30155,54909,56683,111592
2027,Veracruz,30,Tatahuicapan de Juárez,30209,8332,8599,16931
2027,Veracruz,30,Tatatila,30156,3278,3028,6306
2027,Veracruz,30,Tecolutla,30158,12933,13298,26231
2027,Veracruz,30,Tehuipango,30159,13285,14097,27382
2027,Veracruz,30,Tempoal,30161,19157,19809,38966
2027,Veracruz,30,Tenampa,30162,3586,3691,7277
2027,Veracruz,30,Tenochtitlán,30163,2716,2867,5583
2027,Veracruz,30,Teocelo,30164,8766,9320,18086
2027,Veracruz,30,Tepatlaxco,30165,4677,4402,9079
2027,Veracruz,30,Tepetlán,30166,5339,5156,10495
2027,Veracruz,30,Tepetzintla,30167,7879,8129,16008
2027,Veracruz,30,Tequila,30168,7937,8219,16156
2027,Veracruz,30,Texcatepec,30170,5714,5957,11671
2027,Veracruz,30,Texhuacán,30171,2716,2999,5715
2027,Veracruz,30,Texistepec,30172,11329,11240,22569
2027,Veracruz,30,Tezonapa,30173,30486,31171,61657
2027,Veracruz,30,Tierra Blanca,30174,55920,60179,116099
2027,Veracruz,30,Tihuatlán,30175,51179,53332,104511
2027,Veracruz,30,Tlachichilco,30180,6178,6359,12537
2027,Veracruz,30,Tlacojalpan,30176,2661,2768,5429
2027,Veracruz,30,Tlacolulan,30177,6093,5893,11986
2027,Veracruz,30,Tlacotalpan,30178,7074,7785,14859
2027,Veracruz,30,Tlacotepec de Mejía,30179,2118,2159,4277
2027,Veracruz,30,Tlalixcoyan,30181,20582,21293,41875
2027,Veracruz,30,Tlalnelhuayocan,30182,9871,10210,20081
2027,Veracruz,30,Tlaltetela,30024,8490,8236,16726
2027,Veracruz,30,Tlapacoyan,30183,32420,34359,66779
2027,Veracruz,30,Tlaquilpa,30184,3793,4326,8119
2027,Veracruz,30,Tlilapan,30185,2755,2909,5664
2027,Veracruz,30,Tomatlán,30186,3731,3835,7566
2027,Veracruz,30,Tonayán,30187,2925,3119,6044
2027,Veracruz,30,Totutla,30188,9392,9448,18840
2027,Veracruz,30,Tres Valles,30207,24569,25829,50398
2027,Veracruz,30,Tuxpan,30189,85838,90799,176637
2027,Veracruz,30,Tuxtilla,30190,1233,1270,2503
2027,Veracruz,30,Ursulo Galván,30191,16605,17596,34201
2027,Veracruz,30,Uxpanapa,30210,15860,15304,31164
2027,Veracruz,30,Vega de Alatorre,30192,10775,11479,22254
2027,Veracruz,30,Veracruz,30193,308908,338389,647297
2027,Veracruz,30,Villa Aldama,30194,6184,6367,12551
2027,Veracruz,30,Xalapa,30087,247117,280142,527259
2027,Veracruz,30,Xico,30092,20393,21065,41458
2027,Veracruz,30,Xoxocotla,30195,2938,2831,5769
2027,Veracruz,30,Yanga,30196,9333,10537,19870
2027,Veracruz,30,Yecuatla,30197,6499,6674,13173
2027,Veracruz,30,Zacualpan,30198,3793,4073,7866
2027,Veracruz,30,Zaragoza,30199,5876,6105,11981
2027,Veracruz,30,Zentla,30200,7370,7219,14589
2027,Veracruz,30,Zongolica,30201,23076,23583,46659
2027,Veracruz,30,Zontecomatlán de López y Fuentes,30202,7624,7886,15510
2027,Veracruz,30,Zozocolco de Hidalgo,30203,7976,8330,16306
2027,Veracruz,30,Álamo Temapache,30160,56775,57491,114266
2027,Yucatán,31,Abalá,31001,3840,3665,7505
2027,Yucatán,31,Acanceh,31002,9302,9291,18593
2027,Yucatán,31,Akil,31003,6146,6391,12537
2027,Yucatán,31,Baca,31004,3453,3547,7000
2027,Yucatán,31,Bokobá,31005,1300,1254,2554
2027,Yucatán,31,Buctzotz,31006,5152,5137,10289
2027,Yucatán,31,Cacalchén,31007,4310,4089,8399
2027,Yucatán,31,Calotmul,31008,2353,2350,4703
2027,Yucatán,31,Cansahcab,31009,2696,2766,5462
2027,Yucatán,31,Cantamayec,31010,1486,1364,2850
2027,Yucatán,31,Celestún,31011,4512,4267,8779
2027,Yucatán,31,Cenotillo,31012,2242,2382,4624
2027,Yucatán,31,Chacsinkín,31016,1707,1667,3374
2027,Yucatán,31,Chankom,31017,2656,2563,5219
2027,Yucatán,31,Chapab,31018,1836,1824,3660
2027,Yucatán,31,Chemax,31019,20547,20217,40764
2027,Yucatán,31,Chichimilá,31021,4757,4694,9451
2027,Yucatán,31,Chicxulub Pueblo,31020,2653,2526,5179
2027,Yucatán,31,Chikindzonot,31022,2356,2291,4647
2027,Yucatán,31,Chocholá,31023,2778,2696,5474
2027,Yucatán,31,Chumayel,31024,1852,1900,3752
2027,Yucatán,31,Conkal,31013,6470,6466,12936
2027,Yucatán,31,Cuncunul,31014,939,906,1845
2027,Yucatán,31,Cuzamá,31015,2986,2905,5891
2027,Yucatán,31,Dzemul,31026,2193,2187,4380
2027,Yucatán,31,Dzidzantún,31027,4873,4758,9631
2027,Yucatán,31,Dzilam González,31029,3633,3445,7078
2027,Yucatán,31,Dzilam de Bravo,31028,1613,1511,3124
2027,Yucatán,31,Dzitás,31030,2238,2139,4377
2027,Yucatán,31,Dzoncauich,31031,1520,1553,3073
2027,Yucatán,31,Dzán,31025,2983,3097,6080
2027,Yucatán,31,Espita,31032,9322,9081,18403
2027,Yucatán,31,Halachó,31033,11717,11459,23176
2027,Yucatán,31,Hocabá,31034,3557,3553,7110
2027,Yucatán,31,Hoctún,31035,3395,3474,6869
2027,Yucatán,31,Homún,31036,4482,4310,8792
2027,Yucatán,31,Huhí,31037,3068,2954,6022
2027,Yucatán,31,Hunucmá,31038,18504,18608,37112
2027,Yucatán,31,Ixil,31039,2381,2308,4689
2027,Yucatán,31,Izamal,31040,15411,15756,31167
2027,Yucatán,31,Kanasín,31041,58023,58907,116930
2027,Yucatán,31,Kantunil,31042,3028,3187,6215
2027,Yucatán,31,Kaua,31043,1779,1717,3496
2027,Yucatán,31,Kinchil,31044,4140,4046,8186
2027,Yucatán,31,Kopomá,31045,1521,1439,2960
2027,Yucatán,31,Mama,31046,1738,1890,3628
2027,Yucatán,31,Maní,31047,3156,3290,6446
2027,Yucatán,31,Maxcanú,31048,13085,12893,25978
2027,Yucatán,31,Mayapán,31049,2127,1973,4100
2027,Yucatán,31,Mocochá,31051,1927,1889,3816
2027,Yucatán,31,Motul,31052,20863,21250,42113
2027,Yucatán,31,Muna,31053,7167,7417,14584
2027,Yucatán,31,Muxupip,31054,1629,1698,3327
2027,Yucatán,31,Mérida,31050,498642,541364,1040006
2027,Yucatán,31,Opichén,31055,3937,3800,7737
2027,Yucatán,31,Oxkutzcab,31056,16908,18360,35268
2027,Yucatán,31,Panabá,31057,4420,4458,8878
2027,Yucatán,31,Peto,31058,14259,14463,28722
2027,Yucatán,31,Progreso,31059,33596,34070,67666
2027,Yucatán,31,Quintana Roo,31060,563,560,1123
2027,Yucatán,31,Río Lagartos,31061,2105,1987,4092
2027,Yucatán,31,Sacalum,31062,2819,2690,5509
2027,Yucatán,31,Samahil,31063,2969,2944,5913
2027,Yucatán,31,San Felipe,31065,1145,1077,2222
2027,Yucatán,31,Sanahcat,31064,1000,989,1989
2027,Yucatán,31,Santa Elena,31066,2217,2314,4531
2027,Yucatán,31,Seyé,31067,5635,5382,11017
2027,Yucatán,31,Sinanché,31068,1929,1781,3710
2027,Yucatán,31,Sotuta,31069,5183,5002,10185
2027,Yucatán,31,Sucilá,31070,2309,2226,4535
2027,Yucatán,31,Sudzal,31071,1031,928,1959
2027,Yucatán,31,Suma,31072,1101,1076,2177
2027,Yucatán,31,Tahdziú,31073,2895,2730,5625
2027,Yucatán,31,Tahmek,31074,2232,2164,4396
2027,Yucatán,31,Teabo,31075,3741,3752,7493
2027,Yucatán,31,Tecoh,31076,10098,10040,20138
2027,Yucatán,31,Tekal de Venegas,31077,1559,1514,3073
2027,Yucatán,31,Tekantó,31078,2204,2222,4426
2027,Yucatán,31,Tekax,31079,23751,24534,48285
2027,Yucatán,31,Tekit,31080,5889,5729,11618
2027,Yucatán,31,Tekom,31081,1810,1852,3662
2027,Yucatán,31,Telchac Pueblo,31082,2251,2240,4491
2027,Yucatán,31,Telchac Puerto,31083,1070,974,2044
2027,Yucatán,31,Temax,31084,4225,4210,8435
2027,Yucatán,31,Temozón,31085,8891,8657,17548
2027,Yucatán,31,Tepakán,31086,1338,1286,2624
2027,Yucatán,31,Tetiz,31087,2882,2878,5760
2027,Yucatán,31,Teya,31088,1138,1148,2286
2027,Yucatán,31,Ticul,31089,22544,23248,45792
2027,Yucatán,31,Timucuy,31090,4275,4112,8387
2027,Yucatán,31,Tinum,31091,6883,6667,13550
2027,Yucatán,31,Tixcacalcupul,31092,4044,3992,8036
2027,Yucatán,31,Tixkokob,31093,10353,10568,20921
2027,Yucatán,31,Tixmehuac,31094,2767,2764,5531
2027,Yucatán,31,Tixpéhual,31095,3148,3267,6415
2027,Yucatán,31,Tizimín,31096,43452,44758,88210
2027,Yucatán,31,Tunkás,31097,2090,1998,4088
2027,Yucatán,31,Tzucacab,31098,8405,8259,16664
2027,Yucatán,31,Uayma,31099,2387,2292,4679
2027,Yucatán,31,Ucú,31100,2147,2112,4259
2027,Yucatán,31,Umán,31101,30599,30601,61200
2027,Yucatán,31,Valladolid,31102,45148,46012,91160
2027,Yucatán,31,Xocchel,31103,2052,1976,4028
2027,Yucatán,31,Yaxcabá,31104,8915,8399,17314
2027,Yucatán,31,Yaxkukul,31105,1817,1836,3653
2027,Yucatán,31,Yobaín,31106,1360,1307,2667
2027,Zacatecas,32,Apozol,32001,3229,3462,6691
2027,Zacatecas,32,Apulco,32002,2528,2788,5316
2027,Zacatecas,32,Atolinga,32003,1366,1475,2841
2027,Zacatecas,32,Benito Juárez,32004,2279,2228,4507
2027,Zacatecas,32,Calera,32005,24310,24287,48597
2027,Zacatecas,32,Cañitas de Felipe Pescador,32006,4483,4590,9073
2027,Zacatecas,32,Chalchihuites,32009,6164,6486,12650
2027,Zacatecas,32,Concepción del Oro,32007,7439,7340,14779
2027,Zacatecas,32,Cuauhtémoc,32008,6664,7033,13697
2027,Zacatecas,32,El Plateado de Joaquín Amaro,32015,686,715,1401
2027,Zacatecas,32,El Salvador,32041,1335,1302,2637
2027,Zacatecas,32,Fresnillo,32010,124360,128085,252445
2027,Zacatecas,32,Genaro Codina,32012,4354,4541,8895
2027,Zacatecas,32,General Enrique Estrada,32013,3401,3461,6862
2027,Zacatecas,32,General Francisco R. Murguía,32014,11661,12314,23975
2027,Zacatecas,32,General Pánfilo Natera,32016,12362,12851,25213
2027,Zacatecas,32,Guadalupe,32017,101543,106613,208156
2027,Zacatecas,32,Huanusco,32018,2217,2332,4549
2027,Zacatecas,32,Jalpa,32019,13028,13659,26687
2027,Zacatecas,32,Jerez,32020,32346,34523,66869
2027,Zacatecas,32,Jiménez del Teul,32021,2262,2318,4580
2027,Zacatecas,32,Juan Aldama,32022,11590,12270,23860
2027,Zacatecas,32,Juchipila,32023,6705,7520,14225
2027,Zacatecas,32,Loreto,32024,29128,29578,58706
2027,Zacatecas,32,Luis Moya,32025,7274,7351,14625
2027,Zacatecas,32,Mazapil,32026,10241,9372,19613
2027,Zacatecas,32,Melchor Ocampo,32027,1783,1560,3343
2027,Zacatecas,32,Mezquital del Oro,32028,1327,1439,2766
2027,Zacatecas,32,Miguel Auza,32029,12637,13164,25801
2027,Zacatecas,32,Momax,32030,1296,1406,2702
2027,Zacatecas,32,Monte Escobedo,32031,5127,5292,10419
2027,Zacatecas,32,Morelos,32032,6794,6858,13652
2027,Zacatecas,32,Moyahua de Estrada,32033,2101,2413,4514
2027,Zacatecas,32,Nochistlán de Mejía,32034,14777,16339,31116
2027,Zacatecas,32,Noria de Ángeles,32035,9073,9325,18398
2027,Zacatecas,32,Ojocaliente,32036,22904,23852,46756
2027,Zacatecas,32,Pinos,32038,38982,40761,79743
2027,Zacatecas,32,Pánuco,32037,9763,9729,19492
2027,Zacatecas,32,Río Grande,32039,34234,36317,70551
2027,Zacatecas,32,Sain Alto,32040,11855,12464,24319
2027,Zacatecas,32,Santa María de la Paz,32058,1456,1497,2953
2027,Zacatecas,32,Sombrerete,32042,33598,34623,68221
2027,Zacatecas,32,Susticacán,32043,733,806,1539
2027,Zacatecas,32,Tabasco,32044,8307,8776,17083
2027,Zacatecas,32,Tepechitlán,32045,4655,5100,9755
2027,Zacatecas,32,Tepetongo,32046,3936,4219,8155
2027,Zacatecas,32,Teúl de González Ortega,32047,2646,2805,5451
2027,Zacatecas,32,Tlaltenango de Sánchez Román,32048,14402,15113,29515
2027,Zacatecas,32,Trancoso,32057,10415,10670,21085
2027,Zacatecas,32,Trinidad García de la Cadena,32011,1567,1642,3209
2027,Zacatecas,32,Valparaíso,32049,18151,18818,36969
2027,Zacatecas,32,Vetagrande,32050,5404,5532,10936
2027,Zacatecas,32,Villa García,32052,10363,10500,20863
2027,Zacatecas,32,Villa González Ortega,32053,7070,7467,14537
2027,Zacatecas,32,Villa Hidalgo,32054,10349,10486,20835
2027,Zacatecas,32,Villa de Cos,32051,19480,19183,38663
2027,Zacatecas,32,Villanueva,32055,16463,17217,33680
2027,Zacatecas,32,Zacatecas,32056,78316,83441,161757
2028,Aguascalientes,01,Aguascalientes,01001,518378,540521,1058899
2028,Aguascalientes,01,Asientos,01002,27634,27753,55387
2028,Aguascalientes,01,Calvillo,01003,33250,34354,67604
2028,Aguascalientes,01,Cosío,01004,9076,9314,18390
2028,Aguascalientes,01,El Llano,01010,12131,11823,23954
2028,Aguascalientes,01,Jesús María,01005,71121,70052,141173
2028,Aguascalientes,01,Pabellón de Arteaga,01006,26495,27670,54165
2028,Aguascalientes,01,Rincón de Romos,01007,31352,31574,62926
2028,Aguascalientes,01,San Francisco de los Romo,01011,27765,27760,55525
2028,Aguascalientes,01,San José de Gracia,01008,5182,5437,10619
2028,Aguascalientes,01,Tepezalá,01009,12393,12622,25015
2028,Baja California,02,Ensenada,02001,298525,300581,599106
2028,Baja California,02,Mexicali,02002,610540,617918,1228458
2028,Baja California,02,Playas de Rosarito,02005,60134,59798,119932
2028,Baja California,02,Tecate,02003,64561,61872,126433
2028,Baja California,02,Tijuana,02004,981343,991471,1972814
2028,Baja California Sur,03,Comondú,03001,49963,48842,98805
2028,Baja California Sur,03,La Paz,03003,173803,176847,350650
2028,Baja California Sur,03,Loreto,03009,13246,12221,25467
2028,Baja California Sur,03,Los Cabos,03008,193300,182551,375851
2028,Baja California Sur,03,Mulegé,03002,39968,37464,77432
2028,Campeche,04,Calakmul,04010,17819,17013,34832
2028,Campeche,04,Calkiní,04001,35039,36370,71409
2028,Campeche,04,Campeche,04002,172672,186402,359074
2028,Campeche,04,Candelaria,04011,27734,26760,54494
2028,Campeche,04,Carmen,04003,153729,154623,308352
2028,Campeche,04,Champotón,04004,57212,56325,113537
2028,Campeche,04,Escárcega,04009,35394,35746,71140
2028,Campeche,04,Hecelchakán,04005,19368,19510,38878
2028,Campeche,04,Hopelchén,04006,25635,24395,50030
2028,Campeche,04,Palizada,04007,5652,5525,11177
2028,Campeche,04,Tenabo,04008,6857,6534,13391
2028,Chiapas,07,Acacoyagua,07001,11116,10970,22086
2028,Chiapas,07,Acala,07002,19108,19588,38696
2028,Chiapas,07,Acapetahua,07003,17546,17493,35039
2028,Chiapas,07,Aldama,07113,3790,4126,7916
2028,Chiapas,07,Altamirano,07004,19802,19661,39463
2028,Chiapas,07,Amatenango de la Frontera,07006,18417,19361,37778
2028,Chiapas,07,Amatenango del Valle,07007,5657,6176,11833
2028,Chiapas,07,Amatán,07005,12025,11671,23696
2028,Chiapas,07,Angel Albino Corzo,07008,16990,17104,34094
2028,Chiapas,07,Arriaga,07009,24116,26002,50118
2028,Chiapas,07,Bejucal de Ocampo,07010,4630,4605,9235
2028,Chiapas,07,Bella Vista,07011,12280,12350,24630
2028,Chiapas,07,Benemérito de las Américas,07114,12341,12064,24405
2028,Chiapas,07,Berriozábal,07012,31524,31981,63505
2028,Chiapas,07,Bochil,07013,20563,21072,41635
2028,Chiapas,07,Cacahoatán,07015,27527,28934,56461
2028,Chiapas,07,Catazajá,07016,10834,10741,21575
2028,Chiapas,07,Chalchihuitán,07022,9637,9810,19447
2028,Chiapas,07,Chamula,07023,48215,56721,104936
2028,Chiapas,07,Chanal,07024,7288,7339,14627
2028,Chiapas,07,Chapultenango,07025,4560,4543,9103
2028,Chiapas,07,Chenalhó,07026,23706,24239,47945
2028,Chiapas,07,Chiapa de Corzo,07027,60868,63502,124370
2028,Chiapas,07,Chiapilla,07028,3652,3544,7196
2028,Chiapas,07,Chicoasén,07029,3075,3096,6171
2028,Chiapas,07,Chicomuselo,07030,21279,21498,42777
2028,Chiapas,07,Chilón,07031,75769,77581,153350
2028,Chiapas,07,Cintalapa,07017,51926,53099,105025
2028,Chiapas,07,Coapilla,07018,5468,5626,11094
2028,Chiapas,07,Comitán de Domínguez,07019,90101,99533,189634
2028,Chiapas,07,Copainalá,07021,13042,13681,26723
2028,Chiapas,07,El Bosque,07014,13048,13947,26995
2028,Chiapas,07,El Porvenir,07070,8528,8643,17171
2028,Chiapas,07,Escuintla,07032,19105,19622,38727
2028,Chiapas,07,Francisco León,07033,4602,4429,9031
2028,Chiapas,07,Frontera Comalapa,07034,43981,46206,90187
2028,Chiapas,07,Frontera Hidalgo,07035,8620,9110,17730
2028,Chiapas,07,Huehuetán,07037,20891,21997,42888
2028,Chiapas,07,Huitiupán,07039,13831,13667,27498
2028,Chiapas,07,Huixtla,07040,32054,34554,66608
2028,Chiapas,07,Huixtán,07038,14003,14565,28568
2028,Chiapas,07,Ixhuatán,07042,6756,6903,13659
2028,Chiapas,07,Ixtacomitán,07043,6447,6576,13023
2028,Chiapas,07,Ixtapa,07044,16209,16483,32692
2028,Chiapas,07,Ixtapangajoya,07045,3371,3290,6661
2028,Chiapas,07,Jiquipilas,07046,24200,25137,49337
2028,Chiapas,07,Jitotol,07047,12474,12212,24686
2028,Chiapas,07,Juárez,07048,13115,13513,26628
2028,Chiapas,07,La Concordia,07020,28304,27848,56152
2028,Chiapas,07,La Grandeza,07036,4266,4392,8658
2028,Chiapas,07,La Independencia,07041,27018,28041,55059
2028,Chiapas,07,La Libertad,07050,3015,3126,6141
2028,Chiapas,07,La Trinitaria,07099,47134,49249,96383
2028,Chiapas,07,Larráinzar,07049,13875,14398,28273
2028,Chiapas,07,Las Margaritas,07052,74122,75528,149650
2028,Chiapas,07,Las Rosas,07075,16806,17297,34103
2028,Chiapas,07,Mapastepec,07051,28736,29635,58371
2028,Chiapas,07,Maravilla Tenejapa,07115,7760,7537,15297
2028,Chiapas,07,Marqués de Comillas,07116,7066,6858,13924
2028,Chiapas,07,Mazapa de Madero,07053,4731,4928,9659
2028,Chiapas,07,Mazatán,07054,17683,18314,35997
2028,Chiapas,07,Metapa,07055,3333,3625,6958
2028,Chiapas,07,Mitontic,07056,7126,7205,14331
2028,Chiapas,07,Montecristo de Guerrero,07117,4558,4476,9034
2028,Chiapas,07,Motozintla,07057,43428,45063,88491
2028,Chiapas,07,Nicolás Ruíz,07058,2647,2503,5150
2028,Chiapas,07,Ocosingo,07059,130290,131324,261614
2028,Chiapas,07,Ocotepec,07060,7280,7648,14928
2028,Chiapas,07,Ocozocoautla de Espinosa,07061,54578,56254,110832
2028,Chiapas,07,Ostuacán,07062,11225,11073,22298
2028,Chiapas,07,Osumacinta,07063,2257,2261,4518
2028,Chiapas,07,Oxchuc,07064,28389,28244,56633
2028,Chiapas,07,Palenque,07065,71184,73311,144495
2028,Chiapas,07,Pantelhó,07066,12921,13152,26073
2028,Chiapas,07,Pantepec,07067,7297,7445,14742
2028,Chiapas,07,Pichucalco,07068,18990,19540,38530
2028,Chiapas,07,Pijijiapan,07069,32429,33343,65772
2028,Chiapas,07,Pueblo Nuevo Solistahuacán,07072,18159,19825,37984
2028,Chiapas,07,Rayón,07073,5731,5860,11591
2028,Chiapas,07,Reforma,07074,27462,27915,55377
2028,Chiapas,07,Sabanilla,07076,16149,16001,32150
2028,Chiapas,07,Salto de Agua,07077,37735,38211,75946
2028,Chiapas,07,San Andrés Duraznal,07118,3255,3430,6685
2028,Chiapas,07,San Cristóbal de las Casas,07078,120149,134513,254662
2028,Chiapas,07,San Fernando,07079,24246,23750,47996
2028,Chiapas,07,San Juan Cancuc,07112,20373,21284,41657
2028,Chiapas,07,San Lucas,07110,4335,4362,8697
2028,Chiapas,07,Santiago el Pinar,07119,2158,2110,4268
2028,Chiapas,07,Siltepec,07080,21972,21237,43209
2028,Chiapas,07,Simojovel,07081,26132,26657,52789
2028,Chiapas,07,Sitalá,07082,8435,8556,16991
2028,Chiapas,07,Socoltenango,07083,11152,11194,22346
2028,Chiapas,07,Solosuchiapa,07084,4859,4803,9662
2028,Chiapas,07,Soyaló,07085,6512,6478,12990
2028,Chiapas,07,Suchiapa,07086,14727,14798,29525
2028,Chiapas,07,Suchiate,07087,22876,23970,46846
2028,Chiapas,07,Sunuapa,07088,1461,1445,2906
2028,Chiapas,07,Tapachula,07089,205313,225894,431207
2028,Chiapas,07,Tapalapa,07090,2345,2478,4823
2028,Chiapas,07,Tapilula,07091,7700,8143,15843
2028,Chiapas,07,Tecpatán,07092,25148,25467,50615
2028,Chiapas,07,Tenejapa,07093,25146,26667,51813
2028,Chiapas,07,Teopisca,07094,25090,26615,51705
2028,Chiapas,07,Tila,07096,47209,47256,94465
2028,Chiapas,07,Tonalá,07097,54138,55947,110085
2028,Chiapas,07,Totolapa,07098,4374,4330,8704
2028,Chiapas,07,Tumbalá,07100,20067,21179,41246
2028,Chiapas,07,Tuxtla Chico,07102,25171,26877,52048
2028,Chiapas,07,Tuxtla Gutiérrez,07101,348232,387783,736015
2028,Chiapas,07,Tuzantán,07103,19448,20001,39449
2028,Chiapas,07,Tzimol,07104,9239,9683,18922
2028,Chiapas,07,Unión Juárez,07105,9288,9785,19073
2028,Chiapas,07,Venustiano Carranza,07106,39157,39636,78793
2028,Chiapas,07,Villa Comaltitlán,07071,17451,17800,35251
2028,Chiapas,07,Villa Corzo,07107,46913,48549,95462
2028,Chiapas,07,Villaflores,07108,63181,66308,129489
2028,Chiapas,07,Yajalón,07109,22446,23587,46033
2028,Chiapas,07,Zinacantán,07111,22892,26213,49105
2028,Chihuahua,08,Ahumada,08001,7038,6882,13920
2028,Chihuahua,08,Aldama,08002,14106,14226,28332
2028,Chihuahua,08,Allende,08003,5414,5290,10704
2028,Chihuahua,08,Aquiles Serdán,08004,10205,9956,20161
2028,Chihuahua,08,Ascensión,08005,14065,13753,27818
2028,Chihuahua,08,Bachíniva,08006,3953,3801,7754
2028,Chihuahua,08,Balleza,08007,9587,9290,18877
2028,Chihuahua,08,Batopilas,08008,6640,6639,13279
2028,Chihuahua,08,Bocoyna,08009,15374,16049,31423
2028,Chihuahua,08,Buenaventura,08010,13567,13229,26796
2028,Chihuahua,08,Camargo,08011,29596,30736,60332
2028,Chihuahua,08,Carichí,08012,5683,5512,11195
2028,Chihuahua,08,Casas Grandes,08013,6900,6551,13451
2028,Chihuahua,08,Chihuahua,08019,494274,525246,1019520
2028,Chihuahua,08,Chínipas,08020,4771,4327,9098
2028,Chihuahua,08,Coronado,08014,1416,1303,2719
2028,Chihuahua,08,Coyame del Sotol,08015,1158,943,2101
2028,Chihuahua,08,Cuauhtémoc,08017,94532,101020,195552
2028,Chihuahua,08,Cusihuiriachi,08018,2989,2755,5744
2028,Chihuahua,08,Delicias,08021,84391,89171,173562
2028,Chihuahua,08,Dr. Belisario Domínguez,08022,1759,1691,3450
2028,Chihuahua,08,El Tule,08064,1078,1032,2110
2028,Chihuahua,08,Galeana,08023,3726,3731,7457
2028,Chihuahua,08,Gran Morelos,08026,1702,1642,3344
2028,Chihuahua,08,Guachochi,08027,25455,26682,52137
2028,Chihuahua,08,Guadalupe,08028,2486,2505,4991
2028,Chihuahua,08,Guadalupe y Calvo,08029,30653,30024,60677
2028,Chihuahua,08,Guazapares,08030,4772,4562,9334
2028,Chihuahua,08,Guerrero,08031,23600,23183,46783
2028,Chihuahua,08,Gómez Farías,08025,5448,5400,10848
2028,Chihuahua,08,Hidalgo del Parral,08032,61278,65629,126907
2028,Chihuahua,08,Huejotitán,08033,627,628,1255
2028,Chihuahua,08,Ignacio Zaragoza,08034,4310,4208,8518
2028,Chihuahua,08,Janos,08035,6722,6146,12868
2028,Chihuahua,08,Jiménez,08036,24463,24957,49420
2028,Chihuahua,08,Julimes,08038,2799,2714,5513
2028,Chihuahua,08,Juárez,08037,761637,766673,1528310
2028,Chihuahua,08,La Cruz,08016,2407,2284,4691
2028,Chihuahua,08,López,08039,2554,2360,4914
2028,Chihuahua,08,Madera,08040,17035,16814,33849
2028,Chihuahua,08,Maguarichi,08041,933,876,1809
2028,Chihuahua,08,Manuel Benavides,08042,999,845,1844
2028,Chihuahua,08,Matachí,08043,1899,1887,3786
2028,Chihuahua,08,Matamoros,08044,2785,2671,5456
2028,Chihuahua,08,Meoqui,08045,25802,26381,52183
2028,Chihuahua,08,Morelos,08046,4338,4264,8602
2028,Chihuahua,08,Moris,08047,3075,2891,5966
2028,Chihuahua,08,Namiquipa,08048,14979,14300,29279
2028,Chihuahua,08,Nonoava,08049,1635,1541,3176
2028,Chihuahua,08,Nuevo Casas Grandes,08050,35438,37125,72563
2028,Chihuahua,08,Ocampo,08051,4441,4135,8576
2028,Chihuahua,08,Ojinaga,08052,16558,16346,32904
2028,Chihuahua,08,Praxedis G. Guerrero,08053,2787,2717,5504
2028,Chihuahua,08,Riva Palacio,08054,4594,4405,8999
2028,Chihuahua,08,Rosales,08055,10106,9949,20055
2028,Chihuahua,08,Rosario,08056,1305,1231,2536
2028,Chihuahua,08,San Francisco de Borja,08057,1498,1404,2902
2028,Chihuahua,08,San Francisco de Conchos,08058,1646,1549,3195
2028,Chihuahua,08,San Francisco del Oro,08059,3236,3233,6469
2028,Chihuahua,08,Santa Bárbara,08060,6485,6630,13115
2028,Chihuahua,08,Santa Isabel,08024,2426,2469,4895
2028,Chihuahua,08,Satevó,08061,2063,1934,3997
2028,Chihuahua,08,Saucillo,08062,18840,18686,37526
2028,Chihuahua,08,Temósachic,08063,4099,3916,8015
2028,Chihuahua,08,Urique,08065,12094,11694,23788
2028,Chihuahua,08,Uruachi,08066,3396,3207,6603
2028,Chihuahua,08,Valle de Zaragoza,08067,3356,3193,6549
2028,Ciudad de México,09,Azcapotzalco,09002,190956,216687,407643
2028,Ciudad de México,09,Benito Juárez,09014,203160,241241,444401
2028,Ciudad de México,09,Coyoacán,09003,289835,330448,620283
2028,Ciudad de México,09,Cuajimalpa de Morelos,09004,92196,98641,190837
2028,Ciudad de México,09,Cuauhtémoc,09015,259253,289732,548985
2028,Ciudad de México,09,Gustavo A. Madero,09005,556346,606084,1162430
2028,Ciudad de México,09,Iztacalco,09006,185112,206577,391689
2028,Ciudad de México,09,Iztapalapa,09007,844500,897400,1741900
2028,Ciudad de México,09,La Magdalena Contreras,09008,114291,123340,237631
2028,Ciudad de México,09,Miguel Hidalgo,09016,176017,206216,382233
2028,Ciudad de México,09,Milpa Alta,09009,64494,67131,131625
2028,Ciudad de México,09,Tlalpan,09012,316794,345938,662732
2028,Ciudad de México,09,Tláhuac,09011,167302,179501,346803
2028,Ciudad de México,09,Venustiano Carranza,09017,202822,230085,432907
2028,Ciudad de México,09,Xochimilco,09013,194459,203928,398387
2028,Ciudad de México,09,Álvaro Obregón,09010,352233,386747,738980
2028,Coahuila,05,Abasolo,05001,667,654,1321
2028,Coahuila,05,Acuña,05002,87320,86512,173832
2028,Coahuila,05,Allende,05003,13446,13762,27208
2028,Coahuila,05,Arteaga,05004,14513,13802,28315
2028,Coahuila,05,Candela,05005,1162,1057,2219
2028,Coahuila,05,Castaños,05006,16960,16869,33829
2028,Coahuila,05,Cuatro Ciénegas,05007,8232,8053,16285
2028,Coahuila,05,Escobedo,05008,1930,1834,3764
2028,Coahuila,05,Francisco I. Madero,05009,35886,35922,71808
2028,Coahuila,05,Frontera,05010,48672,48219,96891
2028,Coahuila,05,General Cepeda,05011,7967,7267,15234
2028,Coahuila,05,Guerrero,05012,1173,1039,2212
2028,Coahuila,05,Hidalgo,05013,1039,991,2030
2028,Coahuila,05,Jiménez,05014,6155,5920,12075
2028,Coahuila,05,Juárez,05015,1015,919,1934
2028,Coahuila,05,Lamadrid,05016,1176,1107,2283
2028,Coahuila,05,Matamoros,05017,65776,65444,131220
2028,Coahuila,05,Monclova,05018,138019,140429,278448
2028,Coahuila,05,Morelos,05019,5309,5180,10489
2028,Coahuila,05,Múzquiz,05020,42680,41803,84483
2028,Coahuila,05,Nadadores,05021,4031,3950,7981
2028,Coahuila,05,Nava,05022,18443,17450,35893
2028,Coahuila,05,Ocampo,05023,6532,5990,12522
2028,Coahuila,05,Parras,05024,27376,26165,53541
2028,Coahuila,05,Piedras Negras,05025,96560,95891,192451
2028,Coahuila,05,Progreso,05026,2135,1982,4117
2028,Coahuila,05,Ramos Arizpe,05027,57845,55346,113191
2028,Coahuila,05,Sabinas,05028,38606,38481,77087
2028,Coahuila,05,Sacramento,05029,1486,1432,2918
2028,Coahuila,05,Saltillo,05030,474099,477951,952050
2028,Coahuila,05,San Buenaventura,05031,14479,14471,28950
2028,Coahuila,05,San Juan de Sabinas,05032,26002,27238,53240
2028,Coahuila,05,San Pedro,05033,65659,65765,131424
2028,Coahuila,05,Sierra Mojada,05034,4667,4264,8931
2028,Coahuila,05,Torreón,05035,401049,421673,822722
2028,Coahuila,05,Viesca,05036,13600,13014,26614
2028,Coahuila,05,Villa Unión,05037,3899,3695,7594
2028,Coahuila,05,Zaragoza,05038,7870,7795,15665
2028,Colima,06,Armería,06001,18554,18096,36650
2028,Colima,06,Colima,06002,93193,98474,191667
2028,Colima,06,Comala,06003,13511,13295,26806
2028,Colima,06,Coquimatlán,06004,12636,12256,24892
2028,Colima,06,Cuauhtémoc,06005,18847,18487,37334
2028,Colima,06,Ixtlahuacán,06006,3529,3423,6952
2028,Colima,06,Manzanillo,06007,114374,111032,225406
2028,Colima,06,Minatitlán,06008,5742,5210,10952
2028,Colima,06,Tecomán,06009,75725,73802,149527
2028,Colima,06,Villa de Álvarez,06010,80900,84488,165388
2028,Durango,10,Canatlán,10001,18587,19066,37653
2028,Durango,10,Canelas,10002,2651,2436,5087
2028,Durango,10,Coneto de Comonfort,10003,2493,2493,4986
2028,Durango,10,Cuencamé,10004,20259,19912,40171
2028,Durango,10,Durango,10005,355409,381548,736957
2028,Durango,10,El Oro,10018,6767,6879,13646
2028,Durango,10,General Simón Bolívar,10006,5820,5874,11694
2028,Durango,10,Guadalupe Victoria,10008,20010,20408,40418
2028,Durango,10,Guanaceví,10009,5820,5453,11273
2028,Durango,10,Gómez Palacio,10007,192601,197548,390149
2028,Durango,10,Hidalgo,10010,2320,2257,4577
2028,Durango,10,Indé,10011,3078,3028,6106
2028,Durango,10,Lerdo,10012,86492,87532,174024
2028,Durango,10,Mapimí,10013,15103,15040,30143
2028,Durango,10,Mezquital,10014,20516,21229,41745
2028,Durango,10,Nazas,10015,7544,7529,15073
2028,Durango,10,Nombre de Dios,10016,11291,11314,22605
2028,Durango,10,Nuevo Ideal,10039,15405,15589,30994
2028,Durango,10,Ocampo,10017,5855,5630,11485
2028,Durango,10,Otáez,10019,2987,2747,5734
2028,Durango,10,Peñón Blanco,10021,6277,6161,12438
2028,Durango,10,Poanas,10022,14379,14643,29022
2028,Durango,10,Pueblo Nuevo,10023,27223,27438,54661
2028,Durango,10,Pánuco de Coronado,10020,6952,7114,14066
2028,Durango,10,Rodeo,10024,7892,7836,15728
2028,Durango,10,San Bernardo,10025,2072,1837,3909
2028,Durango,10,San Dimas,10026,10895,10235,21130
2028,Durango,10,San Juan de Guadalupe,10027,3152,3267,6419
2028,Durango,10,San Juan del Río,10028,7212,7307,14519
2028,Durango,10,San Luis del Cordero,10029,1250,1216,2466
2028,Durango,10,San Pedro del Gallo,10030,950,870,1820
2028,Durango,10,Santa Clara,10031,4075,4065,8140
2028,Durango,10,Santiago Papasquiaro,10032,27218,27254,54472
2028,Durango,10,Súchil,10033,3470,3754,7224
2028,Durango,10,Tamazula,10034,14655,13346,28001
2028,Durango,10,Tepehuanes,10035,6223,6298,12521
2028,Durango,10,Tlahualilo,10036,13732,13534,27266
2028,Durango,10,Topia,10037,5449,5056,10505
2028,Durango,10,Vicente Guerrero,10038,12013,12723,24736
2028,Estado de México,15,Acambay de Ruíz Castañeda,15001,36266,38246,74512
2028,Estado de México,15,Acolman,15002,99723,99681,199404
2028,Estado de México,15,Aculco,15003,27647,28081,55728
2028,Estado de México,15,Almoloya de Alquisiras,15004,8025,8627,16652
2028,Estado de México,15,Almoloya de Juárez,15005,98553,100504,199057
2028,Estado de México,15,Almoloya del Río,15006,6305,6752,13057
2028,Estado de México,15,Amanalco,15007,13471,13906,27377
2028,Estado de México,15,Amatepec,15008,15370,16069,31439
2028,Estado de México,15,Amecameca,15009,28272,30226,58498
2028,Estado de México,15,Apaxco,15010,16668,17033,33701
2028,Estado de México,15,Atenco,15011,36752,37623,74375
2028,Estado de México,15,Atizapán,15012,6416,6763,13179
2028,Estado de México,15,Atizapán de Zaragoza,15013,288969,306838,595807
2028,Estado de México,15,Atlacomulco,15014,54354,59162,113516
2028,Estado de México,15,Atlautla,15015,17283,17899,35182
2028,Estado de México,15,Axapusco,15016,16153,16213,32366
2028,Estado de México,15,Ayapango,15017,5846,6061,11907
2028,Estado de México,15,Calimaya,15018,31541,32947,64488
2028,Estado de México,15,Capulhuac,15019,19691,20896,40587
2028,Estado de México,15,Chalco,15025,213267,220727,433994
2028,Estado de México,15,Chapa de Mota,15026,15807,16445,32252
2028,Estado de México,15,Chapultepec,15027,6884,7048,13932
2028,Estado de México,15,Chiautla,15028,16816,17399,34215
2028,Estado de México,15,Chicoloapan,15029,116108,123227,239335
2028,Estado de México,15,Chiconcuac,15030,14589,14967,29556
2028,Estado de México,15,Chimalhuacán,15031,367571,379336,746907
2028,Estado de México,15,Coacalco de Berriozábal,15020,158404,171462,329866
2028,Estado de México,15,Coatepec Harinas,15021,21473,22888,44361
2028,Estado de México,15,Cocotitlán,15022,8104,8488,16592
2028,Estado de México,15,Coyotepec,15023,22933,23359,46292
2028,Estado de México,15,Cuautitlán,15024,91600,93603,185203
2028,Estado de México,15,Cuautitlán Izcalli,15121,301065,317140,618205
2028,Estado de México,15,Donato Guerra,15032,18552,19178,37730
2028,Estado de México,15,Ecatepec de Morelos,15033,903397,928018,1831415
2028,Estado de México,15,Ecatzingo,15034,5244,5370,10614
2028,Estado de México,15,El Oro,15064,20452,21905,42357
2028,Estado de México,15,Huehuetoca,15035,77134,78891,156025
2028,Estado de México,15,Hueypoxtla,15036,25305,24695,50000
2028,Estado de México,15,Huixquilucan,15037,150153,161042,311195
2028,Estado de México,15,Isidro Fabela,15038,6601,6662,13263
2028,Estado de México,15,Ixtapaluca,15039,281769,291241,573010
2028,Estado de México,15,Ixtapan de la Sal,15040,19780,21198,40978
2028,Estado de México,15,Ixtapan del Oro,15041,3971,3861,7832
2028,Estado de México,15,Ixtlahuaca,15042,83627,89633,173260
2028,Estado de México,15,Jaltenco,15044,15055,15993,31048
2028,Estado de México,15,Jilotepec,15045,50053,51457,101510
2028,Estado de México,15,Jilotzingo,15046,10700,11274,21974
2028,Estado de México,15,Jiquipilco,15047,40864,43408,84272
2028,Estado de México,15,Jocotitlán,15048,36430,38869,75299
2028,Estado de México,15,Joquicingo,15049,7697,7954,15651
2028,Estado de México,15,Juchitepec,15050,14301,14678,28979
2028,Estado de México,15,La Paz,15070,161674,165356,327030
2028,Estado de México,15,Lerma,15051,84203,86379,170582
2028,Estado de México,15,Luvianos,15123,15918,16141,32059
2028,Estado de México,15,Malinalco,15052,15703,16043,31746
2028,Estado de México,15,Melchor Ocampo,15053,32102,33383,65485
2028,Estado de México,15,Metepec,15054,128158,136472,264630
2028,Estado de México,15,Mexicaltzingo,15055,7119,7576,14695
2028,Estado de México,15,Morelos,15056,16458,17803,34261
2028,Estado de México,15,Naucalpan de Juárez,15057,483996,514482,998478
2028,Estado de México,15,Nextlalpan,15059,22833,23285,46118
2028,Estado de México,15,Nezahualcóyotl,15058,605025,652680,1257705
2028,Estado de México,15,Nicolás Romero,15060,229903,239195,469098
2028,Estado de México,15,Nopaltepec,15061,5197,5203,10400
2028,Estado de México,15,Ocoyoacac,15062,37716,38969,76685
2028,Estado de México,15,Ocuilan,15063,19116,19732,38848
2028,Estado de México,15,Otumba,15065,20560,20250,40810
2028,Estado de México,15,Otzoloapan,15066,2265,2199,4464
2028,Estado de México,15,Otzolotepec,15067,47103,48222,95325
2028,Estado de México,15,Ozumba,15068,16077,17285,33362
2028,Estado de México,15,Papalotla,15069,2259,2379,4638
2028,Estado de México,15,Polotitlán,15071,8040,8316,16356
2028,Estado de México,15,Rayón,15072,7698,7908,15606
2028,Estado de México,15,San Antonio la Isla,15073,16740,17065,33805
2028,Estado de México,15,San Felipe del Progreso,15074,69745,77786,147531
2028,Estado de México,15,San José del Rincón,15124,50141,51275,101416
2028,Estado de México,15,San Martín de las Pirámides,15075,15451,15733,31184
2028,Estado de México,15,San Mateo Atenco,15076,41853,43215,85068
2028,Estado de México,15,San Simón de Guerrero,15077,3389,3575,6964
2028,Estado de México,15,Santo Tomás,15078,5451,5559,11010
2028,Estado de México,15,Soyaniquilpan de Juárez,15079,7694,7784,15478
2028,Estado de México,15,Sultepec,15080,14495,15951,30446
2028,Estado de México,15,Tecámac,15081,261195,273075,534270
2028,Estado de México,15,Tejupilco,15082,41449,44452,85901
2028,Estado de México,15,Temamatla,15083,7061,7383,14444
2028,Estado de México,15,Temascalapa,15084,22169,22126,44295
2028,Estado de México,15,Temascalcingo,15085,34727,37523,72250
2028,Estado de México,15,Temascaltepec,15086,18007,18622,36629
2028,Estado de México,15,Temoaya,15087,55804,58972,114776
2028,Estado de México,15,Tenancingo,15088,54722,57648,112370
2028,Estado de México,15,Tenango del Aire,15089,7112,7269,14381
2028,Estado de México,15,Tenango del Valle,15090,47920,49780,97700
2028,Estado de México,15,Teoloyucan,15091,35573,36345,71918
2028,Estado de México,15,Teotihuacán,15092,31955,32915,64870
2028,Estado de México,15,Tepetlaoxtoc,15093,17591,17797,35388
2028,Estado de México,15,Tepetlixpa,15094,11231,11491,22722
2028,Estado de México,15,Tepotzotlán,15095,54700,56557,111257
2028,Estado de México,15,Tequixquiac,15096,21108,21251,42359
2028,Estado de México,15,Texcaltitlán,15097,10423,10990,21413
2028,Estado de México,15,Texcalyacac,15098,2997,3086,6083
2028,Estado de México,15,Texcoco,15099,135789,144297,280086
2028,Estado de México,15,Tezoyuca,15100,24746,24927,49673
2028,Estado de México,15,Tianguistenco,15101,42610,44868,87478
2028,Estado de México,15,Timilpan,15102,8744,9441,18185
2028,Estado de México,15,Tlalmanalco,15103,26748,28728,55476
2028,Estado de México,15,Tlalnepantla de Baz,15104,407076,436178,843254
2028,Estado de México,15,Tlatlaya,15105,20479,21198,41677
2028,Estado de México,15,Toluca,15106,487819,523349,1011168
2028,Estado de México,15,Tonanitla,15125,5466,5591,11057
2028,Estado de México,15,Tonatico,15107,7225,7713,14938
2028,Estado de México,15,Tultepec,15108,83037,85943,168980
2028,Estado de México,15,Tultitlán,15109,287357,298425,585782
2028,Estado de México,15,Valle de Bravo,15110,36363,37706,74069
2028,Estado de México,15,Valle de Chalco Solidaridad,15122,218229,225049,443278
2028,Estado de México,15,Villa Guerrero,15113,37562,38498,76060
2028,Estado de México,15,Villa Victoria,15114,57681,58402,116083
2028,Estado de México,15,Villa de Allende,15111,28122,29362,57484
2028,Estado de México,15,Villa del Carbón,15112,26899,26572,53471
2028,Estado de México,15,Xalatlaco,15043,16653,17505,34158
2028,Estado de México,15,Xonacatlán,15115,28949,28673,57622
2028,Estado de México,15,Zacazonapan,15116,2307,2260,4567
2028,Estado de México,15,Zacualpan,15117,8378,9190,17568
2028,Estado de México,15,Zinacantepec,15118,105603,108185,213788
2028,Estado de México,15,Zumpahuacán,15119,9067,9863,18930
2028,Estado de México,15,Zumpango,15120,111934,119296,231230
2028,Guanajuato,11,Abasolo,11001,49460,52189,101649
2028,Guanajuato,11,Acámbaro,11002,62388,67352,129740
2028,Guanajuato,11,Apaseo el Alto,11004,37235,38929,76164
2028,Guanajuato,11,Apaseo el Grande,11005,50862,53869,104731
2028,Guanajuato,11,Atarjea,11006,2954,3038,5992
2028,Guanajuato,11,Celaya,11007,272454,288778,561232
2028,Guanajuato,11,Comonfort,11009,43475,48112,91587
2028,Guanajuato,11,Coroneo,11010,6584,7346,13930
2028,Guanajuato,11,Cortazar,11011,52505,55625,108130
2028,Guanajuato,11,Cuerámaro,11012,15453,16617,32070
2028,Guanajuato,11,Doctor Mora,11013,12888,13863,26751
2028,Guanajuato,11,Dolores Hidalgo Cuna de la Independencia Nacional,11014,79334,88351,167685
2028,Guanajuato,11,Guanajuato,11015,102591,107223,209814
2028,Guanajuato,11,Huanímaro,11016,11583,12721,24304
2028,Guanajuato,11,Irapuato,11017,314821,331372,646193
2028,Guanajuato,11,Jaral del Progreso,11018,21888,22397,44285
2028,Guanajuato,11,Jerécuaro,11019,25744,29207,54951
2028,Guanajuato,11,León,11020,873508,890105,1763613
2028,Guanajuato,11,Manuel Doblado,11008,21046,22660,43706
2028,Guanajuato,11,Moroleón,11021,28270,31100,59370
2028,Guanajuato,11,Ocampo,11022,12715,13482,26197
2028,Guanajuato,11,Pueblo Nuevo,11024,6542,7185,13727
2028,Guanajuato,11,Purísima del Rincón,11025,45104,44809,89913
2028,Guanajuato,11,Pénjamo,11023,81870,89092,170962
2028,Guanajuato,11,Romita,11026,32372,33771,66143
2028,Guanajuato,11,Salamanca,11027,152982,161224,314206
2028,Guanajuato,11,Salvatierra,11028,55609,61058,116667
2028,Guanajuato,11,San Diego de la Unión,11029,20516,23469,43985
2028,Guanajuato,11,San Felipe,11030,60791,64126,124917
2028,Guanajuato,11,San Francisco del Rincón,11031,64459,67672,132131
2028,Guanajuato,11,San José Iturbide,11032,42589,44966,87555
2028,Guanajuato,11,San Luis de la Paz,11033,63530,69736,133266
2028,Guanajuato,11,San Miguel de Allende,11003,93316,100410,193726
2028,Guanajuato,11,Santa Catarina,11034,2828,3114,5942
2028,Guanajuato,11,Santa Cruz de Juventino Rosas,11035,45206,48148,93354
2028,Guanajuato,11,Santiago Maravatío,11036,3938,4324,8262
2028,Guanajuato,11,Silao de la Victoria,11037,104527,106910,211437
2028,Guanajuato,11,Tarandacuao,11038,6783,7468,14251
2028,Guanajuato,11,Tarimoro,11039,19375,20280,39655
2028,Guanajuato,11,Tierra Blanca,11040,10229,11020,21249
2028,Guanajuato,11,Uriangato,11041,34861,37181,72042
2028,Guanajuato,11,Valle de Santiago,11042,78692,86352,165044
2028,Guanajuato,11,Victoria,11043,10813,12101,22914
2028,Guanajuato,11,Villagrán,11044,32437,33819,66256
2028,Guanajuato,11,Xichú,11045,6307,6901,13208
2028,Guanajuato,11,Yuriria,11046,38509,42071,80580
2028,Guerrero,12,Acapulco de Juárez,12001,413211,448032,861243
2028,Guerrero,12,Acatepec,12076,18198,19197,37395
2028,Guerrero,12,Ahuacuotzingo,12002,12914,14622,27536
2028,Guerrero,12,Ajuchitlán del Progreso,12003,19162,20334,39496
2028,Guerrero,12,Alcozauca de Guerrero,12004,9480,10767,20247
2028,Guerrero,12,Alpoyeca,12005,3353,3732,7085
2028,Guerrero,12,Apaxtla,12006,5844,6315,12159
2028,Guerrero,12,Arcelia,12007,16212,17225,33437
2028,Guerrero,12,Atenango del Río,12008,4443,4795,9238
2028,Guerrero,12,Atlamajalcingo del Monte,12009,2490,2760,5250
2028,Guerrero,12,Atlixtac,12010,13486,14382,27868
2028,Guerrero,12,Atoyac de Álvarez,12011,31627,32821,64448
2028,Guerrero,12,Ayutla de los Libres,12012,34247,35638,69885
2028,Guerrero,12,Azoyú,12013,6883,7254,14137
2028,Guerrero,12,Benito Juárez,12014,8192,8624,16816
2028,Guerrero,12,Buenavista de Cuéllar,12015,6923,7298,14221
2028,Guerrero,12,Chilapa de Álvarez,12028,63572,70811,134383
2028,Guerrero,12,Chilpancingo de los Bravo,12029,137824,150146,287970
2028,Guerrero,12,Coahuayutla de José María Izazaga,12016,6581,6247,12828
2028,Guerrero,12,Cochoapa el Grande,12078,8741,9680,18421
2028,Guerrero,12,Cocula,12017,7096,7574,14670
2028,Guerrero,12,Copala,12018,7399,7656,15055
2028,Guerrero,12,Copalillo,12019,7248,7915,15163
2028,Guerrero,12,Copanatoyac,12020,9857,10864,20721
2028,Guerrero,12,Coyuca de Benítez,12021,39621,41137,80758
2028,Guerrero,12,Coyuca de Catalán,12022,20902,20549,41451
2028,Guerrero,12,Cuajinicuilapa,12023,14327,14230,28557
2028,Guerrero,12,Cualác,12024,3847,4070,7917
2028,Guerrero,12,Cuautepec,12025,8378,8387,16765
2028,Guerrero,12,Cuetzala del Progreso,12026,4555,4794,9349
2028,Guerrero,12,Cutzamala de Pinzón,12027,10599,11010,21609
2028,Guerrero,12,Eduardo Neri,12075,26428,27557,53985
2028,Guerrero,12,Florencio Villarreal,12030,10793,11030,21823
2028,Guerrero,12,General Canuto A. Neri,12031,3010,3270,6280
2028,Guerrero,12,General Heliodoro Castillo,12032,18829,18784,37613
2028,Guerrero,12,Huamuxtitlán,12033,7631,8572,16203
2028,Guerrero,12,Huitzuco de los Figueroa,12034,19373,20916,40289
2028,Guerrero,12,Iguala de la Independencia,12035,77926,84078,162004
2028,Guerrero,12,Igualapa,12036,5720,5887,11607
2028,Guerrero,12,Iliatenco,12081,5371,5972,11343
2028,Guerrero,12,Ixcateopan de Cuauhtémoc,12037,3203,3566,6769
2028,Guerrero,12,José Joaquín de Herrera,12079,8839,9037,17876
2028,Guerrero,12,Juan R. Escudero,12039,12864,13475,26339
2028,Guerrero,12,Juchitán,12080,4039,3978,8017
2028,Guerrero,12,La Unión de Isidoro Montes de Oca,12068,14200,13535,27735
2028,Guerrero,12,Leonardo Bravo,12040,13426,13677,27103
2028,Guerrero,12,Malinaltepec,12041,13218,14891,28109
2028,Guerrero,12,Marquelia,12077,7171,7273,14444
2028,Guerrero,12,Metlatónoc,12043,8826,10146,18972
2028,Guerrero,12,Mochitlán,12044,6674,6959,13633
2028,Guerrero,12,Mártir de Cuilapan,12042,9380,10268,19648
2028,Guerrero,12,Olinalá,12045,12847,13750,26597
2028,Guerrero,12,Ometepec,12046,34214,35955,70169
2028,Guerrero,12,Pedro Ascencio Alquisiras,12047,3352,3883,7235
2028,Guerrero,12,Petatlán,12048,22920,23391,46311
2028,Guerrero,12,Pilcaya,12049,6658,7036,13694
2028,Guerrero,12,Pungarabato,12050,18891,20186,39077
2028,Guerrero,12,Quechultenango,12051,18293,19036,37329
2028,Guerrero,12,San Luis Acatlán,12052,22030,22620,44650
2028,Guerrero,12,San Marcos,12053,25676,26471,52147
2028,Guerrero,12,San Miguel Totolapan,12054,13913,14491,28404
2028,Guerrero,12,Taxco de Alarcón,12055,55242,60484,115726
2028,Guerrero,12,Tecoanapa,12056,23712,24383,48095
2028,Guerrero,12,Teloloapan,12058,28875,32471,61346
2028,Guerrero,12,Tepecoacuilco de Trujano,12059,16671,18124,34795
2028,Guerrero,12,Tetipac,12060,7491,7870,15361
2028,Guerrero,12,Tixtla de Guerrero,12061,21792,23657,45449
2028,Guerrero,12,Tlacoachistlahuaca,12062,11380,12809,24189
2028,Guerrero,12,Tlacoapa,12063,5017,5604,10621
2028,Guerrero,12,Tlalchapa,12064,6796,6826,13622
2028,Guerrero,12,Tlalixtaquilla de Maldonado,12065,3775,4069,7844
2028,Guerrero,12,Tlapa de Comonfort,12066,44390,49387,93777
2028,Guerrero,12,Tlapehuala,12067,11214,12058,23272
2028,Guerrero,12,Técpan de Galeana,12057,34521,35079,69600
2028,Guerrero,12,Xalpatláhuac,12069,5687,6637,12324
2028,Guerrero,12,Xochihuehuetlán,12070,3604,4081,7685
2028,Guerrero,12,Xochistlahuaca,12071,14635,15521,30156
2028,Guerrero,12,Zapotitlán Tablas,12072,6502,7154,13656
2028,Guerrero,12,Zihuatanejo de Azueta,12038,65040,66794,131834
2028,Guerrero,12,Zirándaro,12073,9525,9144,18669
2028,Guerrero,12,Zitlala,12074,11394,12754,24148
2028,Hidalgo,13,Acatlán,13001,11517,12285,23802
2028,Hidalgo,13,Acaxochitlán,13002,23642,25693,49335
2028,Hidalgo,13,Actopan,13003,31509,35005,66514
2028,Hidalgo,13,Agua Blanca de Iturbide,13004,4991,5531,10522
2028,Hidalgo,13,Ajacuba,13005,10658,11062,21720
2028,Hidalgo,13,Alfajayucan,13006,11927,12547,24474
2028,Hidalgo,13,Almoloya,13007,7077,7149,14226
2028,Hidalgo,13,Apan,13008,25032,27209,52241
2028,Hidalgo,13,Atitalaquia,13010,17241,17620,34861
2028,Hidalgo,13,Atlapexco,13011,11325,12321,23646
2028,Hidalgo,13,Atotonilco de Tula,13013,21619,22762,44381
2028,Hidalgo,13,Atotonilco el Grande,13012,15303,16984,32287
2028,Hidalgo,13,Calnali,13014,9917,10774,20691
2028,Hidalgo,13,Cardonal,13015,10553,11374,21927
2028,Hidalgo,13,Chapantongo,13017,7944,8335,16279
2028,Hidalgo,13,Chapulhuacán,13018,13927,13711,27638
2028,Hidalgo,13,Chilcuautla,13019,10537,10801,21338
2028,Hidalgo,13,Cuautepec de Hinojosa,13016,32161,35174,67335
2028,Hidalgo,13,El Arenal,13009,10472,11355,21827
2028,Hidalgo,13,Eloxochitlán,13020,1592,1806,3398
2028,Hidalgo,13,Emiliano Zapata,13021,8197,9104,17301
2028,Hidalgo,13,Epazoyucan,13022,8509,9013,17522
2028,Hidalgo,13,Francisco I. Madero,13023,20316,22080,42396
2028,Hidalgo,13,Huasca de Ocampo,13024,9913,10786,20699
2028,Hidalgo,13,Huautla,13025,12255,13593,25848
2028,Hidalgo,13,Huazalingo,13026,7865,8369,16234
2028,Hidalgo,13,Huehuetla,13027,14421,15350,29771
2028,Hidalgo,13,Huejutla de Reyes,13028,73334,76437,149771
2028,Hidalgo,13,Huichapan,13029,26069,28175,54244
2028,Hidalgo,13,Ixmiquilpan,13030,51038,57137,108175
2028,Hidalgo,13,Jacala de Ledezma,13031,7653,8494,16147
2028,Hidalgo,13,Jaltocán,13032,6869,7093,13962
2028,Hidalgo,13,Juárez Hidalgo,13033,1824,1996,3820
2028,Hidalgo,13,La Misión,13040,5974,6108,12082
2028,Hidalgo,13,Lolotla,13034,5418,5725,11143
2028,Hidalgo,13,Metepec,13035,6335,7139,13474
2028,Hidalgo,13,Metztitlán,13037,11680,12897,24577
2028,Hidalgo,13,Mineral de la Reforma,13051,95791,105572,201363
2028,Hidalgo,13,Mineral del Chico,13038,5158,5462,10620
2028,Hidalgo,13,Mineral del Monte,13039,8245,9062,17307
2028,Hidalgo,13,Mixquiahuala de Juárez,13041,26220,28095,54315
2028,Hidalgo,13,Molango de Escamilla,13042,6739,7044,13783
2028,Hidalgo,13,Nicolás Flores,13043,3869,4329,8198
2028,Hidalgo,13,Nopala de Villagrán,13044,9846,10158,20004
2028,Hidalgo,13,Omitlán de Juárez,13045,5513,5958,11471
2028,Hidalgo,13,Pachuca de Soto,13048,142755,158394,301149
2028,Hidalgo,13,Pacula,13047,2777,3169,5946
2028,Hidalgo,13,Pisaflores,13049,10091,10012,20103
2028,Hidalgo,13,Progreso de Obregón,13050,13120,14606,27726
2028,Hidalgo,13,San Agustín Metzquititlán,13036,5485,5965,11450
2028,Hidalgo,13,San Agustín Tlaxiaca,13052,20834,21750,42584
2028,Hidalgo,13,San Bartolo Tutotepec,13053,10757,11102,21859
2028,Hidalgo,13,San Felipe Orizatlán,13046,22069,23009,45078
2028,Hidalgo,13,San Salvador,13054,19996,21427,41423
2028,Hidalgo,13,Santiago Tulantepec de Lugo Guerrero,13056,20566,22484,43050
2028,Hidalgo,13,Santiago de Anaya,13055,9834,10255,20089
2028,Hidalgo,13,Singuilucan,13057,9380,9573,18953
2028,Hidalgo,13,Tasquillo,13058,8879,10322,19201
2028,Hidalgo,13,Tecozautla,13059,21246,22762,44008
2028,Hidalgo,13,Tenango de Doria,13060,10133,11172,21305
2028,Hidalgo,13,Tepeapulco,13061,31210,33219,64429
2028,Hidalgo,13,Tepehuacán de Guerrero,13062,17796,17281,35077
2028,Hidalgo,13,Tepeji del Río de Ocampo,13063,49684,50977,100661
2028,Hidalgo,13,Tepetitlán,13064,6330,6679,13009
2028,Hidalgo,13,Tetepango,13065,6733,6754,13487
2028,Hidalgo,13,Tezontepec de Aldama,13067,30404,31046,61450
2028,Hidalgo,13,Tianguistengo,13068,8594,9000,17594
2028,Hidalgo,13,Tizayuca,13069,73191,75208,148399
2028,Hidalgo,13,Tlahuelilpan,13070,10998,11389,22387
2028,Hidalgo,13,Tlahuiltepa,13071,6112,6091,12203
2028,Hidalgo,13,Tlanalapa,13072,5927,6314,12241
2028,Hidalgo,13,Tlanchinol,13073,22483,22835,45318
2028,Hidalgo,13,Tlaxcoapan,13074,16328,16708,33036
2028,Hidalgo,13,Tolcayuca,13075,9302,9864,19166
2028,Hidalgo,13,Tula de Allende,13076,62556,66401,128957
2028,Hidalgo,13,Tulancingo de Bravo,13077,86547,96337,182884
2028,Hidalgo,13,Villa de Tezontepec,13066,7048,7378,14426
2028,Hidalgo,13,Xochiatipan,13078,11001,11811,22812
2028,Hidalgo,13,Xochicoatlán,13079,4587,4743,9330
2028,Hidalgo,13,Yahualica,13080,13738,14453,28191
2028,Hidalgo,13,Zacualtipán de Ángeles,13081,19406,21205,40611
2028,Hidalgo,13,Zapotlán de Juárez,13082,10547,11427,21974
2028,Hidalgo,13,Zempoala,13083,26944,28537,55481
2028,Hidalgo,13,Zimapán,13084,21617,24894,46511
2028,Jalisco,14,Acatic,14001,12046,12526,24572
2028,Jalisco,14,Acatlán de Juárez,14002,12776,12553,25329
2028,Jalisco,14,Ahualulco de Mercado,14003,13126,13498,26624
2028,Jalisco,14,Amacueca,14004,3101,3232,6333
2028,Jalisco,14,Amatitán,14005,8686,8733,17419
2028,Jalisco,14,Ameca,14006,34863,36133,70996
2028,Jalisco,14,Arandas,14008,40686,43871,84557
2028,Jalisco,14,Atemajac de Brizuela,14010,3737,3781,7518
2028,Jalisco,14,Atengo,14011,3381,3152,6533
2028,Jalisco,14,Atenguillo,14012,2313,2408,4721
2028,Jalisco,14,Atotonilco el Alto,14013,34187,35215,69402
2028,Jalisco,14,Atoyac,14014,4607,4933,9540
2028,Jalisco,14,Autlán de Navarro,14015,34738,35904,70642
2028,Jalisco,14,Ayotlán,14016,21234,22063,43297
2028,Jalisco,14,Ayutla,14017,7364,7291,14655
2028,Jalisco,14,Bolaños,14019,4385,4370,8755
2028,Jalisco,14,Cabo Corrientes,14020,6270,5728,11998
2028,Jalisco,14,Casimiro Castillo,14021,12746,12653,25399
2028,Jalisco,14,Cañadas de Obregón,14117,2442,2554,4996
2028,Jalisco,14,Chapala,14030,28971,30485,59456
2028,Jalisco,14,Chimaltitán,14031,1879,1915,3794
2028,Jalisco,14,Chiquilistlán,14032,3507,3444,6951
2028,Jalisco,14,Cihuatlán,14022,23958,23271,47229
2028,Jalisco,14,Cocula,14024,15206,15893,31099
2028,Jalisco,14,Colotlán,14025,10070,10759,20829
2028,Jalisco,14,Concepción de Buenos Aires,14026,3657,3520,7177
2028,Jalisco,14,Cuautitlán de García Barragán,14027,10327,10021,20348
2028,Jalisco,14,Cuautla,14028,1257,1346,2603
2028,Jalisco,14,Cuquío,14029,10190,10974,21164
2028,Jalisco,14,Degollado,14033,12054,12711,24765
2028,Jalisco,14,Ejutla,14034,1192,1110,2302
2028,Jalisco,14,El Arenal,14009,11171,11198,22369
2028,Jalisco,14,El Grullo,14037,13840,14651,28491
2028,Jalisco,14,El Limón,14054,3333,3330,6663
2028,Jalisco,14,El Salto,14070,104742,105096,209838
2028,Jalisco,14,Encarnación de Díaz,14035,29704,31682,61386
2028,Jalisco,14,Etzatlán,14036,11178,11716,22894
2028,Jalisco,14,Guachinango,14038,2590,2484,5074
2028,Jalisco,14,Guadalajara,14039,793896,847504,1641400
2028,Jalisco,14,Gómez Farías,14079,7965,8504,16469
2028,Jalisco,14,Hostotipaquillo,14040,6361,5511,11872
2028,Jalisco,14,Huejuquilla el Alto,14042,4987,5379,10366
2028,Jalisco,14,Huejúcar,14041,3346,3656,7002
2028,Jalisco,14,Ixtlahuacán de los Membrillos,14044,31898,32322,64220
2028,Jalisco,14,Ixtlahuacán del Río,14045,10755,11360,22115
2028,Jalisco,14,Jalostotitlán,14046,19037,19494,38531
2028,Jalisco,14,Jamay,14047,14250,14182,28432
2028,Jalisco,14,Jesús María,14048,10207,11990,22197
2028,Jalisco,14,Jilotlán de los Dolores,14049,5596,5287,10883
2028,Jalisco,14,Jocotepec,14050,26252,26544,52796
2028,Jalisco,14,Juanacatlán,14051,10345,10255,20600
2028,Jalisco,14,Juchitlán,14052,3241,3404,6645
2028,Jalisco,14,La Barca,14018,36444,38591,75035
2028,Jalisco,14,La Huerta,14043,14496,13830,28326
2028,Jalisco,14,La Manzanilla de la Paz,14057,2140,2280,4420
2028,Jalisco,14,Lagos de Moreno,14053,91293,94889,186182
2028,Jalisco,14,Magdalena,14055,12891,12857,25748
2028,Jalisco,14,Mascota,14058,8499,8739,17238
2028,Jalisco,14,Mazamitla,14059,7737,8358,16095
2028,Jalisco,14,Mexticacán,14060,2748,3219,5967
2028,Jalisco,14,Mezquitic,14061,10607,11247,21854
2028,Jalisco,14,Mixtlán,14062,2095,2062,4157
2028,Jalisco,14,Ocotlán,14063,55579,57527,113106
2028,Jalisco,14,Ojuelos de Jalisco,14064,17568,18414,35982
2028,Jalisco,14,Pihuamo,14065,6749,6655,13404
2028,Jalisco,14,Poncitlán,14066,28684,29355,58039
2028,Jalisco,14,Puerto Vallarta,14067,159582,155673,315255
2028,Jalisco,14,Quitupan,14069,4697,5189,9886
2028,Jalisco,14,San Cristóbal de la Barranca,14071,1749,1728,3477
2028,Jalisco,14,San Diego de Alejandría,14072,4007,4276,8283
2028,Jalisco,14,San Gabriel,14113,9353,9666,19019
2028,Jalisco,14,San Ignacio Cerro Gordo,14125,10414,11027,21441
2028,Jalisco,14,San Juan de los Lagos,14073,39179,39602,78781
2028,Jalisco,14,San Juanito de Escobedo,14007,5476,5361,10837
2028,Jalisco,14,San Julián,14074,8751,9622,18373
2028,Jalisco,14,San Marcos,14075,2219,2164,4383
2028,Jalisco,14,San Martín Hidalgo,14077,15943,16602,32545
2028,Jalisco,14,San Martín de Bolaños,14076,1750,1754,3504
2028,Jalisco,14,San Miguel el Alto,14078,18353,19317,37670
2028,Jalisco,14,San Pedro Tlaquepaque,14098,371372,374651,746023
2028,Jalisco,14,San Sebastián del Oeste,14080,3488,3117,6605
2028,Jalisco,14,Santa María de los Ángeles,14081,1818,1993,3811
2028,Jalisco,14,Santa María del Oro,14056,1210,1197,2407
2028,Jalisco,14,Sayula,14082,20301,21773,42074
2028,Jalisco,14,Tala,14083,45782,46190,91972
2028,Jalisco,14,Talpa de Allende,14084,8775,8617,17392
2028,Jalisco,14,Tamazula de Gordiano,14085,22124,23202,45326
2028,Jalisco,14,Tapalpa,14086,10671,11066,21737
2028,Jalisco,14,Tecalitlán,14087,9459,9861,19320
2028,Jalisco,14,Techaluta de Montenegro,14089,2172,2219,4391
2028,Jalisco,14,Tecolotlán,14088,10116,10103,20219
2028,Jalisco,14,Tenamaxtlán,14090,4080,4102,8182
2028,Jalisco,14,Teocaltiche,14091,22886,24889,47775
2028,Jalisco,14,Teocuitatlán de Corona,14092,6110,6324,12434
2028,Jalisco,14,Tepatitlán de Morelos,14093,78523,81344,159867
2028,Jalisco,14,Tequila,14094,23419,23740,47159
2028,Jalisco,14,Teuchitlán,14095,5584,5742,11326
2028,Jalisco,14,Tizapán el Alto,14096,11969,12472,24441
2028,Jalisco,14,Tlajomulco de Zúñiga,14097,339692,344024,683716
2028,Jalisco,14,Tolimán,14099,5927,5961,11888
2028,Jalisco,14,Tomatlán,14100,20958,19706,40664
2028,Jalisco,14,Tonalá,14101,299756,300942,600698
2028,Jalisco,14,Tonaya,14102,3505,3640,7145
2028,Jalisco,14,Tonila,14103,4617,4634,9251
2028,Jalisco,14,Totatiche,14104,2668,2712,5380
2028,Jalisco,14,Tototlán,14105,13189,13449,26638
2028,Jalisco,14,Tuxcacuesco,14106,2619,2491,5110
2028,Jalisco,14,Tuxcueca,14107,3493,3704,7197
2028,Jalisco,14,Tuxpan,14108,19613,20805,40418
2028,Jalisco,14,Unión de San Antonio,14109,10028,10679,20707
2028,Jalisco,14,Unión de Tula,14110,7697,8155,15852
2028,Jalisco,14,Valle de Guadalupe,14111,4016,4056,8072
2028,Jalisco,14,Valle de Juárez,14112,3147,3327,6474
2028,Jalisco,14,Villa Corona,14114,10315,10565,20880
2028,Jalisco,14,Villa Guerrero,14115,3189,3303,6492
2028,Jalisco,14,Villa Hidalgo,14116,11244,11969,23213
2028,Jalisco,14,Villa Purificación,14068,6638,6137,12775
2028,Jalisco,14,Yahualica de González Gallo,14118,12411,13639,26050
2028,Jalisco,14,Zacoalco de Torres,14119,16399,16637,33036
2028,Jalisco,14,Zapopan,14120,745859,773042,1518901
2028,Jalisco,14,Zapotiltic,14121,16702,17310,34012
2028,Jalisco,14,Zapotitlán de Vadillo,14122,4086,4047,8133
2028,Jalisco,14,Zapotlanejo,14124,37994,38783,76777
2028,Jalisco,14,Zapotlán del Rey,14123,10390,10379,20769
2028,Jalisco,14,Zapotlán el Grande,14023,59354,62680,122034
2028,Michoacán,16,Acuitzio,16001,6086,6551,12637
2028,Michoacán,16,Aguililla,16002,8059,7858,15917
2028,Michoacán,16,Angamacutiro,16004,8218,8896,17114
2028,Michoacán,16,Angangueo,16005,5997,6362,12359
2028,Michoacán,16,Apatzingán,16006,69002,69881,138883
2028,Michoacán,16,Aporo,16007,1733,1848,3581
2028,Michoacán,16,Aquila,16008,13787,13421,27208
2028,Michoacán,16,Ario,16009,19738,20795,40533
2028,Michoacán,16,Arteaga,16010,11945,12030,23975
2028,Michoacán,16,Briseñas,16011,6176,6477,12653
2028,Michoacán,16,Buenavista,16012,26612,25192,51804
2028,Michoacán,16,Carácuaro,16013,5101,5040,10141
2028,Michoacán,16,Charapan,16021,6452,7235,13687
2028,Michoacán,16,Charo,16022,12373,11882,24255
2028,Michoacán,16,Chavinda,16023,5679,5971,11650
2028,Michoacán,16,Cherán,16024,10075,10819,20894
2028,Michoacán,16,Chilchota,16025,20701,22275,42976
2028,Michoacán,16,Chinicuila,16026,2778,2509,5287
2028,Michoacán,16,Chucándiro,16027,2333,2632,4965
2028,Michoacán,16,Churintzio,16028,2842,3210,6052
2028,Michoacán,16,Churumuco,16029,8401,8331,16732
2028,Michoacán,16,Coahuayana,16014,8348,7680,16028
2028,Michoacán,16,Coalcomán de Vázquez Pallares,16015,9587,9654,19241
2028,Michoacán,16,Coeneo,16016,11091,12701,23792
2028,Michoacán,16,Cojumatlán de Régules,16074,5705,5928,11633
2028,Michoacán,16,Contepec,16017,18267,18998,37265
2028,Michoacán,16,Copándaro,16018,4805,5244,10049
2028,Michoacán,16,Cotija,16019,9906,10827,20733
2028,Michoacán,16,Cuitzeo,16020,15801,17308,33109
2028,Michoacán,16,Ecuandureo,16030,6614,7691,14305
2028,Michoacán,16,Epitacio Huerta,16031,9083,9372,18455
2028,Michoacán,16,Erongarícuaro,16032,8217,8810,17027
2028,Michoacán,16,Gabriel Zamora,16033,12533,12527,25060
2028,Michoacán,16,Hidalgo,16034,65447,68589,134036
2028,Michoacán,16,Huandacareo,16036,6294,7204,13498
2028,Michoacán,16,Huaniqueo,16037,4381,5064,9445
2028,Michoacán,16,Huetamo,16038,22033,23143,45176
2028,Michoacán,16,Huiramba,16039,4733,4897,9630
2028,Michoacán,16,Indaparapeo,16040,9026,9380,18406
2028,Michoacán,16,Irimbo,16041,7959,8618,16577
2028,Michoacán,16,Ixtlán,16042,7151,7297,14448
2028,Michoacán,16,Jacona,16043,36567,38583,75150
2028,Michoacán,16,Jiménez,16044,7026,7583,14609
2028,Michoacán,16,Jiquilpan,16045,17656,19390,37046
2028,Michoacán,16,José Sixto Verduzco,16113,14202,15495,29697
2028,Michoacán,16,Jungapeo,16047,11570,11598,23168
2028,Michoacán,16,Juárez,16046,7860,8166,16026
2028,Michoacán,16,La Huacana,16035,18756,18859,37615
2028,Michoacán,16,La Piedad,16069,55620,60689,116309
2028,Michoacán,16,Lagunillas,16048,3065,3144,6209
2028,Michoacán,16,Los Reyes,16075,37573,39356,76929
2028,Michoacán,16,Lázaro Cárdenas,16052,99589,98569,198158
2028,Michoacán,16,Madero,16049,9928,9632,19560
2028,Michoacán,16,Maravatío,16050,46860,49979,96839
2028,Michoacán,16,Marcos Castellanos,16051,7446,7945,15391
2028,Michoacán,16,Morelia,16053,414374,448373,862747
2028,Michoacán,16,Morelos,16054,3947,4599,8546
2028,Michoacán,16,Múgica,16055,24732,25195,49927
2028,Michoacán,16,Nahuatzen,16056,15150,15967,31117
2028,Michoacán,16,Nocupétaro,16057,4462,4477,8939
2028,Michoacán,16,Nuevo Parangaricutiro,16058,10665,10961,21626
2028,Michoacán,16,Nuevo Urecho,16059,4506,4454,8960
2028,Michoacán,16,Numarán,16060,5220,5724,10944
2028,Michoacán,16,Ocampo,16061,12928,12936,25864
2028,Michoacán,16,Pajacuarán,16062,10351,11059,21410
2028,Michoacán,16,Panindícuaro,16063,8477,9423,17900
2028,Michoacán,16,Paracho,16065,19772,21511,41283
2028,Michoacán,16,Parácuaro,16064,14858,14344,29202
2028,Michoacán,16,Penjamillo,16067,9052,10325,19377
2028,Michoacán,16,Peribán,16068,15373,15139,30512
2028,Michoacán,16,Puruándiro,16071,35402,38974,74376
2028,Michoacán,16,Purépero,16070,8335,8710,17045
2028,Michoacán,16,Pátzcuaro,16066,49148,53303,102451
2028,Michoacán,16,Queréndaro,16072,7426,7682,15108
2028,Michoacán,16,Quiroga,16073,14703,16045,30748
2028,Michoacán,16,Sahuayo,16076,41677,43628,85305
2028,Michoacán,16,Salvador Escalante,16079,26212,27493,53705
2028,Michoacán,16,San Lucas,16077,10036,10180,20216
2028,Michoacán,16,Santa Ana Maya,16078,6621,7476,14097
2028,Michoacán,16,Senguio,16080,10164,10729,20893
2028,Michoacán,16,Susupuato,16081,4807,4774,9581
2028,Michoacán,16,Tacámbaro,16082,41609,43223,84832
2028,Michoacán,16,Tancítaro,16083,17163,16592,33755
2028,Michoacán,16,Tangamandapio,16084,15579,16532,32111
2028,Michoacán,16,Tangancícuaro,16085,18281,19358,37639
2028,Michoacán,16,Tanhuato,16086,8429,8788,17217
2028,Michoacán,16,Taretan,16087,8122,8237,16359
2028,Michoacán,16,Tarímbaro,16088,60299,64887,125186
2028,Michoacán,16,Tepalcatepec,16089,13389,13058,26447
2028,Michoacán,16,Tingambato,16090,8052,8482,16534
2028,Michoacán,16,Tingüindín,16091,7846,8459,16305
2028,Michoacán,16,Tiquicheo de Nicolás Romero,16092,7349,7455,14804
2028,Michoacán,16,Tlalpujahua,16093,14942,16575,31517
2028,Michoacán,16,Tlazazalca,16094,3607,3844,7451
2028,Michoacán,16,Tocumbo,16095,6742,6835,13577
2028,Michoacán,16,Tumbiscatío,16096,3682,3521,7203
2028,Michoacán,16,Turicato,16097,16696,17387,34083
2028,Michoacán,16,Tuxpan,16098,14304,15208,29512
2028,Michoacán,16,Tuzantla,16099,8387,8386,16773
2028,Michoacán,16,Tzintzuntzan,16100,7612,8355,15967
2028,Michoacán,16,Tzitzio,16101,4788,4631,9419
2028,Michoacán,16,Uruapan,16102,178952,190863,369815
2028,Michoacán,16,Venustiano Carranza,16103,13645,14229,27874
2028,Michoacán,16,Villamar,16104,9139,9709,18848
2028,Michoacán,16,Vista Hermosa,16105,11318,11749,23067
2028,Michoacán,16,Yurécuaro,16106,16991,17788,34779
2028,Michoacán,16,Zacapu,16107,40415,43641,84056
2028,Michoacán,16,Zamora,16108,105734,111914,217648
2028,Michoacán,16,Zinapécuaro,16110,25241,27143,52384
2028,Michoacán,16,Zináparo,16109,1737,2011,3748
2028,Michoacán,16,Ziracuaretiro,16111,9443,9570,19013
2028,Michoacán,16,Zitácuaro,16112,85349,93365,178714
2028,Michoacán,16,Álvaro Obregón,16003,11788,12441,24229
2028,Morelos,17,Amacuzac,17001,9997,10399,20396
2028,Morelos,17,Atlatlahucan,17002,12873,13195,26068
2028,Morelos,17,Axochiapan,17003,20432,20669,41101
2028,Morelos,17,Ayala,17004,47390,50241,97631
2028,Morelos,17,Coatlán del Río,17005,5741,5839,11580
2028,Morelos,17,Cuautla,17006,108535,115958,224493
2028,Morelos,17,Cuernavaca,17007,203367,230169,433536
2028,Morelos,17,Emiliano Zapata,17008,56043,57439,113482
2028,Morelos,17,Huitzilac,17009,10837,10870,21707
2028,Morelos,17,Jantetelco,17010,9732,10054,19786
2028,Morelos,17,Jiutepec,17011,116789,123847,240636
2028,Morelos,17,Jojutla,17012,32366,34491,66857
2028,Morelos,17,Jonacatepec,17013,8776,9353,18129
2028,Morelos,17,Mazatepec,17014,5685,5880,11565
2028,Morelos,17,Miacatlán,17015,14961,15496,30457
2028,Morelos,17,Ocuituco,17016,10503,10632,21135
2028,Morelos,17,Puente de Ixtla,17017,37297,38592,75889
2028,Morelos,17,Temixco,17018,64674,67061,131735
2028,Morelos,17,Temoac,17033,8925,9303,18228
2028,Morelos,17,Tepalcingo,17019,15444,15852,31296
2028,Morelos,17,Tepoztlán,17020,27468,28216,55684
2028,Morelos,17,Tetecala,17021,4544,4535,9079
2028,Morelos,17,Tetela del Volcán,17022,11517,11957,23474
2028,Morelos,17,Tlalnepantla,17023,4184,4049,8233
2028,Morelos,17,Tlaltizapán de Zapata,17024,29389,30565,59954
2028,Morelos,17,Tlaquiltenango,17025,19515,19955,39470
2028,Morelos,17,Tlayacapan,17026,10177,10280,20457
2028,Morelos,17,Totolapan,17027,6737,6856,13593
2028,Morelos,17,Xochitepec,17028,39841,39283,79124
2028,Morelos,17,Yautepec,17029,57396,60238,117634
2028,Morelos,17,Yecapixtla,17030,29808,30285,60093
2028,Morelos,17,Zacatepec,17031,20550,22173,42723
2028,Morelos,17,Zacualpan,17032,5457,5616,11073
2028,Nayarit,18,Acaponeta,18001,22507,22383,44890
2028,Nayarit,18,Ahuacatlán,18002,9763,9588,19351
2028,Nayarit,18,Amatlán de Cañas,18003,7397,7075,14472
2028,Nayarit,18,Bahía de Banderas,18020,97587,93344,190931
2028,Nayarit,18,Compostela,18004,45560,45084,90644
2028,Nayarit,18,Del Nayar,18009,24179,24079,48258
2028,Nayarit,18,Huajicori,18005,7482,7217,14699
2028,Nayarit,18,Ixtlán del Río,18006,17049,18143,35192
2028,Nayarit,18,Jala,18007,10911,11068,21979
2028,Nayarit,18,La Yesca,18019,8299,7769,16068
2028,Nayarit,18,Rosamorada,18010,21171,20135,41306
2028,Nayarit,18,Ruíz,18011,15109,14627,29736
2028,Nayarit,18,San Blas,18012,28454,25265,53719
2028,Nayarit,18,San Pedro Lagunillas,18013,4724,4567,9291
2028,Nayarit,18,Santa María del Oro,18014,14207,13836,28043
2028,Nayarit,18,Santiago Ixcuintla,18015,60706,58378,119084
2028,Nayarit,18,Tecuala,18016,24714,23899,48613
2028,Nayarit,18,Tepic,18017,238449,250752,489201
2028,Nayarit,18,Tuxpan,18018,18726,18818,37544
2028,Nayarit,18,Xalisco,18008,33220,34401,67621
2028,Nuevo León,19,Abasolo,19001,1557,1550,3107
2028,Nuevo León,19,Agualeguas,19002,1342,1275,2617
2028,Nuevo León,19,Allende,19004,21334,21087,42421
2028,Nuevo León,19,Anáhuac,19005,11059,11147,22206
2028,Nuevo León,19,Apodaca,19006,359488,352327,711815
2028,Nuevo León,19,Aramberri,19007,10314,10019,20333
2028,Nuevo León,19,Bustamante,19008,2484,2472,4956
2028,Nuevo León,19,Cadereyta Jiménez,19009,58953,56510,115463
2028,Nuevo León,19,Cerralvo,19011,4771,4473,9244
2028,Nuevo León,19,China,19013,6990,6644,13634
2028,Nuevo León,19,Ciénega de Flores,19012,28141,26995,55136
2028,Nuevo León,19,Doctor Arroyo,19014,21797,21106,42903
2028,Nuevo León,19,Doctor Coss,19015,1131,1104,2235
2028,Nuevo León,19,Doctor González,19016,1891,1786,3677
2028,Nuevo León,19,El Carmen,19010,26303,25691,51994
2028,Nuevo León,19,Galeana,19017,25811,25082,50893
2028,Nuevo León,19,García,19018,165595,162785,328380
2028,Nuevo León,19,General Bravo,19020,3615,3439,7054
2028,Nuevo León,19,General Escobedo,19021,249333,248110,497443
2028,Nuevo León,19,General Terán,19022,9406,9428,18834
2028,Nuevo León,19,General Treviño,19023,632,660,1292
2028,Nuevo León,19,General Zaragoza,19024,3827,3561,7388
2028,Nuevo León,19,General Zuazua,19025,50521,49436,99957
2028,Nuevo León,19,Guadalupe,19026,395493,388688,784181
2028,Nuevo León,19,Hidalgo,19047,8650,8580,17230
2028,Nuevo León,19,Higueras,19028,986,916,1902
2028,Nuevo León,19,Hualahuises,19029,4379,4409,8788
2028,Nuevo León,19,Iturbide,19030,2341,2170,4511
2028,Nuevo León,19,Juárez,19031,218251,211566,429817
2028,Nuevo León,19,Lampazos de Naranjo,19032,3326,3222,6548
2028,Nuevo León,19,Linares,19033,49342,49299,98641
2028,Nuevo León,19,Los Aldamas,19003,987,971,1958
2028,Nuevo León,19,Los Herreras,19027,1208,1234,2442
2028,Nuevo León,19,Los Ramones,19042,2828,2771,5599
2028,Nuevo León,19,Marín,19034,3458,3248,6706
2028,Nuevo León,19,Melchor Ocampo,19035,657,631,1288
2028,Nuevo León,19,Mier y Noriega,19036,4302,4190,8492
2028,Nuevo León,19,Mina,19037,3307,3134,6441
2028,Nuevo León,19,Montemorelos,19038,37981,37788,75769
2028,Nuevo León,19,Monterrey,19039,622778,653762,1276540
2028,Nuevo León,19,Parás,19040,637,611,1248
2028,Nuevo León,19,Pesquería,19041,62408,61636,124044
2028,Nuevo León,19,Rayones,19043,1802,1668,3470
2028,Nuevo León,19,Sabinas Hidalgo,19044,21432,22281,43713
2028,Nuevo León,19,Salinas Victoria,19045,34588,32783,67371
2028,Nuevo León,19,San Nicolás de los Garza,19046,257315,268723,526038
2028,Nuevo León,19,San Pedro Garza García,19019,73129,81685,154814
2028,Nuevo León,19,Santa Catarina,19048,175617,173568,349185
2028,Nuevo León,19,Santiago,19049,26319,26084,52403
2028,Nuevo León,19,Vallecillo,19050,1227,1057,2284
2028,Nuevo León,19,Villaldama,19051,2628,2624,5252
2028,Oaxaca,20,Abejones,20001,446,608,1054
2028,Oaxaca,20,Acatlán de Pérez Figueroa,20002,24379,25351,49730
2028,Oaxaca,20,Asunción Cacalotepec,20003,1104,1197,2301
2028,Oaxaca,20,Asunción Cuyotepeji,20004,507,576,1083
2028,Oaxaca,20,Asunción Ixtaltepec,20005,8385,8524,16909
2028,Oaxaca,20,Asunción Nochixtlán,20006,9552,10795,20347
2028,Oaxaca,20,Asunción Ocotlán,20007,1184,1468,2652
2028,Oaxaca,20,Asunción Tlacolulita,20008,423,451,874
2028,Oaxaca,20,Ayoquezco de Aldama,20398,2243,2499,4742
2028,Oaxaca,20,Ayotzintepec,20009,3813,3850,7663
2028,Oaxaca,20,Calihualá,20011,607,644,1251
2028,Oaxaca,20,Candelaria Loxicha,20012,5441,5679,11120
2028,Oaxaca,20,Capulálpam de Méndez,20247,774,946,1720
2028,Oaxaca,20,Chahuites,20025,6238,6310,12548
2028,Oaxaca,20,Chalcatongo de Hidalgo,20026,4658,5331,9989
2028,Oaxaca,20,Chiquihuitlán de Benito Juárez,20027,1170,1424,2594
2028,Oaxaca,20,Ciudad Ixtepec,20014,15335,16760,32095
2028,Oaxaca,20,Ciénega de Zimatlán,20013,1602,1763,3365
2028,Oaxaca,20,Coatecas Altas,20015,2226,2574,4800
2028,Oaxaca,20,Coicoyán de las Flores,20016,4896,5561,10457
2028,Oaxaca,20,Concepción Buenavista,20018,429,460,889
2028,Oaxaca,20,Concepción Pápalo,20019,1626,1640,3266
2028,Oaxaca,20,Constancia del Rosario,20020,1914,2198,4112
2028,Oaxaca,20,Cosolapa,20021,8128,8787,16915
2028,Oaxaca,20,Cosoltepec,20022,397,473,870
2028,Oaxaca,20,Cuilápam de Guerrero,20023,11500,12174,23674
2028,Oaxaca,20,Cuyamecalco Villa de Zaragoza,20024,2013,1997,4010
2028,Oaxaca,20,El Barrio de la Soledad,20010,7524,8153,15677
2028,Oaxaca,20,El Espinal,20030,4723,4966,9689
2028,Oaxaca,20,Eloxochitlán de Flores Magón,20029,2165,2451,4616
2028,Oaxaca,20,Fresnillo de Trujano,20032,550,599,1149
2028,Oaxaca,20,Guadalupe Etla,20033,1397,1562,2959
2028,Oaxaca,20,Guadalupe de Ramírez,20034,698,716,1414
2028,Oaxaca,20,Guelatao de Juárez,20035,290,294,584
2028,Oaxaca,20,Guevea de Humboldt,20036,2763,2875,5638
2028,Oaxaca,20,Heroica Ciudad de Ejutla de Crespo,20028,10957,12294,23251
2028,Oaxaca,20,Heroica Ciudad de Huajuapan de León,20039,39649,44375,84024
2028,Oaxaca,20,Heroica Ciudad de Juchitán de Zaragoza,20043,52016,55048,107064
2028,Oaxaca,20,Heroica Ciudad de Tlaxiaco,20397,20471,23339,43810
2028,Oaxaca,20,Huautepec,20040,3051,3542,6593
2028,Oaxaca,20,Huautla de Jiménez,20041,15460,17981,33441
2028,Oaxaca,20,Ixpantepec Nieves,20065,580,730,1310
2028,Oaxaca,20,Ixtlán de Juárez,20042,4331,4485,8816
2028,Oaxaca,20,La Compañía,20017,1717,1897,3614
2028,Oaxaca,20,La Pe,20069,1359,1454,2813
2028,Oaxaca,20,La Reforma,20076,1642,1788,3430
2028,Oaxaca,20,La Trinidad Vista Hermosa,20556,129,156,285
2028,Oaxaca,20,Loma Bonita,20044,22387,24533,46920
2028,Oaxaca,20,Magdalena Apasco,20045,4586,5112,9698
2028,Oaxaca,20,Magdalena Jaltepec,20046,1644,1926,3570
2028,Oaxaca,20,Magdalena Mixtepec,20048,678,713,1391
2028,Oaxaca,20,Magdalena Ocotlán,20049,605,651,1256
2028,Oaxaca,20,Magdalena Peñasco,20050,1734,2013,3747
2028,Oaxaca,20,Magdalena Teitipac,20051,2358,2520,4878
2028,Oaxaca,20,Magdalena Tequisistlán,20052,3301,3453,6754
2028,Oaxaca,20,Magdalena Tlacotepec,20053,673,732,1405
2028,Oaxaca,20,Magdalena Yodocono de Porfirio Díaz,20562,817,873,1690
2028,Oaxaca,20,Magdalena Zahuatlán,20054,216,244,460
2028,Oaxaca,20,Mariscala de Juárez,20055,1885,2044,3929
2028,Oaxaca,20,Matías Romero Avendaño,20057,20517,21918,42435
2028,Oaxaca,20,Mazatlán Villa de Flores,20058,6931,7086,14017
2028,Oaxaca,20,Mesones Hidalgo,20037,2173,2553,4726
2028,Oaxaca,20,Miahuatlán de Porfirio Díaz,20059,22506,24842,47348
2028,Oaxaca,20,Mixistlán de la Reforma,20060,1327,1477,2804
2028,Oaxaca,20,Monjas,20061,1378,1618,2996
2028,Oaxaca,20,Mártires de Tacubaya,20056,755,822,1577
2028,Oaxaca,20,Natividad,20062,336,389,725
2028,Oaxaca,20,Nazareno Etla,20063,2119,2328,4447
2028,Oaxaca,20,Nejapa de Madero,20064,4025,4171,8196
2028,Oaxaca,20,Nuevo Zoquiápam,20504,847,909,1756
2028,Oaxaca,20,Oaxaca de Juárez,20067,124374,144047,268421
2028,Oaxaca,20,Ocotlán de Morelos,20068,11401,12430,23831
2028,Oaxaca,20,Pinotepa de Don Luis,20070,3674,3793,7467
2028,Oaxaca,20,Pluma Hidalgo,20071,1549,1602,3151
2028,Oaxaca,20,Putla Villa de Guerrero,20073,16872,19040,35912
2028,Oaxaca,20,Reforma de Pineda,20075,1509,1620,3129
2028,Oaxaca,20,Reyes Etla,20077,2082,2212,4294
2028,Oaxaca,20,Rojas de Cuauhtémoc,20078,581,659,1240
2028,Oaxaca,20,Salina Cruz,20079,46355,50312,96667
2028,Oaxaca,20,San Agustín Amatengo,20080,769,877,1646
2028,Oaxaca,20,San Agustín Atenango,20081,900,1036,1936
2028,Oaxaca,20,San Agustín Chayuco,20082,2010,2188,4198
2028,Oaxaca,20,San Agustín Etla,20084,2143,2367,4510
2028,Oaxaca,20,San Agustín Loxicha,20085,12915,13432,26347
2028,Oaxaca,20,San Agustín Tlacotepec,20086,444,605,1049
2028,Oaxaca,20,San Agustín Yatareni,20087,2243,2540,4783
2028,Oaxaca,20,San Agustín de las Juntas,20083,5100,5324,10424
2028,Oaxaca,20,San Andrés Cabecera Nueva,20088,1488,1524,3012
2028,Oaxaca,20,San Andrés Dinicuiti,20089,1118,1183,2301
2028,Oaxaca,20,San Andrés Huaxpaltepec,20090,3203,3391,6594
2028,Oaxaca,20,San Andrés Huayápam,20091,2773,3061,5834
2028,Oaxaca,20,San Andrés Ixtlahuaca,20092,837,951,1788
2028,Oaxaca,20,San Andrés Lagunas,20093,254,297,551
2028,Oaxaca,20,San Andrés Nuxiño,20094,898,988,1886
2028,Oaxaca,20,San Andrés Paxtlán,20095,2302,2298,4600
2028,Oaxaca,20,San Andrés Sinaxtla,20096,380,447,827
2028,Oaxaca,20,San Andrés Solaga,20097,934,998,1932
2028,Oaxaca,20,San Andrés Teotilálpam,20098,2261,2479,4740
2028,Oaxaca,20,San Andrés Tepetlapa,20099,255,293,548
2028,Oaxaca,20,San Andrés Yaá,20100,238,284,522
2028,Oaxaca,20,San Andrés Zabache,20101,352,440,792
2028,Oaxaca,20,San Andrés Zautla,20102,2429,2602,5031
2028,Oaxaca,20,San Antonino Castillo Velasco,20103,3162,3488,6650
2028,Oaxaca,20,San Antonino Monte Verde,20105,3526,4112,7638
2028,Oaxaca,20,San Antonino el Alto,20104,1430,1462,2892
2028,Oaxaca,20,San Antonio Acutla,20106,125,157,282
2028,Oaxaca,20,San Antonio Huitepec,20108,2189,2600,4789
2028,Oaxaca,20,San Antonio Nanahuatípam,20109,670,677,1347
2028,Oaxaca,20,San Antonio Sinicahua,20110,773,905,1678
2028,Oaxaca,20,San Antonio Tepetlapa,20111,2208,2368,4576
2028,Oaxaca,20,San Antonio de la Cal,20107,12355,13812,26167
2028,Oaxaca,20,San Baltazar Chichicápam,20112,1330,1509,2839
2028,Oaxaca,20,San Baltazar Loxicha,20113,1548,1613,3161
2028,Oaxaca,20,San Baltazar Yatzachi el Bajo,20114,349,397,746
2028,Oaxaca,20,San Bartolo Coyotepec,20115,4979,5577,10556
2028,Oaxaca,20,San Bartolo Soyaltepec,20121,333,410,743
2028,Oaxaca,20,San Bartolo Yautepec,20122,364,370,734
2028,Oaxaca,20,San Bartolomé Ayautla,20116,2314,2489,4803
2028,Oaxaca,20,San Bartolomé Loxicha,20117,1203,1258,2461
2028,Oaxaca,20,San Bartolomé Quialana,20118,1104,1553,2657
2028,Oaxaca,20,San Bartolomé Yucuañe,20119,175,253,428
2028,Oaxaca,20,San Bartolomé Zoogocho,20120,151,200,351
2028,Oaxaca,20,San Bernardo Mixtepec,20123,1423,1515,2938
2028,Oaxaca,20,San Blas Atempa,20124,9678,9669,19347
2028,Oaxaca,20,San Carlos Yautepec,20125,6634,6494,13128
2028,Oaxaca,20,San Cristóbal Amatlán,20126,2602,2976,5578
2028,Oaxaca,20,San Cristóbal Amoltepec,20127,535,642,1177
2028,Oaxaca,20,San Cristóbal Lachirioag,20128,688,739,1427
2028,Oaxaca,20,San Cristóbal Suchixtlahuaca,20129,197,212,409
2028,Oaxaca,20,San Dionisio Ocotepec,20131,5442,6095,11537
2028,Oaxaca,20,San Dionisio Ocotlán,20132,627,642,1269
2028,Oaxaca,20,San Dionisio del Mar,20130,2832,2712,5544
2028,Oaxaca,20,San Esteban Atatlahuca,20133,1977,2090,4067
2028,Oaxaca,20,San Felipe Jalapa de Díaz,20134,14127,15155,29282
2028,Oaxaca,20,San Felipe Tejalápam,20135,4080,4452,8532
2028,Oaxaca,20,San Felipe Usila,20136,5938,6448,12386
2028,Oaxaca,20,San Francisco Cahuacuá,20137,1788,1828,3616
2028,Oaxaca,20,San Francisco Cajonos,20138,242,270,512
2028,Oaxaca,20,San Francisco Chapulapa,20139,1058,1139,2197
2028,Oaxaca,20,San Francisco Chindúa,20140,431,456,887
2028,Oaxaca,20,San Francisco Huehuetlán,20142,537,672,1209
2028,Oaxaca,20,San Francisco Ixhuatán,20143,4857,4890,9747
2028,Oaxaca,20,San Francisco Jaltepetongo,20144,545,579,1124
2028,Oaxaca,20,San Francisco Lachigoló,20145,2344,2422,4766
2028,Oaxaca,20,San Francisco Logueche,20146,1427,1664,3091
2028,Oaxaca,20,San Francisco Nuxaño,20147,214,203,417
2028,Oaxaca,20,San Francisco Ozolotepec,20148,975,1034,2009
2028,Oaxaca,20,San Francisco Sola,20149,871,964,1835
2028,Oaxaca,20,San Francisco Telixtlahuaca,20150,6688,7241,13929
2028,Oaxaca,20,San Francisco Teopan,20151,190,175,365
2028,Oaxaca,20,San Francisco Tlapancingo,20152,1071,1352,2423
2028,Oaxaca,20,San Francisco del Mar,20141,4217,4088,8305
2028,Oaxaca,20,San Gabriel Mixtepec,20153,2535,2686,5221
2028,Oaxaca,20,San Ildefonso Amatlán,20154,1254,1434,2688
2028,Oaxaca,20,San Ildefonso Sola,20155,522,516,1038
2028,Oaxaca,20,San Ildefonso Villa Alta,20156,1813,1930,3743
2028,Oaxaca,20,San Jacinto Amilpas,20157,8889,9840,18729
2028,Oaxaca,20,San Jacinto Tlacotepec,20158,1114,1169,2283
2028,Oaxaca,20,San Jerónimo Coatlán,20159,2688,2848,5536
2028,Oaxaca,20,San Jerónimo Silacayoapilla,20160,737,756,1493
2028,Oaxaca,20,San Jerónimo Sosola,20161,1361,1543,2904
2028,Oaxaca,20,San Jerónimo Taviche,20162,975,1051,2026
2028,Oaxaca,20,San Jerónimo Tecóatl,20163,821,935,1756
2028,Oaxaca,20,San Jerónimo Tlacochahuaya,20550,2860,3208,6068
2028,Oaxaca,20,San Jorge Nuchita,20164,1395,1688,3083
2028,Oaxaca,20,San José Ayuquila,20165,773,895,1668
2028,Oaxaca,20,San José Chiltepec,20166,6416,6723,13139
2028,Oaxaca,20,San José Estancia Grande,20168,561,574,1135
2028,Oaxaca,20,San José Independencia,20169,1905,2042,3947
2028,Oaxaca,20,San José Lachiguiri,20170,1654,2064,3718
2028,Oaxaca,20,San José Tenango,20171,9344,10188,19532
2028,Oaxaca,20,San José del Peñasco,20167,1109,1158,2267
2028,Oaxaca,20,San José del Progreso,20072,3516,3721,7237
2028,Oaxaca,20,San Juan Achiutla,20172,229,246,475
2028,Oaxaca,20,San Juan Atepec,20173,793,886,1679
2028,Oaxaca,20,San Juan Bautista Atatlahuca,20175,842,894,1736
2028,Oaxaca,20,San Juan Bautista Coixtlahuaca,20176,1390,1557,2947
2028,Oaxaca,20,San Juan Bautista Cuicatlán,20177,5288,5629,10917
2028,Oaxaca,20,San Juan Bautista Guelache,20178,3897,4369,8266
2028,Oaxaca,20,San Juan Bautista Jayacatlán,20179,838,826,1664
2028,Oaxaca,20,San Juan Bautista Lo de Soto,20180,1407,1439,2846
2028,Oaxaca,20,San Juan Bautista Suchitepec,20181,233,274,507
2028,Oaxaca,20,San Juan Bautista Tlachichilco,20183,695,798,1493
2028,Oaxaca,20,San Juan Bautista Tlacoatzintepec,20182,1091,1201,2292
2028,Oaxaca,20,San Juan Bautista Tuxtepec,20184,84514,91584,176098
2028,Oaxaca,20,San Juan Bautista Valle Nacional,20559,11755,12592,24347
2028,Oaxaca,20,San Juan Cacahuatepec,20185,4688,4934,9622
2028,Oaxaca,20,San Juan Chicomezúchil,20191,175,205,380
2028,Oaxaca,20,San Juan Chilateca,20192,784,915,1699
2028,Oaxaca,20,San Juan Cieneguilla,20186,313,343,656
2028,Oaxaca,20,San Juan Coatzóspam,20187,1126,1121,2247
2028,Oaxaca,20,San Juan Colorado,20188,5141,5486,10627
2028,Oaxaca,20,San Juan Comaltepec,20189,1476,1537,3013
2028,Oaxaca,20,San Juan Cotzocón,20190,12451,13084,25535
2028,Oaxaca,20,San Juan Diuxi,20195,593,624,1217
2028,Oaxaca,20,San Juan Evangelista Analco,20196,231,252,483
2028,Oaxaca,20,San Juan Guelavía,20197,1753,1881,3634
2028,Oaxaca,20,San Juan Guichicovi,20198,15286,17196,32482
2028,Oaxaca,20,San Juan Ihualtepec,20199,323,377,700
2028,Oaxaca,20,San Juan Juquila Mixes,20200,1966,2204,4170
2028,Oaxaca,20,San Juan Juquila Vijanos,20201,995,1095,2090
2028,Oaxaca,20,San Juan Lachao,20202,2453,2618,5071
2028,Oaxaca,20,San Juan Lachigalla,20203,1675,1829,3504
2028,Oaxaca,20,San Juan Lajarcia,20204,330,400,730
2028,Oaxaca,20,San Juan Lalana,20205,8772,9199,17971
2028,Oaxaca,20,San Juan Mazatlán,20207,9866,9898,19764
2028,Oaxaca,20,San Juan Mixtepec Distrito 08,20208,3607,4139,7746
2028,Oaxaca,20,San Juan Mixtepec Distrito 26,20209,303,441,744
2028,Oaxaca,20,San Juan Ozolotepec,20211,1401,1393,2794
2028,Oaxaca,20,San Juan Petlapa,20212,1492,1589,3081
2028,Oaxaca,20,San Juan Quiahije,20213,1921,2196,4117
2028,Oaxaca,20,San Juan Quiotepec,20214,1096,1149,2245
2028,Oaxaca,20,San Juan Sayultepec,20215,413,486,899
2028,Oaxaca,20,San Juan Tabaá,20216,696,767,1463
2028,Oaxaca,20,San Juan Tamazola,20217,1558,1650,3208
2028,Oaxaca,20,San Juan Teita,20218,337,354,691
2028,Oaxaca,20,San Juan Teitipac,20219,1392,1527,2919
2028,Oaxaca,20,San Juan Tepeuxila,20220,1476,1399,2875
2028,Oaxaca,20,San Juan Teposcolula,20221,665,708,1373
2028,Oaxaca,20,San Juan Yaeé,20222,775,878,1653
2028,Oaxaca,20,San Juan Yatzona,20223,221,281,502
2028,Oaxaca,20,San Juan Yucuita,20224,303,359,662
2028,Oaxaca,20,San Juan de los Cués,20206,1302,1324,2626
2028,Oaxaca,20,San Juan del Estado,20193,1408,1535,2943
2028,Oaxaca,20,San Juan del Río,20194,659,781,1440
2028,Oaxaca,20,San Juan Ñumí,20210,2962,3395,6357
2028,Oaxaca,20,San Lorenzo,20225,3138,3387,6525
2028,Oaxaca,20,San Lorenzo Albarradas,20226,1552,1500,3052
2028,Oaxaca,20,San Lorenzo Cacaotepec,20227,8284,9000,17284
2028,Oaxaca,20,San Lorenzo Cuaunecuiltitla,20228,452,417,869
2028,Oaxaca,20,San Lorenzo Texmelúcan,20229,3958,4628,8586
2028,Oaxaca,20,San Lorenzo Victoria,20230,538,569,1107
2028,Oaxaca,20,San Lucas Camotlán,20231,1540,1644,3184
2028,Oaxaca,20,San Lucas Ojitlán,20232,10366,11039,21405
2028,Oaxaca,20,San Lucas Quiaviní,20233,804,1126,1930
2028,Oaxaca,20,San Lucas Zoquiápam,20234,3855,4107,7962
2028,Oaxaca,20,San Luis Amatlán,20235,1823,2166,3989
2028,Oaxaca,20,San Marcial Ozolotepec,20236,770,841,1611
2028,Oaxaca,20,San Marcos Arteaga,20237,675,772,1447
2028,Oaxaca,20,San Martín Huamelúlpam,20239,533,633,1166
2028,Oaxaca,20,San Martín Itunyoso,20240,1015,1293,2308
2028,Oaxaca,20,San Martín Lachilá,20241,538,665,1203
2028,Oaxaca,20,San Martín Peras,20242,5973,6465,12438
2028,Oaxaca,20,San Martín Tilcajete,20243,902,1083,1985
2028,Oaxaca,20,San Martín Toxpalan,20244,1989,2098,4087
2028,Oaxaca,20,San Martín Zacatepec,20245,693,728,1421
2028,Oaxaca,20,San Martín de los Cansecos,20238,462,477,939
2028,Oaxaca,20,San Mateo Cajonos,20246,311,383,694
2028,Oaxaca,20,San Mateo Etlatongo,20250,601,646,1247
2028,Oaxaca,20,San Mateo Nejápam,20251,580,644,1224
2028,Oaxaca,20,San Mateo Peñasco,20252,1079,1235,2314
2028,Oaxaca,20,San Mateo Piñas,20253,1074,1072,2146
2028,Oaxaca,20,San Mateo Río Hondo,20254,1674,1763,3437
2028,Oaxaca,20,San Mateo Sindihui,20255,1039,1160,2199
2028,Oaxaca,20,San Mateo Tlapiltepec,20256,115,135,250
2028,Oaxaca,20,San Mateo Yoloxochitlán,20249,1835,2026,3861
2028,Oaxaca,20,San Mateo Yucutindoo,20566,1614,1654,3268
2028,Oaxaca,20,San Mateo del Mar,20248,8236,7934,16170
2028,Oaxaca,20,San Melchor Betaza,20257,532,620,1152
2028,Oaxaca,20,San Miguel Achiutla,20258,404,454,858
2028,Oaxaca,20,San Miguel Ahuehuetitlán,20259,1223,1360,2583
2028,Oaxaca,20,San Miguel Aloápam,20260,1106,1248,2354
2028,Oaxaca,20,San Miguel Amatitlán,20261,3805,4279,8084
2028,Oaxaca,20,San Miguel Amatlán,20262,524,556,1080
2028,Oaxaca,20,San Miguel Chicahua,20264,1050,1298,2348
2028,Oaxaca,20,San Miguel Chimalapa,20265,3798,3603,7401
2028,Oaxaca,20,San Miguel Coatlán,20263,1602,1861,3463
2028,Oaxaca,20,San Miguel Ejutla,20268,501,586,1087
2028,Oaxaca,20,San Miguel Huautla,20270,569,662,1231
2028,Oaxaca,20,San Miguel Mixtepec,20271,1658,1712,3370
2028,Oaxaca,20,San Miguel Panixtlahuaca,20272,2997,3705,6702
2028,Oaxaca,20,San Miguel Peras,20273,1720,1841,3561
2028,Oaxaca,20,San Miguel Piedras,20274,672,728,1400
2028,Oaxaca,20,San Miguel Quetzaltepec,20275,4450,4385,8835
2028,Oaxaca,20,San Miguel Santa Flor,20276,399,395,794
2028,Oaxaca,20,San Miguel Soyaltepec,20278,20238,21545,41783
2028,Oaxaca,20,San Miguel Suchixtepec,20279,1393,1534,2927
2028,Oaxaca,20,San Miguel Tecomatlán,20281,182,162,344
2028,Oaxaca,20,San Miguel Tenango,20282,407,388,795
2028,Oaxaca,20,San Miguel Tequixtepec,20283,538,589,1127
2028,Oaxaca,20,San Miguel Tilquiápam,20284,1458,1852,3310
2028,Oaxaca,20,San Miguel Tlacamama,20285,1933,1987,3920
2028,Oaxaca,20,San Miguel Tlacotepec,20286,1582,1827,3409
2028,Oaxaca,20,San Miguel Tulancingo,20287,141,223,364
2028,Oaxaca,20,San Miguel Yotao,20288,300,338,638
2028,Oaxaca,20,San Miguel del Puerto,20266,4408,4468,8876
2028,Oaxaca,20,San Miguel del Río,20267,150,147,297
2028,Oaxaca,20,San Miguel el Grande,20269,2198,2513,4711
2028,Oaxaca,20,San Nicolás,20289,580,703,1283
2028,Oaxaca,20,San Nicolás Hidalgo,20290,510,590,1100
2028,Oaxaca,20,San Pablo Coatlán,20291,2202,2310,4512
2028,Oaxaca,20,San Pablo Cuatro Venados,20292,702,795,1497
2028,Oaxaca,20,San Pablo Etla,20293,9349,10379,19728
2028,Oaxaca,20,San Pablo Huitzo,20294,3678,4171,7849
2028,Oaxaca,20,San Pablo Huixtepec,20295,4901,5393,10294
2028,Oaxaca,20,San Pablo Macuiltianguis,20296,500,522,1022
2028,Oaxaca,20,San Pablo Tijaltepec,20297,1155,1376,2531
2028,Oaxaca,20,San Pablo Villa de Mitla,20298,6615,7233,13848
2028,Oaxaca,20,San Pablo Yaganiza,20299,543,617,1160
2028,Oaxaca,20,San Pedro Amuzgos,20300,3386,3864,7250
2028,Oaxaca,20,San Pedro Apóstol,20301,787,927,1714
2028,Oaxaca,20,San Pedro Atoyac,20302,2221,2500,4721
2028,Oaxaca,20,San Pedro Cajonos,20303,549,683,1232
2028,Oaxaca,20,San Pedro Comitancillo,20305,2254,2463,4717
2028,Oaxaca,20,San Pedro Coxcaltepec Cántaros,20304,397,443,840
2028,Oaxaca,20,San Pedro Huamelula,20307,5323,5348,10671
2028,Oaxaca,20,San Pedro Huilotepec,20308,1694,1711,3405
2028,Oaxaca,20,San Pedro Ixcatlán,20309,5917,6254,12171
2028,Oaxaca,20,San Pedro Ixtlahuaca,20310,4692,4967,9659
2028,Oaxaca,20,San Pedro Jaltepetongo,20311,296,336,632
2028,Oaxaca,20,San Pedro Jicayán,20312,6248,6870,13118
2028,Oaxaca,20,San Pedro Jocotipac,20313,402,480,882
2028,Oaxaca,20,San Pedro Juchatengo,20314,828,911,1739
2028,Oaxaca,20,San Pedro Mixtepec Distrito 22,20318,25692,26902,52594
2028,Oaxaca,20,San Pedro Mixtepec Distrito 26,20319,566,611,1177
2028,Oaxaca,20,San Pedro Molinos,20320,349,392,741
2028,Oaxaca,20,San Pedro Mártir,20315,802,1000,1802
2028,Oaxaca,20,San Pedro Mártir Quiechapa,20316,360,408,768
2028,Oaxaca,20,San Pedro Mártir Yucuxaco,20317,630,738,1368
2028,Oaxaca,20,San Pedro Nopala,20321,377,417,794
2028,Oaxaca,20,San Pedro Ocopetatillo,20322,406,478,884
2028,Oaxaca,20,San Pedro Ocotepec,20323,1087,1162,2249
2028,Oaxaca,20,San Pedro Pochutla,20324,24872,25653,50525
2028,Oaxaca,20,San Pedro Quiatoni,20325,5671,5999,11670
2028,Oaxaca,20,San Pedro Sochiápam,20326,2630,2717,5347
2028,Oaxaca,20,San Pedro Tapanatepec,20327,7890,8041,15931
2028,Oaxaca,20,San Pedro Taviche,20328,633,642,1275
2028,Oaxaca,20,San Pedro Teozacoalco,20329,651,696,1347
2028,Oaxaca,20,San Pedro Teutila,20330,2234,2316,4550
2028,Oaxaca,20,San Pedro Tidaá,20331,472,553,1025
2028,Oaxaca,20,San Pedro Topiltepec,20332,194,223,417
2028,Oaxaca,20,San Pedro Totolápam,20333,1382,1539,2921
2028,Oaxaca,20,San Pedro Yaneri,20335,474,509,983
2028,Oaxaca,20,San Pedro Yucunama,20341,109,143,252
2028,Oaxaca,20,San Pedro Yólox,20336,883,959,1842
2028,Oaxaca,20,San Pedro el Alto,20306,1834,1931,3765
2028,Oaxaca,20,San Pedro y San Pablo Ayutla,20337,2586,3102,5688
2028,Oaxaca,20,San Pedro y San Pablo Teposcolula,20339,2145,2397,4542
2028,Oaxaca,20,San Pedro y San Pablo Tequixtepec,20340,890,1102,1992
2028,Oaxaca,20,San Raymundo Jalpan,20342,1776,2135,3911
2028,Oaxaca,20,San Sebastián Abasolo,20343,1029,1114,2143
2028,Oaxaca,20,San Sebastián Coatlán,20344,1400,1496,2896
2028,Oaxaca,20,San Sebastián Ixcapa,20345,2207,2251,4458
2028,Oaxaca,20,San Sebastián Nicananduta,20346,703,907,1610
2028,Oaxaca,20,San Sebastián Río Hondo,20347,1929,1956,3885
2028,Oaxaca,20,San Sebastián Tecomaxtlahuaca,20348,4256,4762,9018
2028,Oaxaca,20,San Sebastián Teitipac,20349,990,1171,2161
2028,Oaxaca,20,San Sebastián Tutla,20350,8921,10430,19351
2028,Oaxaca,20,San Simón Almolongas,20351,1436,1638,3074
2028,Oaxaca,20,San Simón Zahuatlán,20352,2162,2204,4366
2028,Oaxaca,20,San Vicente Coatlán,20534,1911,2246,4157
2028,Oaxaca,20,San Vicente Lachixío,20535,1352,1556,2908
2028,Oaxaca,20,San Vicente Nuñú,20536,223,262,485
2028,Oaxaca,20,Santa Ana,20353,1145,1208,2353
2028,Oaxaca,20,Santa Ana Ateixtlahuaca,20354,278,282,560
2028,Oaxaca,20,Santa Ana Cuauhtémoc,20355,385,404,789
2028,Oaxaca,20,Santa Ana Tavela,20357,442,481,923
2028,Oaxaca,20,Santa Ana Tlapacoyan,20358,1105,1206,2311
2028,Oaxaca,20,Santa Ana Yareni,20359,476,532,1008
2028,Oaxaca,20,Santa Ana Zegache,20360,1949,2196,4145
2028,Oaxaca,20,Santa Ana del Valle,20356,1125,1177,2302
2028,Oaxaca,20,Santa Catalina Quierí,20361,443,559,1002
2028,Oaxaca,20,Santa Catarina Cuixtla,20362,737,925,1662
2028,Oaxaca,20,Santa Catarina Ixtepeji,20363,1378,1479,2857
2028,Oaxaca,20,Santa Catarina Juquila,20364,8042,8589,16631
2028,Oaxaca,20,Santa Catarina Lachatao,20365,590,639,1229
2028,Oaxaca,20,Santa Catarina Loxicha,20366,2000,2080,4080
2028,Oaxaca,20,Santa Catarina Mechoacán,20367,2364,2425,4789
2028,Oaxaca,20,Santa Catarina Minas,20368,1044,1080,2124
2028,Oaxaca,20,Santa Catarina Quiané,20369,1043,1087,2130
2028,Oaxaca,20,Santa Catarina Quioquitani,20074,279,307,586
2028,Oaxaca,20,Santa Catarina Tayata,20370,331,395,726
2028,Oaxaca,20,Santa Catarina Ticuá,20371,527,660,1187
2028,Oaxaca,20,Santa Catarina Yosonotú,20372,841,1036,1877
2028,Oaxaca,20,Santa Catarina Zapoquila,20373,200,226,426
2028,Oaxaca,20,Santa Cruz Acatepec,20374,797,878,1675
2028,Oaxaca,20,Santa Cruz Amilpas,20375,6538,7595,14133
2028,Oaxaca,20,Santa Cruz Itundujia,20377,5917,6445,12362
2028,Oaxaca,20,Santa Cruz Mixtepec,20378,1844,2005,3849
2028,Oaxaca,20,Santa Cruz Nundaco,20379,1453,1721,3174
2028,Oaxaca,20,Santa Cruz Papalutla,20380,1147,1210,2357
2028,Oaxaca,20,Santa Cruz Tacache de Mina,20381,1399,1546,2945
2028,Oaxaca,20,Santa Cruz Tacahua,20382,569,646,1215
2028,Oaxaca,20,Santa Cruz Tayata,20383,324,336,660
2028,Oaxaca,20,Santa Cruz Xitla,20384,2466,2695,5161
2028,Oaxaca,20,Santa Cruz Xoxocotlán,20385,47998,54042,102040
2028,Oaxaca,20,Santa Cruz Zenzontepec,20386,9354,9778,19132
2028,Oaxaca,20,Santa Cruz de Bravo,20376,198,216,414
2028,Oaxaca,20,Santa Gertrudis,20387,1532,1637,3169
2028,Oaxaca,20,Santa Inés Yatzeche,20389,439,578,1017
2028,Oaxaca,20,Santa Inés de Zaragoza,20569,844,968,1812
2028,Oaxaca,20,Santa Inés del Monte,20388,1234,1288,2522
2028,Oaxaca,20,Santa Lucía Miahuatlán,20391,1751,1849,3600
2028,Oaxaca,20,Santa Lucía Monteverde,20392,3326,3666,6992
2028,Oaxaca,20,Santa Lucía Ocotlán,20393,1892,2230,4122
2028,Oaxaca,20,Santa Lucía del Camino,20390,25469,27950,53419
2028,Oaxaca,20,Santa Magdalena Jicotlán,20047,46,62,108
2028,Oaxaca,20,Santa María Alotepec,20394,1501,1542,3043
2028,Oaxaca,20,Santa María Apazco,20395,862,1109,1971
2028,Oaxaca,20,Santa María Atzompa,20399,18405,19790,38195
2028,Oaxaca,20,Santa María Camotlán,20400,844,977,1821
2028,Oaxaca,20,Santa María Chachoápam,20404,387,440,827
2028,Oaxaca,20,Santa María Chilchotla,20406,10568,10998,21566
2028,Oaxaca,20,Santa María Chimalapa,20407,4855,4680,9535
2028,Oaxaca,20,Santa María Colotepec,20401,12761,12941,25702
2028,Oaxaca,20,Santa María Cortijo,20402,556,587,1143
2028,Oaxaca,20,Santa María Coyotepec,20403,1586,1761,3347
2028,Oaxaca,20,Santa María Ecatepec,20410,1819,1851,3670
2028,Oaxaca,20,Santa María Guelacé,20411,406,494,900
2028,Oaxaca,20,Santa María Guienagati,20412,1660,1659,3319
2028,Oaxaca,20,Santa María Huatulco,20413,23319,24068,47387
2028,Oaxaca,20,Santa María Huazolotitlán,20414,6123,6241,12364
2028,Oaxaca,20,Santa María Ipalapa,20415,2558,2800,5358
2028,Oaxaca,20,Santa María Ixcatlán,20416,261,294,555
2028,Oaxaca,20,Santa María Jacatepec,20417,4731,5221,9952
2028,Oaxaca,20,Santa María Jalapa del Marqués,20418,6969,7364,14333
2028,Oaxaca,20,Santa María Jaltianguis,20419,260,320,580
2028,Oaxaca,20,Santa María Lachixío,20420,947,1117,2064
2028,Oaxaca,20,Santa María Mixtequilla,20421,2464,2608,5072
2028,Oaxaca,20,Santa María Nativitas,20422,301,368,669
2028,Oaxaca,20,Santa María Nduayaco,20423,276,287,563
2028,Oaxaca,20,Santa María Ozolotepec,20424,1965,2084,4049
2028,Oaxaca,20,Santa María Petapa,20427,8554,9184,17738
2028,Oaxaca,20,Santa María Peñoles,20426,4356,4633,8989
2028,Oaxaca,20,Santa María Pápalo,20425,1129,1134,2263
2028,Oaxaca,20,Santa María Quiegolani,20428,1043,1023,2066
2028,Oaxaca,20,Santa María Sola,20429,780,838,1618
2028,Oaxaca,20,Santa María Tataltepec,20430,210,231,441
2028,Oaxaca,20,Santa María Tecomavaca,20431,880,939,1819
2028,Oaxaca,20,Santa María Temaxcalapa,20432,497,515,1012
2028,Oaxaca,20,Santa María Temaxcaltepec,20433,1240,1420,2660
2028,Oaxaca,20,Santa María Teopoxco,20434,2090,2402,4492
2028,Oaxaca,20,Santa María Tepantlali,20435,1970,2051,4021
2028,Oaxaca,20,Santa María Texcatitlán,20436,517,567,1084
2028,Oaxaca,20,Santa María Tlahuitoltepec,20437,4719,5135,9854
2028,Oaxaca,20,Santa María Tlalixtac,20438,885,926,1811
2028,Oaxaca,20,Santa María Tonameca,20439,13374,13481,26855
2028,Oaxaca,20,Santa María Totolapilla,20440,434,473,907
2028,Oaxaca,20,Santa María Xadani,20441,4696,4627,9323
2028,Oaxaca,20,Santa María Yalina,20442,142,168,310
2028,Oaxaca,20,Santa María Yavesía,20443,254,318,572
2028,Oaxaca,20,Santa María Yolotepec,20444,215,232,447
2028,Oaxaca,20,Santa María Yosoyúa,20445,879,875,1754
2028,Oaxaca,20,Santa María Yucuhiti,20446,3243,3578,6821
2028,Oaxaca,20,Santa María Zacatepec,20447,8123,9067,17190
2028,Oaxaca,20,Santa María Zaniza,20448,1107,1166,2273
2028,Oaxaca,20,Santa María Zoquitlán,20449,1654,1697,3351
2028,Oaxaca,20,Santa María del Rosario,20408,282,266,548
2028,Oaxaca,20,Santa María del Tule,20409,4561,5272,9833
2028,Oaxaca,20,Santa María la Asunción,20396,1553,1992,3545
2028,Oaxaca,20,Santiago Amoltepec,20450,6298,6741,13039
2028,Oaxaca,20,Santiago Apoala,20451,476,563,1039
2028,Oaxaca,20,Santiago Apóstol,20452,1941,2392,4333
2028,Oaxaca,20,Santiago Astata,20453,2131,2143,4274
2028,Oaxaca,20,Santiago Atitlán,20454,1614,1565,3179
2028,Oaxaca,20,Santiago Ayuquililla,20455,1385,1533,2918
2028,Oaxaca,20,Santiago Cacaloxtepec,20456,846,915,1761
2028,Oaxaca,20,Santiago Camotlán,20457,1677,1689,3366
2028,Oaxaca,20,Santiago Chazumba,20459,2220,2786,5006
2028,Oaxaca,20,Santiago Choápam,20460,2649,2833,5482
2028,Oaxaca,20,Santiago Comaltepec,20458,509,568,1077
2028,Oaxaca,20,Santiago Huajolotitlán,20462,2091,2469,4560
2028,Oaxaca,20,Santiago Huauclilla,20463,281,317,598
2028,Oaxaca,20,Santiago Ihuitlán Plumas,20464,176,224,400
2028,Oaxaca,20,Santiago Ixcuintepec,20465,844,870,1714
2028,Oaxaca,20,Santiago Ixtayutla,20466,6534,6865,13399
2028,Oaxaca,20,Santiago Jamiltepec,20467,9823,10662,20485
2028,Oaxaca,20,Santiago Jocotepec,20468,7283,7450,14733
2028,Oaxaca,20,Santiago Juxtlahuaca,20469,18249,20165,38414
2028,Oaxaca,20,Santiago Lachiguiri,20470,2533,2579,5112
2028,Oaxaca,20,Santiago Lalopa,20471,268,279,547
2028,Oaxaca,20,Santiago Laollaga,20472,1880,1897,3777
2028,Oaxaca,20,Santiago Laxopa,20473,680,767,1447
2028,Oaxaca,20,Santiago Llano Grande,20474,1772,1806,3578
2028,Oaxaca,20,Santiago Matatlán,20475,4994,5661,10655
2028,Oaxaca,20,Santiago Miltepec,20476,230,235,465
2028,Oaxaca,20,Santiago Minas,20477,740,749,1489
2028,Oaxaca,20,Santiago Nacaltepec,20478,950,1054,2004
2028,Oaxaca,20,Santiago Nejapilla,20479,125,116,241
2028,Oaxaca,20,Santiago Niltepec,20066,2950,2990,5940
2028,Oaxaca,20,Santiago Nundiche,20480,485,536,1021
2028,Oaxaca,20,Santiago Nuyoó,20481,910,1021,1931
2028,Oaxaca,20,Santiago Pinotepa Nacional,20482,27815,29199,57014
2028,Oaxaca,20,Santiago Suchilquitongo,20483,5479,5882,11361
2028,Oaxaca,20,Santiago Tamazola,20484,2258,2567,4825
2028,Oaxaca,20,Santiago Tapextla,20485,1687,1610,3297
2028,Oaxaca,20,Santiago Tenango,20487,1108,1110,2218
2028,Oaxaca,20,Santiago Tepetlapa,20488,61,74,135
2028,Oaxaca,20,Santiago Tetepec,20489,2599,2610,5209
2028,Oaxaca,20,Santiago Texcalcingo,20490,1571,1701,3272
2028,Oaxaca,20,Santiago Textitlán,20491,2282,2293,4575
2028,Oaxaca,20,Santiago Tilantongo,20492,1469,1738,3207
2028,Oaxaca,20,Santiago Tillo,20493,278,324,602
2028,Oaxaca,20,Santiago Tlazoyaltepec,20494,2320,2750,5070
2028,Oaxaca,20,Santiago Xanica,20495,1617,1600,3217
2028,Oaxaca,20,Santiago Xiacuí,20496,1096,1203,2299
2028,Oaxaca,20,Santiago Yaitepec,20497,2070,2461,4531
2028,Oaxaca,20,Santiago Yaveo,20498,3769,3713,7482
2028,Oaxaca,20,Santiago Yolomécatl,20499,1067,1254,2321
2028,Oaxaca,20,Santiago Yosondúa,20500,4334,4872,9206
2028,Oaxaca,20,Santiago Yucuyachi,20501,499,554,1053
2028,Oaxaca,20,Santiago Zacatepec,20502,2803,2901,5704
2028,Oaxaca,20,Santiago Zoochila,20503,206,222,428
2028,Oaxaca,20,Santiago del Río,20461,304,339,643
2028,Oaxaca,20,Santo Domingo Albarradas,20506,400,452,852
2028,Oaxaca,20,Santo Domingo Armenta,20507,1844,1835,3679
2028,Oaxaca,20,Santo Domingo Chihuitán,20508,826,856,1682
2028,Oaxaca,20,Santo Domingo Ingenio,20505,4409,4453,8862
2028,Oaxaca,20,Santo Domingo Ixcatlán,20510,291,362,653
2028,Oaxaca,20,Santo Domingo Nuxaá,20511,1663,1761,3424
2028,Oaxaca,20,Santo Domingo Ozolotepec,20512,411,442,853
2028,Oaxaca,20,Santo Domingo Petapa,20513,5020,4935,9955
2028,Oaxaca,20,Santo Domingo Roayaga,20514,527,569,1096
2028,Oaxaca,20,Santo Domingo Tehuantepec,20515,34391,36345,70736
2028,Oaxaca,20,Santo Domingo Teojomulco,20516,2618,2728,5346
2028,Oaxaca,20,Santo Domingo Tepuxtepec,20517,2857,3268,6125
2028,Oaxaca,20,Santo Domingo Tlatayápam,20518,70,83,153
2028,Oaxaca,20,Santo Domingo Tomaltepec,20519,1601,1647,3248
2028,Oaxaca,20,Santo Domingo Tonaltepec,20521,118,152,270
2028,Oaxaca,20,Santo Domingo Tonalá,20520,3547,3985,7532
2028,Oaxaca,20,Santo Domingo Xagacía,20522,598,685,1283
2028,Oaxaca,20,Santo Domingo Yanhuitlán,20523,814,923,1737
2028,Oaxaca,20,Santo Domingo Yodohino,20524,165,174,339
2028,Oaxaca,20,Santo Domingo Zanatepec,20525,6603,6674,13277
2028,Oaxaca,20,Santo Domingo de Morelos,20509,5501,6066,11567
2028,Oaxaca,20,Santo Tomás Jalieza,20530,1831,2011,3842
2028,Oaxaca,20,Santo Tomás Mazaltepec,20531,1398,1509,2907
2028,Oaxaca,20,Santo Tomás Ocotepec,20532,1921,2202,4123
2028,Oaxaca,20,Santo Tomás Tamazulapan,20533,1181,1256,2437
2028,Oaxaca,20,Santos Reyes Nopala,20526,9068,9671,18739
2028,Oaxaca,20,Santos Reyes Pápalo,20527,1334,1444,2778
2028,Oaxaca,20,Santos Reyes Tepejillo,20528,476,621,1097
2028,Oaxaca,20,Santos Reyes Yucuná,20529,664,675,1339
2028,Oaxaca,20,Silacayoápam,20537,3514,4028,7542
2028,Oaxaca,20,Sitio de Xitlapehua,20538,352,397,749
2028,Oaxaca,20,Soledad Etla,20539,3023,3174,6197
2028,Oaxaca,20,Tamazulápam del Espíritu Santo,20031,3598,4396,7994
2028,Oaxaca,20,Tanetze de Zaragoza,20541,876,946,1822
2028,Oaxaca,20,Taniche,20542,415,496,911
2028,Oaxaca,20,Tataltepec de Valdés,20543,2981,3152,6133
2028,Oaxaca,20,Teococuilco de Marcos Pérez,20544,481,563,1044
2028,Oaxaca,20,Teotitlán de Flores Magón,20545,5049,5677,10726
2028,Oaxaca,20,Teotitlán del Valle,20546,3049,3368,6417
2028,Oaxaca,20,Teotongo,20547,493,585,1078
2028,Oaxaca,20,Tepelmeme Villa de Morelos,20548,818,980,1798
2028,Oaxaca,20,Tlacolula de Matamoros,20551,11817,13399,25216
2028,Oaxaca,20,Tlacotepec Plumas,20552,238,263,501
2028,Oaxaca,20,Tlalixtac de Cabrera,20553,5369,5951,11320
2028,Oaxaca,20,Totontepec Villa de Morelos,20554,2789,3025,5814
2028,Oaxaca,20,Trinidad Zaachila,20555,1544,1728,3272
2028,Oaxaca,20,Unión Hidalgo,20557,8291,8757,17048
2028,Oaxaca,20,Valerio Trujano,20558,705,848,1553
2028,Oaxaca,20,Villa Díaz Ordaz,20560,3418,4031,7449
2028,Oaxaca,20,Villa Hidalgo,20038,1013,1130,2143
2028,Oaxaca,20,Villa Sola de Vega,20277,6471,6631,13102
2028,Oaxaca,20,Villa Talea de Castro,20280,1206,1328,2534
2028,Oaxaca,20,Villa Tejúpam de la Unión,20486,1295,1404,2699
2028,Oaxaca,20,Villa Tezoatlán de Segura y Luna,20549,5536,6539,12075
2028,Oaxaca,20,Villa de Chilapa de Díaz,20405,1047,1332,2379
2028,Oaxaca,20,Villa de Etla,20338,5655,6272,11927
2028,Oaxaca,20,Villa de Tamazulápam del Progreso,20540,3911,4460,8371
2028,Oaxaca,20,Villa de Tututepec de Melchor Ocampo,20334,23914,24796,48710
2028,Oaxaca,20,Villa de Zaachila,20565,23045,25319,48364
2028,Oaxaca,20,Yaxe,20561,1459,1576,3035
2028,Oaxaca,20,Yogana,20563,647,756,1403
2028,Oaxaca,20,Yutanduchi de Guerrero,20564,603,671,1274
2028,Oaxaca,20,Zapotitlán Lagunas,20567,1613,1814,3427
2028,Oaxaca,20,Zapotitlán Palmas,20568,718,865,1583
2028,Oaxaca,20,Zimatlán de Álvarez,20570,10170,11546,21716
2028,Oaxaca,20,Ánimas Trujano,20174,2073,2308,4381
2028,Puebla,21,Acajete,21001,35285,37610,72895
2028,Puebla,21,Acateno,21002,5345,5249,10594
2028,Puebla,21,Acatlán,21003,18848,21849,40697
2028,Puebla,21,Acatzingo,21004,32220,33304,65524
2028,Puebla,21,Acteopan,21005,1618,1781,3399
2028,Puebla,21,Ahuacatlán,21006,8468,9438,17906
2028,Puebla,21,Ahuatlán,21007,1771,1916,3687
2028,Puebla,21,Ahuazotepec,21008,6361,6548,12909
2028,Puebla,21,Ahuehuetitla,21009,975,1121,2096
2028,Puebla,21,Ajalpan,21010,35676,37565,73241
2028,Puebla,21,Albino Zertuche,21011,959,1118,2077
2028,Puebla,21,Aljojuca,21012,3632,3952,7584
2028,Puebla,21,Altepexi,21013,11694,12274,23968
2028,Puebla,21,Amixtlán,21014,2681,2945,5626
2028,Puebla,21,Amozoc,21015,64883,67461,132344
2028,Puebla,21,Aquixtla,21016,4960,4999,9959
2028,Puebla,21,Atempan,21017,14720,16588,31308
2028,Puebla,21,Atexcal,21018,2090,2247,4337
2028,Puebla,21,Atlequizayan,21080,1429,1590,3019
2028,Puebla,21,Atlixco,21019,73263,81673,154936
2028,Puebla,21,Atoyatempan,21020,3807,4016,7823
2028,Puebla,21,Atzala,21021,717,780,1497
2028,Puebla,21,Atzitzihuacán,21022,6597,7432,14029
2028,Puebla,21,Atzitzintla,21023,5129,5176,10305
2028,Puebla,21,Axutla,21024,530,613,1143
2028,Puebla,21,Ayotoxco de Guerrero,21025,4806,4910,9716
2028,Puebla,21,Calpan,21026,7920,8696,16616
2028,Puebla,21,Caltepec,21027,2128,2464,4592
2028,Puebla,21,Camocuautla,21028,1471,1497,2968
2028,Puebla,21,Caxhuacan,21029,2022,2215,4237
2028,Puebla,21,Cañada Morelos,21099,10529,11156,21685
2028,Puebla,21,Chalchicomula de Sesma,21045,25911,28034,53945
2028,Puebla,21,Chapulco,21046,4190,4484,8674
2028,Puebla,21,Chiautla,21047,11148,11840,22988
2028,Puebla,21,Chiautzingo,21048,11011,12038,23049
2028,Puebla,21,Chichiquila,21050,13804,14752,28556
2028,Puebla,21,Chiconcuautla,21049,9043,9465,18508
2028,Puebla,21,Chietla,21051,19263,20554,39817
2028,Puebla,21,Chigmecatitlán,21052,636,764,1400
2028,Puebla,21,Chignahuapan,21053,34895,35867,70762
2028,Puebla,21,Chignautla,21054,18317,19338,37655
2028,Puebla,21,Chila,21055,2510,2795,5305
2028,Puebla,21,Chila de la Sal,21056,832,903,1735
2028,Puebla,21,Chilchotla,21058,11049,11018,22067
2028,Puebla,21,Chinantla,21059,1228,1399,2627
2028,Puebla,21,Coatepec,21030,421,467,888
2028,Puebla,21,Coatzingo,21031,1610,1788,3398
2028,Puebla,21,Cohetzala,21032,805,800,1605
2028,Puebla,21,Cohuecan,21033,2672,2873,5545
2028,Puebla,21,Coronango,21034,22586,23275,45861
2028,Puebla,21,Coxcatlán,21035,11102,12214,23316
2028,Puebla,21,Coyomeapan,21036,7389,8145,15534
2028,Puebla,21,Coyotepec,21037,1262,1492,2754
2028,Puebla,21,Cuapiaxtla de Madero,21038,5609,5628,11237
2028,Puebla,21,Cuautempan,21039,5100,5470,10570
2028,Puebla,21,Cuautinchán,21040,5709,5738,11447
2028,Puebla,21,Cuautlancingo,21041,66250,69596,135846
2028,Puebla,21,Cuayuca de Andrade,21042,1775,1903,3678
2028,Puebla,21,Cuetzalan del Progreso,21043,26476,27847,54323
2028,Puebla,21,Cuyoaco,21044,8552,9232,17784
2028,Puebla,21,Domingo Arenas,21060,4009,4422,8431
2028,Puebla,21,Eloxochitlán,21061,6809,7258,14067
2028,Puebla,21,Epatlán,21062,2691,2846,5537
2028,Puebla,21,Esperanza,21063,8196,8678,16874
2028,Puebla,21,Francisco Z. Mena,21064,9939,9758,19697
2028,Puebla,21,General Felipe Ángeles,21065,11098,12065,23163
2028,Puebla,21,Guadalupe,21066,3120,3628,6748
2028,Puebla,21,Guadalupe Victoria,21067,9336,9830,19166
2028,Puebla,21,Hermenegildo Galeana,21068,4355,4433,8788
2028,Puebla,21,Honey,21057,4349,4657,9006
2028,Puebla,21,Huaquechula,21069,13356,15076,28432
2028,Puebla,21,Huatlatlauca,21070,3462,4193,7655
2028,Puebla,21,Huauchinango,21071,56202,62297,118499
2028,Puebla,21,Huehuetla,21072,10515,10814,21329
2028,Puebla,21,Huehuetlán el Chico,21073,4780,4989,9769
2028,Puebla,21,Huehuetlán el Grande,21150,4041,4286,8327
2028,Puebla,21,Huejotzingo,21074,40853,42576,83429
2028,Puebla,21,Hueyapan,21075,6848,7279,14127
2028,Puebla,21,Hueytamalco,21076,14721,15018,29739
2028,Puebla,21,Hueytlalpan,21077,3027,3150,6177
2028,Puebla,21,Huitzilan de Serdán,21078,8441,8267,16708
2028,Puebla,21,Huitziltepec,21079,3001,3197,6198
2028,Puebla,21,Ixcamilpa de Guerrero,21081,1991,2183,4174
2028,Puebla,21,Ixcaquixtla,21082,4822,5295,10117
2028,Puebla,21,Ixtacamaxtitlán,21083,13854,14043,27897
2028,Puebla,21,Ixtepec,21084,3866,4082,7948
2028,Puebla,21,Izúcar de Matamoros,21085,42013,46751,88764
2028,Puebla,21,Jalpan,21086,6630,7059,13689
2028,Puebla,21,Jolalpan,21087,7179,7665,14844
2028,Puebla,21,Jonotla,21088,2575,2666,5241
2028,Puebla,21,Jopala,21089,7259,7531,14790
2028,Puebla,21,Juan C. Bonilla,21090,11600,12524,24124
2028,Puebla,21,Juan Galindo,21091,5685,6529,12214
2028,Puebla,21,Juan N. Méndez,21092,2977,3034,6011
2028,Puebla,21,La Magdalena Tlatlauquitepec,21095,330,324,654
2028,Puebla,21,Lafragua,21093,4575,4692,9267
2028,Puebla,21,Libres,21094,18563,19498,38061
2028,Puebla,21,Los Reyes de Juárez,21118,15026,15396,30422
2028,Puebla,21,Mazapiltepec de Juárez,21096,1609,1624,3233
2028,Puebla,21,Mixtla,21097,1263,1416,2679
2028,Puebla,21,Molcaxac,21098,3284,3677,6961
2028,Puebla,21,Naupan,21100,5338,5863,11201
2028,Puebla,21,Nauzontla,21101,1892,2108,4000
2028,Puebla,21,Nealtican,21102,6662,7239,13901
2028,Puebla,21,Nicolás Bravo,21103,3420,3639,7059
2028,Puebla,21,Nopalucan,21104,17098,17463,34561
2028,Puebla,21,Ocotepec,21105,2655,2848,5503
2028,Puebla,21,Ocoyucan,21106,14940,16672,31612
2028,Puebla,21,Olintla,21107,6477,6793,13270
2028,Puebla,21,Oriental,21108,10003,10595,20598
2028,Puebla,21,Pahuatlán,21109,11935,13078,25013
2028,Puebla,21,Palmar de Bravo,21110,25461,25797,51258
2028,Puebla,21,Pantepec,21111,10316,10870,21186
2028,Puebla,21,Petlalcingo,21112,5240,5968,11208
2028,Puebla,21,Piaxtla,21113,2507,2737,5244
2028,Puebla,21,Puebla,21114,869032,949001,1818033
2028,Puebla,21,Quecholac,21115,27817,28694,56511
2028,Puebla,21,Quimixtlán,21116,12140,12445,24585
2028,Puebla,21,Rafael Lara Grajales,21117,7512,8027,15539
2028,Puebla,21,San Andrés Cholula,21119,82034,83494,165528
2028,Puebla,21,San Antonio Cañada,21120,2892,3259,6151
2028,Puebla,21,San Diego la Mesa Tochimiltzingo,21121,686,682,1368
2028,Puebla,21,San Felipe Teotlalcingo,21122,5765,6116,11881
2028,Puebla,21,San Felipe Tepatlán,21123,2213,2273,4486
2028,Puebla,21,San Gabriel Chilac,21124,8441,9373,17814
2028,Puebla,21,San Gregorio Atzompa,21125,5058,5298,10356
2028,Puebla,21,San Jerónimo Tecuanipan,21126,3381,3689,7070
2028,Puebla,21,San Jerónimo Xayacatlán,21127,1882,2173,4055
2028,Puebla,21,San José Chiapa,21128,4906,4978,9884
2028,Puebla,21,San José Miahuatlán,21129,7275,7859,15134
2028,Puebla,21,San Juan Atenco,21130,1803,2064,3867
2028,Puebla,21,San Juan Atzompa,21131,514,481,995
2028,Puebla,21,San Martín Texmelucan,21132,83462,89209,172671
2028,Puebla,21,San Martín Totoltepec,21133,341,370,711
2028,Puebla,21,San Matías Tlalancaleca,21134,11401,11726,23127
2028,Puebla,21,San Miguel Ixitlán,21135,292,322,614
2028,Puebla,21,San Miguel Xoxtla,21136,6876,7239,14115
2028,Puebla,21,San Nicolás Buenos Aires,21137,5479,5691,11170
2028,Puebla,21,San Nicolás de los Ranchos,21138,6658,6863,13521
2028,Puebla,21,San Pablo Anicano,21139,1960,2135,4095
2028,Puebla,21,San Pedro Cholula,21140,71446,77448,148894
2028,Puebla,21,San Pedro Yeloixtlahuaca,21141,1843,1997,3840
2028,Puebla,21,San Salvador Huixcolotla,21144,8248,8352,16600
2028,Puebla,21,San Salvador el Seco,21142,16782,17621,34403
2028,Puebla,21,San Salvador el Verde,21143,17559,18011,35570
2028,Puebla,21,San Sebastián Tlacotepec,21145,7685,7814,15499
2028,Puebla,21,Santa Catarina Tlaltempan,21146,471,479,950
2028,Puebla,21,Santa Inés Ahuatempan,21147,3481,3840,7321
2028,Puebla,21,Santa Isabel Cholula,21148,4756,5151,9907
2028,Puebla,21,Santiago Miahuatlán,21149,13896,14644,28540
2028,Puebla,21,Santo Tomás Hueyotlipan,21151,4676,5018,9694
2028,Puebla,21,Soltepec,21152,6926,7202,14128
2028,Puebla,21,Tecali de Herrera,21153,12242,12794,25036
2028,Puebla,21,Tecamachalco,21154,41824,44164,85988
2028,Puebla,21,Tecomatlán,21155,3188,3330,6518
2028,Puebla,21,Tehuacán,21156,169820,188770,358590
2028,Puebla,21,Tehuitzingo,21157,6182,6916,13098
2028,Puebla,21,Tenampulco,21158,4107,4255,8362
2028,Puebla,21,Teopantlán,21159,1978,2456,4434
2028,Puebla,21,Teotlalco,21160,1788,1855,3643
2028,Puebla,21,Tepanco de López,21161,10980,12103,23083
2028,Puebla,21,Tepango de Rodríguez,21162,2203,2433,4636
2028,Puebla,21,Tepatlaxco de Hidalgo,21163,9538,10033,19571
2028,Puebla,21,Tepeaca,21164,43238,46881,90119
2028,Puebla,21,Tepemaxalco,21165,597,620,1217
2028,Puebla,21,Tepeojuma,21166,4589,5295,9884
2028,Puebla,21,Tepetzintla,21167,6202,6639,12841
2028,Puebla,21,Tepexco,21168,3721,3886,7607
2028,Puebla,21,Tepexi de Rodríguez,21169,11979,12139,24118
2028,Puebla,21,Tepeyahualco,21170,9546,9677,19223
2028,Puebla,21,Tepeyahualco de Cuauhtémoc,21171,1953,2105,4058
2028,Puebla,21,Tetela de Ocampo,21172,15591,16661,32252
2028,Puebla,21,Teteles de Ávila Castillo,21173,3025,3589,6614
2028,Puebla,21,Teziutlán,21174,52673,58738,111411
2028,Puebla,21,Tianguismanalco,21175,6980,7489,14469
2028,Puebla,21,Tilapa,21176,4713,5037,9750
2028,Puebla,21,Tlachichuca,21179,16291,16809,33100
2028,Puebla,21,Tlacotepec de Benito Juárez,21177,27720,30000,57720
2028,Puebla,21,Tlacuilotepec,21178,9379,9642,19021
2028,Puebla,21,Tlahuapan,21180,22451,22549,45000
2028,Puebla,21,Tlaltenango,21181,3940,4006,7946
2028,Puebla,21,Tlanepantla,21182,2654,2879,5533
2028,Puebla,21,Tlaola,21183,10862,11525,22387
2028,Puebla,21,Tlapacoya,21184,3598,3722,7320
2028,Puebla,21,Tlapanalá,21185,4613,4984,9597
2028,Puebla,21,Tlatlauquitepec,21186,29162,32194,61356
2028,Puebla,21,Tlaxco,21187,3091,3089,6180
2028,Puebla,21,Tochimilco,21188,9831,10755,20586
2028,Puebla,21,Tochtepec,21189,11488,12261,23749
2028,Puebla,21,Totoltepec de Guerrero,21190,653,791,1444
2028,Puebla,21,Tulcingo,21191,5018,5757,10775
2028,Puebla,21,Tuzamapan de Galeana,21192,3637,3785,7422
2028,Puebla,21,Tzicatlacoyan,21193,3980,4067,8047
2028,Puebla,21,Venustiano Carranza,21194,16239,17313,33552
2028,Puebla,21,Vicente Guerrero,21195,13156,14076,27232
2028,Puebla,21,Xayacatlán de Bravo,21196,840,1013,1853
2028,Puebla,21,Xicotepec,21197,44129,47405,91534
2028,Puebla,21,Xicotlán,21198,660,729,1389
2028,Puebla,21,Xiutetelco,21199,21470,23091,44561
2028,Puebla,21,Xochiapulco,21200,1865,2061,3926
2028,Puebla,21,Xochiltepec,21201,1730,2063,3793
2028,Puebla,21,Xochitlán Todos Santos,21203,3457,3825,7282
2028,Puebla,21,Xochitlán de Vicente Suárez,21202,6876,7411,14287
2028,Puebla,21,Yaonáhuac,21204,4296,4713,9009
2028,Puebla,21,Yehualtepec,21205,13564,14151,27715
2028,Puebla,21,Zacapala,21206,2421,2695,5116
2028,Puebla,21,Zacapoaxtla,21207,29698,32672,62370
2028,Puebla,21,Zacatlán,21208,44542,49177,93719
2028,Puebla,21,Zapotitlán,21209,4473,5278,9751
2028,Puebla,21,Zapotitlán de Méndez,21210,3193,3216,6409
2028,Puebla,21,Zaragoza,21211,8490,9889,18379
2028,Puebla,21,Zautla,21212,10081,11521,21602
2028,Puebla,21,Zihuateutla,21213,7333,7679,15012
2028,Puebla,21,Zinacatepec,21214,9233,10050,19283
2028,Puebla,21,Zongozotla,21215,2790,2847,5637
2028,Puebla,21,Zoquiapan,21216,1313,1488,2801
2028,Puebla,21,Zoquitlán,21217,10013,10688,20701
2028,Querétaro,22,Amealco de Bonfil,22001,37340,39530,76870
2028,Querétaro,22,Arroyo Seco,22003,8444,8931,17375
2028,Querétaro,22,Cadereyta de Montes,22004,41836,45054,86890
2028,Querétaro,22,Colón,22005,38897,38087,76984
2028,Querétaro,22,Corregidora,22006,116086,122642,238728
2028,Querétaro,22,El Marqués,22011,102413,99902,202315
2028,Querétaro,22,Ezequiel Montes,22007,24894,26555,51449
2028,Querétaro,22,Huimilpan,22008,22724,24531,47255
2028,Querétaro,22,Jalpan de Serra,22009,16169,17643,33812
2028,Querétaro,22,Landa de Matamoros,22010,11230,12029,23259
2028,Querétaro,22,Pedro Escobedo,22012,42601,43108,85709
2028,Querétaro,22,Peñamiller,22013,12512,12753,25265
2028,Querétaro,22,Pinal de Amoles,22002,15547,16399,31946
2028,Querétaro,22,Querétaro,22014,547200,556825,1104025
2028,Querétaro,22,San Joaquín,22015,5502,6179,11681
2028,Querétaro,22,San Juan del Río,22016,167103,173461,340564
2028,Querétaro,22,Tequisquiapan,22017,43889,45572,89461
2028,Querétaro,22,Tolimán,22018,17348,18037,35385
2028,Quintana Roo,23,Bacalar,23010,27111,26797,53908
2028,Quintana Roo,23,Benito Juárez,23005,489575,483608,973183
2028,Quintana Roo,23,Cozumel,23001,60408,60415,120823
2028,Quintana Roo,23,Felipe Carrillo Puerto,23002,56080,55688,111768
2028,Quintana Roo,23,Isla Mujeres,23003,14816,13579,28395
2028,Quintana Roo,23,José María Morelos,23006,26591,24913,51504
2028,Quintana Roo,23,Lázaro Cárdenas,23007,19357,18434,37791
2028,Quintana Roo,23,Othón P. Blanco,23004,157325,163730,321055
2028,Quintana Roo,23,Solidaridad,23008,141650,127968,269618
2028,Quintana Roo,23,Tulum,23009,22378,20055,42433
2028,San Luis Potosí,24,Ahualulco,24001,9389,10518,19907
2028,San Luis Potosí,24,Alaquines,24002,4605,4712,9317
2028,San Luis Potosí,24,Aquismón,24003,26478,25905,52383
2028,San Luis Potosí,24,Armadillo de los Infante,24004,2323,2387,4710
2028,San Luis Potosí,24,Axtla de Terrazas,24053,20236,20824,41060
2028,San Luis Potosí,24,Catorce,24006,5591,5401,10992
2028,San Luis Potosí,24,Cedral,24007,10308,10775,21083
2028,San Luis Potosí,24,Cerritos,24008,11763,12638,24401
2028,San Luis Potosí,24,Cerro de San Pedro,24009,2527,2456,4983
2028,San Luis Potosí,24,Charcas,24015,11395,11797,23192
2028,San Luis Potosí,24,Ciudad Fernández,24011,24181,25507,49688
2028,San Luis Potosí,24,Ciudad Valles,24013,95490,102431,197921
2028,San Luis Potosí,24,Ciudad del Maíz,24010,19493,19591,39084
2028,San Luis Potosí,24,Coxcatlán,24014,8565,8477,17042
2028,San Luis Potosí,24,Cárdenas,24005,10079,10996,21075
2028,San Luis Potosí,24,Ebano,24016,23752,24595,48347
2028,San Luis Potosí,24,El Naranjo,24058,12227,12095,24322
2028,San Luis Potosí,24,Guadalcázar,24017,14942,14671,29613
2028,San Luis Potosí,24,Huehuetlán,24018,8569,8871,17440
2028,San Luis Potosí,24,Lagunillas,24019,3134,3235,6369
2028,San Luis Potosí,24,Matehuala,24020,53014,56293,109307
2028,San Luis Potosí,24,Matlapa,24057,16571,16752,33323
2028,San Luis Potosí,24,Mexquitic de Carmona,24021,29743,32209,61952
2028,San Luis Potosí,24,Moctezuma,24022,10283,11139,21422
2028,San Luis Potosí,24,Rayón,24023,8609,9040,17649
2028,San Luis Potosí,24,Rioverde,24024,50873,53926,104799
2028,San Luis Potosí,24,Salinas,24025,16606,17856,34462
2028,San Luis Potosí,24,San Antonio,24026,5130,4985,10115
2028,San Luis Potosí,24,San Ciro de Acosta,24027,5637,6008,11645
2028,San Luis Potosí,24,San Luis Potosí,24028,436902,471224,908126
2028,San Luis Potosí,24,San Martín Chalchicuautla,24029,11670,11854,23524
2028,San Luis Potosí,24,San Nicolás Tolentino,24030,2835,3129,5964
2028,San Luis Potosí,24,San Vicente Tancuayalab,24034,8140,8138,16278
2028,San Luis Potosí,24,Santa Catarina,24031,6196,6523,12719
2028,San Luis Potosí,24,Santa María del Río,24032,20852,22828,43680
2028,San Luis Potosí,24,Santo Domingo,24033,6694,6698,13392
2028,San Luis Potosí,24,Soledad de Graciano Sánchez,24035,167004,175741,342745
2028,San Luis Potosí,24,Tamasopo,24036,16901,16524,33425
2028,San Luis Potosí,24,Tamazunchale,24037,52229,53362,105591
2028,San Luis Potosí,24,Tampacán,24038,8648,8484,17132
2028,San Luis Potosí,24,Tampamolón Corona,24039,8326,8532,16858
2028,San Luis Potosí,24,Tamuín,24040,21193,21706,42899
2028,San Luis Potosí,24,Tancanhuitz,24012,11125,11513,22638
2028,San Luis Potosí,24,Tanlajás,24041,10775,10571,21346
2028,San Luis Potosí,24,Tanquián de Escobedo,24042,8206,8617,16823
2028,San Luis Potosí,24,Tierra Nueva,24043,4723,5402,10125
2028,San Luis Potosí,24,Vanegas,24044,4278,4190,8468
2028,San Luis Potosí,24,Venado,24045,7959,8242,16201
2028,San Luis Potosí,24,Villa Hidalgo,24051,8254,8373,16627
2028,San Luis Potosí,24,Villa Juárez,24052,5708,5850,11558
2028,San Luis Potosí,24,Villa de Arista,24056,8284,8319,16603
2028,San Luis Potosí,24,Villa de Arriaga,24046,9657,9791,19448
2028,San Luis Potosí,24,Villa de Guadalupe,24047,5537,5516,11053
2028,San Luis Potosí,24,Villa de Ramos,24049,19721,20624,40345
2028,San Luis Potosí,24,Villa de Reyes,24050,26547,26716,53263
2028,San Luis Potosí,24,Villa de la Paz,24048,2980,2961,5941
2028,San Luis Potosí,24,Xilitla,24054,27735,28693,56428
2028,San Luis Potosí,24,Zaragoza,24055,13866,14222,28088
2028,Sinaloa,25,Ahome,25001,248832,258600,507432
2028,Sinaloa,25,Angostura,25002,27594,27475,55069
2028,Sinaloa,25,Badiraguato,25003,17678,16331,34009
2028,Sinaloa,25,Choix,25007,18714,17682,36396
2028,Sinaloa,25,Concordia,25004,15883,15471,31354
2028,Sinaloa,25,Cosalá,25005,9216,8764,17980
2028,Sinaloa,25,Culiacán,25006,493517,514210,1007727
2028,Sinaloa,25,El Fuerte,25010,58386,57306,115692
2028,Sinaloa,25,Elota,25008,31474,29184,60658
2028,Sinaloa,25,Escuinapa,25009,33723,32752,66475
2028,Sinaloa,25,Guasave,25011,166764,169816,336580
2028,Sinaloa,25,Mazatlán,25012,279261,287289,566550
2028,Sinaloa,25,Mocorito,25013,27014,25539,52553
2028,Sinaloa,25,Navolato,25018,86315,82622,168937
2028,Sinaloa,25,Rosario,25014,31152,30113,61265
2028,Sinaloa,25,Salvador Alvarado,25015,44907,47138,92045
2028,Sinaloa,25,San Ignacio,25016,12341,11377,23718
2028,Sinaloa,25,Sinaloa,25017,51415,50037,101452
2028,Sonora,26,Aconchi,26001,1773,1621,3394
2028,Sonora,26,Agua Prieta,26002,47188,46599,93787
2028,Sonora,26,Alamos,26003,16116,15089,31205
2028,Sonora,26,Altar,26004,5577,5546,11123
2028,Sonora,26,Arivechi,26005,757,729,1486
2028,Sonora,26,Arizpe,26006,1740,1649,3389
2028,Sonora,26,Atil,26007,371,356,727
2028,Sonora,26,Bacadéhuachi,26008,733,663,1396
2028,Sonora,26,Bacanora,26009,554,490,1044
2028,Sonora,26,Bacerac,26010,898,849,1747
2028,Sonora,26,Bacoachi,26011,997,989,1986
2028,Sonora,26,Banámichi,26013,1039,1013,2052
2028,Sonora,26,Bavispe,26015,991,876,1867
2028,Sonora,26,Baviácora,26014,2152,2034,4186
2028,Sonora,26,Benito Juárez,26071,13110,13114,26224
2028,Sonora,26,Benjamín Hill,26016,3045,3188,6233
2028,Sonora,26,Bácum,26012,13827,13627,27454
2028,Sonora,26,Caborca,26017,50408,49618,100026
2028,Sonora,26,Cajeme,26018,250770,263819,514589
2028,Sonora,26,Cananea,26019,20483,21036,41519
2028,Sonora,26,Carbó,26020,3013,2771,5784
2028,Sonora,26,Cucurpe,26022,679,542,1221
2028,Sonora,26,Cumpas,26023,3857,3819,7676
2028,Sonora,26,Divisaderos,26024,479,464,943
2028,Sonora,26,Empalme,26025,33142,33440,66582
2028,Sonora,26,Etchojoa,26026,38250,36998,75248
2028,Sonora,26,Fronteras,26027,5108,4932,10040
2028,Sonora,26,General Plutarco Elías Calles,26070,10086,9919,20005
2028,Sonora,26,Granados,26028,678,666,1344
2028,Sonora,26,Guaymas,26029,93893,95354,189247
2028,Sonora,26,Hermosillo,26030,504253,519435,1023688
2028,Sonora,26,Huachinera,26031,834,778,1612
2028,Sonora,26,Huatabampo,26033,48001,48036,96037
2028,Sonora,26,Huásabas,26032,606,536,1142
2028,Sonora,26,Huépac,26034,642,620,1262
2028,Sonora,26,Imuris,26035,7528,7438,14966
2028,Sonora,26,La Colorada,26021,1382,1097,2479
2028,Sonora,26,Magdalena,26036,18366,18667,37033
2028,Sonora,26,Mazatán,26037,815,697,1512
2028,Sonora,26,Moctezuma,26038,2945,3037,5982
2028,Sonora,26,Naco,26039,3629,3614,7243
2028,Sonora,26,Nacozari de García,26041,7787,7662,15449
2028,Sonora,26,Navojoa,26042,94926,99490,194416
2028,Sonora,26,Nogales,26043,134447,134998,269445
2028,Sonora,26,Nácori Chico,26040,1310,1185,2495
2028,Sonora,26,Onavas,26044,305,265,570
2028,Sonora,26,Opodepe,26045,1787,1576,3363
2028,Sonora,26,Oquitoa,26046,232,262,494
2028,Sonora,26,Pitiquito,26047,5695,5354,11049
2028,Sonora,26,Puerto Peñasco,26048,39653,38477,78130
2028,Sonora,26,Quiriego,26049,1873,1616,3489
2028,Sonora,26,Rayón,26050,1012,921,1933
2028,Sonora,26,Rosario,26051,3252,2976,6228
2028,Sonora,26,Sahuaripa,26052,3612,3347,6959
2028,Sonora,26,San Felipe de Jesús,26053,270,259,529
2028,Sonora,26,San Ignacio Río Muerto,26072,8845,8357,17202
2028,Sonora,26,San Javier,26054,438,328,766
2028,Sonora,26,San Luis Río Colorado,26055,112487,111360,223847
2028,Sonora,26,San Miguel de Horcasitas,26056,5729,4840,10569
2028,Sonora,26,San Pedro de la Cueva,26057,1038,893,1931
2028,Sonora,26,Santa Ana,26058,9651,9954,19605
2028,Sonora,26,Santa Cruz,26059,1078,1111,2189
2028,Sonora,26,Soyopa,26061,955,795,1750
2028,Sonora,26,Suaqui Grande,26062,753,632,1385
2028,Sonora,26,Sáric,26060,909,870,1779
2028,Sonora,26,Tepache,26063,992,907,1899
2028,Sonora,26,Trincheras,26064,1103,899,2002
2028,Sonora,26,Tubutama,26065,715,673,1388
2028,Sonora,26,Ures,26066,5618,5365,10983
2028,Sonora,26,Villa Hidalgo,26067,1017,927,1944
2028,Sonora,26,Villa Pesqueira,26068,785,666,1451
2028,Sonora,26,Yécora,26069,3519,3438,6957
2028,Tabasco,27,Balancán,27001,35224,35238,70462
2028,Tabasco,27,Centla,27003,63131,63529,126660
2028,Tabasco,27,Centro,27004,389394,410250,799644
2028,Tabasco,27,Comalcalco,27005,115684,119742,235426
2028,Tabasco,27,Cunduacán,27006,78537,81109,159646
2028,Tabasco,27,Cárdenas,27002,145411,151161,296572
2028,Tabasco,27,Emiliano Zapata,27007,17119,18899,36018
2028,Tabasco,27,Huimanguillo,27008,106547,109039,215586
2028,Tabasco,27,Jalapa,27009,22597,22573,45170
2028,Tabasco,27,Jalpa de Méndez,27010,50526,51083,101609
2028,Tabasco,27,Jonuta,27011,17792,17752,35544
2028,Tabasco,27,Macuspana,27012,93410,97596,191006
2028,Tabasco,27,Nacajuca,27013,78407,81770,160177
2028,Tabasco,27,Paraíso,27014,54790,55416,110206
2028,Tabasco,27,Tacotalpa,27015,28236,27934,56170
2028,Tabasco,27,Teapa,27016,32997,34350,67347
2028,Tabasco,27,Tenosique,27017,33642,35634,69276
2028,Tamaulipas,28,Abasolo,28001,7082,7020,14102
2028,Tamaulipas,28,Aldama,28002,16833,16361,33194
2028,Tamaulipas,28,Altamira,28003,133418,134876,268294
2028,Tamaulipas,28,Antiguo Morelos,28004,5780,5705,11485
2028,Tamaulipas,28,Burgos,28005,2773,2559,5332
2028,Tamaulipas,28,Bustamante,28006,4824,4421,9245
2028,Tamaulipas,28,Camargo,28007,8752,8563,17315
2028,Tamaulipas,28,Casas,28008,2530,2257,4787
2028,Tamaulipas,28,Ciudad Madero,28009,114349,126735,241084
2028,Tamaulipas,28,Cruillas,28010,1093,1057,2150
2028,Tamaulipas,28,El Mante,28021,66396,70603,136999
2028,Tamaulipas,28,González,28012,24959,25045,50004
2028,Tamaulipas,28,Guerrero,28014,2714,2511,5225
2028,Tamaulipas,28,Gustavo Díaz Ordaz,28015,9206,9059,18265
2028,Tamaulipas,28,Gómez Farías,28011,5449,5176,10625
2028,Tamaulipas,28,Güémez,28013,9367,8620,17987
2028,Tamaulipas,28,Hidalgo,28016,13955,13213,27168
2028,Tamaulipas,28,Jaumave,28017,9013,8682,17695
2028,Tamaulipas,28,Jiménez,28018,4588,4582,9170
2028,Tamaulipas,28,Llera,28019,10214,9711,19925
2028,Tamaulipas,28,Mainero,28020,1560,1495,3055
2028,Tamaulipas,28,Matamoros,28022,279764,290936,570700
2028,Tamaulipas,28,Mier,28024,2313,2377,4690
2028,Tamaulipas,28,Miguel Alemán,28025,15380,15537,30917
2028,Tamaulipas,28,Miquihuana,28026,2188,1994,4182
2028,Tamaulipas,28,Méndez,28023,2267,2070,4337
2028,Tamaulipas,28,Nuevo Laredo,28027,218458,219997,438455
2028,Tamaulipas,28,Nuevo Morelos,28028,2128,1929,4057
2028,Tamaulipas,28,Ocampo,28029,8304,7828,16132
2028,Tamaulipas,28,Padilla,28030,8177,8041,16218
2028,Tamaulipas,28,Palmillas,28031,1053,993,2046
2028,Tamaulipas,28,Reynosa,28032,355430,358204,713634
2028,Tamaulipas,28,Río Bravo,28033,70900,70999,141899
2028,Tamaulipas,28,San Carlos,28034,5492,4969,10461
2028,Tamaulipas,28,San Fernando,28035,31707,31427,63134
2028,Tamaulipas,28,San Nicolás,28036,631,553,1184
2028,Tamaulipas,28,Soto la Marina,28037,14539,13726,28265
2028,Tamaulipas,28,Tampico,28038,172581,189989,362570
2028,Tamaulipas,28,Tula,28039,16829,16876,33705
2028,Tamaulipas,28,Valle Hermoso,28040,35401,36674,72075
2028,Tamaulipas,28,Victoria,28041,189713,199606,389319
2028,Tamaulipas,28,Villagrán,28042,3782,3550,7332
2028,Tamaulipas,28,Xicoténcatl,28043,13748,13754,27502
2028,Tlaxcala,29,Acuamanala de Miguel Hidalgo,29022,3896,3857,7753
2028,Tlaxcala,29,Altzayanca,29004,10123,10042,20165
2028,Tlaxcala,29,Amaxac de Guerrero,29001,6457,6655,13112
2028,Tlaxcala,29,Apetatitlán de Antonio Carvajal,29002,8529,9130,17659
2028,Tlaxcala,29,Apizaco,29005,43527,47894,91421
2028,Tlaxcala,29,Atlangatepec,29003,3726,3845,7571
2028,Tlaxcala,29,Benito Juárez,29045,3425,3494,6919
2028,Tlaxcala,29,Calpulalpan,29006,27246,28568,55814
2028,Tlaxcala,29,Chiautempan,29010,40992,44077,85069
2028,Tlaxcala,29,Contla de Juan Cuamatzi,29018,21930,22468,44398
2028,Tlaxcala,29,Cuapiaxtla,29008,8742,8730,17472
2028,Tlaxcala,29,Cuaxomulco,29009,3076,3124,6200
2028,Tlaxcala,29,El Carmen Tequexquitla,29007,9643,9845,19488
2028,Tlaxcala,29,Emiliano Zapata,29046,2546,2632,5178
2028,Tlaxcala,29,Españita,29012,5059,5139,10198
2028,Tlaxcala,29,Huamantla,29013,52491,54658,107149
2028,Tlaxcala,29,Hueyotlipan,29014,8385,8516,16901
2028,Tlaxcala,29,Ixtacuixtla de Mariano Matamoros,29015,22475,23547,46022
2028,Tlaxcala,29,Ixtenco,29016,4103,4462,8565
2028,Tlaxcala,29,La Magdalena Tlaltelulco,29048,10280,11101,21381
2028,Tlaxcala,29,Lázaro Cárdenas,29047,1761,1771,3532
2028,Tlaxcala,29,Mazatecochco de José María Morelos,29017,6194,6274,12468
2028,Tlaxcala,29,Muñoz de Domingo Arenas,29011,2628,2616,5244
2028,Tlaxcala,29,Nanacamilpa de Mariano Arista,29021,10331,10759,21090
2028,Tlaxcala,29,Natívitas,29023,14485,15431,29916
2028,Tlaxcala,29,Panotla,29024,15233,16361,31594
2028,Tlaxcala,29,Papalotla de Xicohténcatl,29041,17006,18128,35134
2028,Tlaxcala,29,San Damián Texóloc,29049,3319,3344,6663
2028,Tlaxcala,29,San Francisco Tetlanohcan,29050,6121,6354,12475
2028,Tlaxcala,29,San Jerónimo Zacualpan,29051,2170,2393,4563
2028,Tlaxcala,29,San José Teacalco,29052,3418,3588,7006
2028,Tlaxcala,29,San Juan Huactzinco,29053,4180,4573,8753
2028,Tlaxcala,29,San Lorenzo Axocomanitla,29054,3188,3420,6608
2028,Tlaxcala,29,San Lucas Tecopilco,29055,1795,1890,3685
2028,Tlaxcala,29,San Pablo del Monte,29025,43699,43730,87429
2028,Tlaxcala,29,Sanctórum de Lázaro Cárdenas,29020,5889,6012,11901
2028,Tlaxcala,29,Santa Ana Nopalucan,29056,4473,4627,9100
2028,Tlaxcala,29,Santa Apolonia Teacalco,29057,2571,2855,5426
2028,Tlaxcala,29,Santa Catarina Ayometla,29058,5022,5432,10454
2028,Tlaxcala,29,Santa Cruz Quilehtla,29059,4134,4136,8270
2028,Tlaxcala,29,Santa Cruz Tlaxcala,29026,11777,12177,23954
2028,Tlaxcala,29,Santa Isabel Xiloxoxtla,29060,2823,2971,5794
2028,Tlaxcala,29,Tenancingo,29027,7531,7763,15294
2028,Tlaxcala,29,Teolocholco,29028,13614,14370,27984
2028,Tlaxcala,29,Tepetitla de Lardizábal,29019,11824,12693,24517
2028,Tlaxcala,29,Tepeyanco,29029,7954,8748,16702
2028,Tlaxcala,29,Terrenate,29030,9025,8870,17895
2028,Tlaxcala,29,Tetla de la Solidaridad,29031,18451,18880,37331
2028,Tlaxcala,29,Tetlatlahuca,29032,8421,8901,17322
2028,Tlaxcala,29,Tlaxcala,29033,53005,58451,111456
2028,Tlaxcala,29,Tlaxco,29034,24125,24952,49077
2028,Tlaxcala,29,Tocatlán,29035,3350,3415,6765
2028,Tlaxcala,29,Totolac,29036,12573,13756,26329
2028,Tlaxcala,29,Tzompantepec,29038,9836,10520,20356
2028,Tlaxcala,29,Xaloztoc,29039,13875,13748,27623
2028,Tlaxcala,29,Xaltocan,29040,6273,6711,12984
2028,Tlaxcala,29,Xicohtzinco,29042,7677,8498,16175
2028,Tlaxcala,29,Yauhquemehcan,29043,21799,23055,44854
2028,Tlaxcala,29,Zacatelco,29044,24975,27286,52261
2028,Tlaxcala,29,Ziltlaltépec de Trinidad Sánchez Santos,29037,4945,5387,10332
2028,Veracruz,30,Acajete,30001,4729,4577,9306
2028,Veracruz,30,Acatlán,30002,1696,1745,3441
2028,Veracruz,30,Acayucan,30003,45176,48676,93852
2028,Veracruz,30,Actopan,30004,24041,24720,48761
2028,Veracruz,30,Acula,30005,3018,2996,6014
2028,Veracruz,30,Acultzingo,30006,11942,12352,24294
2028,Veracruz,30,Agua Dulce,30204,25706,27303,53009
2028,Veracruz,30,Alpatláhuac,30008,5373,5407,10780
2028,Veracruz,30,Alto Lucero de Gutiérrez Barrios,30009,16418,16232,32650
2028,Veracruz,30,Altotonga,30010,33471,35979,69450
2028,Veracruz,30,Alvarado,30011,29431,30404,59835
2028,Veracruz,30,Amatitlán,30012,4400,4623,9023
2028,Veracruz,30,Amatlán de los Reyes,30014,23958,25889,49847
2028,Veracruz,30,Angel R. Cabada,30015,18383,19566,37949
2028,Veracruz,30,Apazapan,30017,2261,2290,4551
2028,Veracruz,30,Aquila,30018,973,1026,1999
2028,Veracruz,30,Astacinga,30019,3169,3576,6745
2028,Veracruz,30,Atlahuilco,30020,5552,5808,11360
2028,Veracruz,30,Atoyac,30021,12763,13448,26211
2028,Veracruz,30,Atzacan,30022,11229,11564,22793
2028,Veracruz,30,Atzalan,30023,27336,27416,54752
2028,Veracruz,30,Ayahualulco,30025,14080,14277,28357
2028,Veracruz,30,Banderilla,30026,12241,13654,25895
2028,Veracruz,30,Benito Juárez,30027,9265,9885,19150
2028,Veracruz,30,Boca del Río,30028,75324,86129,161453
2028,Veracruz,30,Calcahualco,30029,6714,6780,13494
2028,Veracruz,30,Camarón de Tejeda,30007,3587,3562,7149
2028,Veracruz,30,Camerino Z. Mendoza,30030,21762,24789,46551
2028,Veracruz,30,Carlos A. Carrillo,30208,13303,14610,27913
2028,Veracruz,30,Carrillo Puerto,30031,9048,9195,18243
2028,Veracruz,30,Castillo de Teayo,30157,10997,10753,21750
2028,Veracruz,30,Catemaco,30032,25896,27677,53573
2028,Veracruz,30,Cazones de Herrera,30033,12624,13425,26049
2028,Veracruz,30,Cerro Azul,30034,14255,16184,30439
2028,Veracruz,30,Chacaltianguis,30054,6799,7163,13962
2028,Veracruz,30,Chalma,30055,7326,7629,14955
2028,Veracruz,30,Chiconamel,30056,3496,3775,7271
2028,Veracruz,30,Chiconquiaco,30057,7515,7578,15093
2028,Veracruz,30,Chicontepec,30058,30221,32079,62300
2028,Veracruz,30,Chinameca,30059,8671,9053,17724
2028,Veracruz,30,Chinampa de Gorostiza,30060,9005,9288,18293
2028,Veracruz,30,Chocamán,30062,11302,11272,22574
2028,Veracruz,30,Chontla,30063,7929,8085,16014
2028,Veracruz,30,Chumatlán,30064,2032,2171,4203
2028,Veracruz,30,Citlaltépetl,30035,6397,6736,13133
2028,Veracruz,30,Coacoatzintla,30036,5430,5663,11093
2028,Veracruz,30,Coahuitlán,30037,4422,4582,9004
2028,Veracruz,30,Coatepec,30038,48519,52862,101381
2028,Veracruz,30,Coatzacoalcos,30039,169232,180707,349939
2028,Veracruz,30,Coatzintla,30040,30252,32072,62324
2028,Veracruz,30,Coetzala,30041,1203,1242,2445
2028,Veracruz,30,Colipa,30042,3017,3122,6139
2028,Veracruz,30,Comapa,30043,11167,10638,21805
2028,Veracruz,30,Cosamaloapan de Carpio,30045,30770,33765,64535
2028,Veracruz,30,Cosautlán de Carvajal,30046,8769,8852,17621
2028,Veracruz,30,Coscomatepec,30047,30294,31214,61508
2028,Veracruz,30,Cosoleacaque,30048,71202,75991,147193
2028,Veracruz,30,Cotaxtla,30049,11424,11367,22791
2028,Veracruz,30,Coxquihui,30050,8866,9292,18158
2028,Veracruz,30,Coyutla,30051,11644,12562,24206
2028,Veracruz,30,Cuichapa,30052,6359,6955,13314
2028,Veracruz,30,Cuitláhuac,30053,14707,16029,30736
2028,Veracruz,30,Córdoba,30044,110943,125888,236831
2028,Veracruz,30,El Higo,30205,10830,10972,21802
2028,Veracruz,30,Emiliano Zapata,30065,42348,45451,87799
2028,Veracruz,30,Espinal,30066,14485,15165,29650
2028,Veracruz,30,Filomeno Mata,30067,9702,9717,19419
2028,Veracruz,30,Fortín,30068,34390,38487,72877
2028,Veracruz,30,Gutiérrez Zamora,30069,12897,14602,27499
2028,Veracruz,30,Hidalgotitlán,30070,10643,10189,20832
2028,Veracruz,30,Huatusco,30071,31370,33794,65164
2028,Veracruz,30,Huayacocotla,30072,11277,12069,23346
2028,Veracruz,30,Hueyapan de Ocampo,30073,23017,24235,47252
2028,Veracruz,30,Huiloapan de Cuauhtémoc,30074,3794,4095,7889
2028,Veracruz,30,Ignacio de la Llave,30075,9240,10181,19421
2028,Veracruz,30,Ilamatlán,30076,6978,7726,14704
2028,Veracruz,30,Isla,30077,22806,23766,46572
2028,Veracruz,30,Ixcatepec,30078,7430,7504,14934
2028,Veracruz,30,Ixhuacán de los Reyes,30079,6176,6105,12281
2028,Veracruz,30,Ixhuatlancillo,30081,13358,14611,27969
2028,Veracruz,30,Ixhuatlán de Madero,30083,28763,30462,59225
2028,Veracruz,30,Ixhuatlán del Café,30080,12265,12292,24557
2028,Veracruz,30,Ixhuatlán del Sureste,30082,8536,8402,16938
2028,Veracruz,30,Ixmatlahuacan,30084,3178,3225,6403
2028,Veracruz,30,Ixtaczoquitlán,30085,35906,38142,74048
2028,Veracruz,30,Jalacingo,30086,22754,23938,46692
2028,Veracruz,30,Jalcomulco,30088,2846,2826,5672
2028,Veracruz,30,Jamapa,30090,6118,6426,12544
2028,Veracruz,30,Jesús Carranza,30091,15900,15916,31816
2028,Veracruz,30,Jilotepec,30093,8870,9309,18179
2028,Veracruz,30,José Azueta,30169,12360,12730,25090
2028,Veracruz,30,Juan Rodríguez Clara,30094,21226,21632,42858
2028,Veracruz,30,Juchique de Ferrer,30095,8724,8757,17481
2028,Veracruz,30,Jáltipan,30089,21952,24056,46008
2028,Veracruz,30,La Antigua,30016,14229,15384,29613
2028,Veracruz,30,La Perla,30127,14190,14695,28885
2028,Veracruz,30,Landero y Coss,30096,868,925,1793
2028,Veracruz,30,Las Choapas,30061,43165,44667,87832
2028,Veracruz,30,Las Minas,30107,1609,1564,3173
2028,Veracruz,30,Las Vigas de Ramírez,30132,10455,10592,21047
2028,Veracruz,30,Lerdo de Tejada,30097,10361,11985,22346
2028,Veracruz,30,Los Reyes,30137,3102,3145,6247
2028,Veracruz,30,Magdalena,30098,1613,1640,3253
2028,Veracruz,30,Maltrata,30099,9329,9924,19253
2028,Veracruz,30,Manlio Fabio Altamirano,30100,12787,13259,26046
2028,Veracruz,30,Mariano Escobedo,30101,18624,20094,38718
2028,Veracruz,30,Martínez de la Torre,30102,54999,60017,115016
2028,Veracruz,30,Mecatlán,30103,6428,6650,13078
2028,Veracruz,30,Mecayapan,30104,8937,9254,18191
2028,Veracruz,30,Medellín,30105,41681,45277,86958
2028,Veracruz,30,Miahuatlán,30106,2476,2558,5034
2028,Veracruz,30,Minatitlán,30108,84066,89706,173772
2028,Veracruz,30,Misantla,30109,34488,36202,70690
2028,Veracruz,30,Mixtla de Altamirano,30110,6212,6110,12322
2028,Veracruz,30,Moloacán,30111,9184,9691,18875
2028,Veracruz,30,Nanchital de Lázaro Cárdenas del Rio,30206,15767,16682,32449
2028,Veracruz,30,Naolinco,30112,11611,12133,23744
2028,Veracruz,30,Naranjal,30113,2372,2544,4916
2028,Veracruz,30,Naranjos Amatlán,30013,14985,16808,31793
2028,Veracruz,30,Nautla,30114,6033,6258,12291
2028,Veracruz,30,Nogales,30115,19641,21706,41347
2028,Veracruz,30,Oluta,30116,8593,9283,17876
2028,Veracruz,30,Omealca,30117,12690,13499,26189
2028,Veracruz,30,Orizaba,30118,64800,77471,142271
2028,Veracruz,30,Otatitlán,30119,2995,3282,6277
2028,Veracruz,30,Oteapan,30120,8624,8927,17551
2028,Veracruz,30,Ozuluama de Mascareñas,30121,13208,12673,25881
2028,Veracruz,30,Pajapan,30122,9325,9217,18542
2028,Veracruz,30,Papantla,30124,85539,87224,172763
2028,Veracruz,30,Paso de Ovejas,30126,18499,18682,37181
2028,Veracruz,30,Paso del Macho,30125,17030,17318,34348
2028,Veracruz,30,Perote,30128,38688,39339,78027
2028,Veracruz,30,Platón Sánchez,30129,9828,10269,20097
2028,Veracruz,30,Playa Vicente,30130,20034,21471,41505
2028,Veracruz,30,Poza Rica de Hidalgo,30131,107457,120725,228182
2028,Veracruz,30,Pueblo Viejo,30133,31307,31506,62813
2028,Veracruz,30,Puente Nacional,30134,12294,12647,24941
2028,Veracruz,30,Pánuco,30123,54851,55326,110177
2028,Veracruz,30,Rafael Delgado,30135,12116,12618,24734
2028,Veracruz,30,Rafael Lucio,30136,4212,4469,8681
2028,Veracruz,30,Río Blanco,30138,21817,24939,46756
2028,Veracruz,30,Saltabarranca,30139,3359,3604,6963
2028,Veracruz,30,San Andrés Tenejapan,30140,1518,1598,3116
2028,Veracruz,30,San Andrés Tuxtla,30141,85711,92528,178239
2028,Veracruz,30,San Juan Evangelista,30142,18284,18867,37151
2028,Veracruz,30,San Rafael,30211,16012,16737,32749
2028,Veracruz,30,Santiago Sochiapan,30212,7041,7546,14587
2028,Veracruz,30,Santiago Tuxtla,30143,30343,32639,62982
2028,Veracruz,30,Sayula de Alemán,30144,17446,17886,35332
2028,Veracruz,30,Sochiapa,30146,1937,1949,3886
2028,Veracruz,30,Soconusco,30145,8585,9005,17590
2028,Veracruz,30,Soledad Atzompa,30147,12066,12204,24270
2028,Veracruz,30,Soledad de Doblado,30148,15071,15379,30450
2028,Veracruz,30,Soteapan,30149,17876,18435,36311
2028,Veracruz,30,Tamalín,30150,6403,6380,12783
2028,Veracruz,30,Tamiahua,30151,13119,13109,26228
2028,Veracruz,30,Tampico Alto,30152,7243,6779,14022
2028,Veracruz,30,Tancoco,30153,3125,3341,6466
2028,Veracruz,30,Tantima,30154,7364,7151,14515
2028,Veracruz,30,Tantoyuca,30155,55093,56924,112017
2028,Veracruz,30,Tatahuicapan de Juárez,30209,8379,8632,17011
2028,Veracruz,30,Tatatila,30156,3267,3023,6290
2028,Veracruz,30,Tecolutla,30158,13076,13428,26504
2028,Veracruz,30,Tehuipango,30159,13181,13979,27160
2028,Veracruz,30,Tempoal,30161,19333,19963,39296
2028,Veracruz,30,Tenampa,30162,3598,3693,7291
2028,Veracruz,30,Tenochtitlán,30163,2738,2880,5618
2028,Veracruz,30,Teocelo,30164,8806,9364,18170
2028,Veracruz,30,Tepatlaxco,30165,4694,4406,9100
2028,Veracruz,30,Tepetlán,30166,5371,5170,10541
2028,Veracruz,30,Tepetzintla,30167,7927,8187,16114
2028,Veracruz,30,Tequila,30168,7909,8189,16098
2028,Veracruz,30,Texcatepec,30170,5715,5933,11648
2028,Veracruz,30,Texhuacán,30171,2723,2993,5716
2028,Veracruz,30,Texistepec,30172,11385,11290,22675
2028,Veracruz,30,Tezonapa,30173,30567,31243,61810
2028,Veracruz,30,Tierra Blanca,30174,56144,60430,116574
2028,Veracruz,30,Tihuatlán,30175,51285,53463,104748
2028,Veracruz,30,Tlachichilco,30180,6218,6386,12604
2028,Veracruz,30,Tlacojalpan,30176,2681,2783,5464
2028,Veracruz,30,Tlacolulan,30177,6067,5875,11942
2028,Veracruz,30,Tlacotalpan,30178,7167,7901,15068
2028,Veracruz,30,Tlacotepec de Mejía,30179,2126,2167,4293
2028,Veracruz,30,Tlalixcoyan,30181,20756,21480,42236
2028,Veracruz,30,Tlalnelhuayocan,30182,9800,10145,19945
2028,Veracruz,30,Tlaltetela,30024,8491,8230,16721
2028,Veracruz,30,Tlapacoyan,30183,32461,34412,66873
2028,Veracruz,30,Tlaquilpa,30184,3786,4309,8095
2028,Veracruz,30,Tlilapan,30185,2745,2898,5643
2028,Veracruz,30,Tomatlán,30186,3749,3848,7597
2028,Veracruz,30,Tonayán,30187,2927,3114,6041
2028,Veracruz,30,Totutla,30188,9413,9460,18873
2028,Veracruz,30,Tres Valles,30207,24744,25983,50727
2028,Veracruz,30,Tuxpan,30189,85948,91102,177050
2028,Veracruz,30,Tuxtilla,30190,1248,1287,2535
2028,Veracruz,30,Ursulo Galván,30191,16728,17741,34469
2028,Veracruz,30,Uxpanapa,30210,15901,15312,31213
2028,Veracruz,30,Vega de Alatorre,30192,10868,11561,22429
2028,Veracruz,30,Veracruz,30193,309003,339599,648602
2028,Veracruz,30,Villa Aldama,30194,6145,6331,12476
2028,Veracruz,30,Xalapa,30087,247156,281085,528241
2028,Veracruz,30,Xico,30092,20360,21068,41428
2028,Veracruz,30,Xoxocotla,30195,2928,2829,5757
2028,Veracruz,30,Yanga,30196,9389,10608,19997
2028,Veracruz,30,Yecuatla,30197,6567,6728,13295
2028,Veracruz,30,Zacualpan,30198,3819,4099,7918
2028,Veracruz,30,Zaragoza,30199,5864,6085,11949
2028,Veracruz,30,Zentla,30200,7407,7247,14654
2028,Veracruz,30,Zongolica,30201,23113,23597,46710
2028,Veracruz,30,Zontecomatlán de López y Fuentes,30202,7620,7892,15512
2028,Veracruz,30,Zozocolco de Hidalgo,30203,7986,8335,16321
2028,Veracruz,30,Álamo Temapache,30160,57203,57929,115132
2028,Yucatán,31,Abalá,31001,3879,3697,7576
2028,Yucatán,31,Acanceh,31002,9386,9373,18759
2028,Yucatán,31,Akil,31003,6189,6431,12620
2028,Yucatán,31,Baca,31004,3496,3595,7091
2028,Yucatán,31,Bokobá,31005,1316,1273,2589
2028,Yucatán,31,Buctzotz,31006,5219,5202,10421
2028,Yucatán,31,Cacalchén,31007,4359,4136,8495
2028,Yucatán,31,Calotmul,31008,2393,2386,4779
2028,Yucatán,31,Cansahcab,31009,2742,2821,5563
2028,Yucatán,31,Cantamayec,31010,1498,1375,2873
2028,Yucatán,31,Celestún,31011,4541,4290,8831
2028,Yucatán,31,Cenotillo,31012,2279,2418,4697
2028,Yucatán,31,Chacsinkín,31016,1721,1676,3397
2028,Yucatán,31,Chankom,31017,2686,2589,5275
2028,Yucatán,31,Chapab,31018,1865,1843,3708
2028,Yucatán,31,Chemax,31019,20575,20235,40810
2028,Yucatán,31,Chichimilá,31021,4779,4719,9498
2028,Yucatán,31,Chicxulub Pueblo,31020,2677,2552,5229
2028,Yucatán,31,Chikindzonot,31022,2374,2307,4681
2028,Yucatán,31,Chocholá,31023,2810,2731,5541
2028,Yucatán,31,Chumayel,31024,1880,1917,3797
2028,Yucatán,31,Conkal,31013,6511,6507,13018
2028,Yucatán,31,Cuncunul,31014,950,915,1865
2028,Yucatán,31,Cuzamá,31015,3015,2930,5945
2028,Yucatán,31,Dzemul,31026,2225,2223,4448
2028,Yucatán,31,Dzidzantún,31027,4958,4833,9791
2028,Yucatán,31,Dzilam González,31029,3692,3497,7189
2028,Yucatán,31,Dzilam de Bravo,31028,1634,1526,3160
2028,Yucatán,31,Dzitás,31030,2263,2165,4428
2028,Yucatán,31,Dzoncauich,31031,1550,1582,3132
2028,Yucatán,31,Dzán,31025,3010,3123,6133
2028,Yucatán,31,Espita,31032,9386,9159,18545
2028,Yucatán,31,Halachó,31033,11832,11568,23400
2028,Yucatán,31,Hocabá,31034,3603,3596,7199
2028,Yucatán,31,Hoctún,31035,3441,3525,6966
2028,Yucatán,31,Homún,31036,4522,4344,8866
2028,Yucatán,31,Huhí,31037,3100,2981,6081
2028,Yucatán,31,Hunucmá,31038,18643,18744,37387
2028,Yucatán,31,Ixil,31039,2399,2325,4724
2028,Yucatán,31,Izamal,31040,15586,15949,31535
2028,Yucatán,31,Kanasín,31041,57735,58648,116383
2028,Yucatán,31,Kantunil,31042,3074,3226,6300
2028,Yucatán,31,Kaua,31043,1784,1723,3507
2028,Yucatán,31,Kinchil,31044,4168,4074,8242
2028,Yucatán,31,Kopomá,31045,1543,1459,3002
2028,Yucatán,31,Mama,31046,1760,1904,3664
2028,Yucatán,31,Maní,31047,3188,3323,6511
2028,Yucatán,31,Maxcanú,31048,13206,13007,26213
2028,Yucatán,31,Mayapán,31049,2127,1975,4102
2028,Yucatán,31,Mocochá,31051,1948,1912,3860
2028,Yucatán,31,Motul,31052,21056,21457,42513
2028,Yucatán,31,Muna,31053,7270,7505,14775
2028,Yucatán,31,Muxupip,31054,1651,1720,3371
2028,Yucatán,31,Mérida,31050,503350,547571,1050921
2028,Yucatán,31,Opichén,31055,3968,3824,7792
2028,Yucatán,31,Oxkutzcab,31056,17047,18476,35523
2028,Yucatán,31,Panabá,31057,4487,4527,9014
2028,Yucatán,31,Peto,31058,14390,14587,28977
2028,Yucatán,31,Progreso,31059,33902,34400,68302
2028,Yucatán,31,Quintana Roo,31060,573,570,1143
2028,Yucatán,31,Río Lagartos,31061,2131,2007,4138
2028,Yucatán,31,Sacalum,31062,2845,2714,5559
2028,Yucatán,31,Samahil,31063,3001,2971,5972
2028,Yucatán,31,San Felipe,31065,1162,1089,2251
2028,Yucatán,31,Sanahcat,31064,1014,1001,2015
2028,Yucatán,31,Santa Elena,31066,2239,2330,4569
2028,Yucatán,31,Seyé,31067,5699,5437,11136
2028,Yucatán,31,Sinanché,31068,1960,1812,3772
2028,Yucatán,31,Sotuta,31069,5237,5053,10290
2028,Yucatán,31,Sucilá,31070,2347,2261,4608
2028,Yucatán,31,Sudzal,31071,1040,939,1979
2028,Yucatán,31,Suma,31072,1121,1098,2219
2028,Yucatán,31,Tahdziú,31073,2886,2732,5618
2028,Yucatán,31,Tahmek,31074,2271,2201,4472
2028,Yucatán,31,Teabo,31075,3767,3770,7537
2028,Yucatán,31,Tecoh,31076,10184,10130,20314
2028,Yucatán,31,Tekal de Venegas,31077,1579,1532,3111
2028,Yucatán,31,Tekantó,31078,2241,2263,4504
2028,Yucatán,31,Tekax,31079,23954,24706,48660
2028,Yucatán,31,Tekit,31080,5936,5772,11708
2028,Yucatán,31,Tekom,31081,1824,1872,3696
2028,Yucatán,31,Telchac Pueblo,31082,2287,2277,4564
2028,Yucatán,31,Telchac Puerto,31083,1083,986,2069
2028,Yucatán,31,Temax,31084,4284,4267,8551
2028,Yucatán,31,Temozón,31085,8951,8721,17672
2028,Yucatán,31,Tepakán,31086,1361,1309,2670
2028,Yucatán,31,Tetiz,31087,2909,2895,5804
2028,Yucatán,31,Teya,31088,1159,1166,2325
2028,Yucatán,31,Ticul,31089,22739,23452,46191
2028,Yucatán,31,Timucuy,31090,4307,4144,8451
2028,Yucatán,31,Tinum,31091,6926,6716,13642
2028,Yucatán,31,Tixcacalcupul,31092,4063,4011,8074
2028,Yucatán,31,Tixkokob,31093,10476,10697,21173
2028,Yucatán,31,Tixmehuac,31094,2788,2786,5574
2028,Yucatán,31,Tixpéhual,31095,3189,3310,6499
2028,Yucatán,31,Tizimín,31096,43840,45156,88996
2028,Yucatán,31,Tunkás,31097,2122,2032,4154
2028,Yucatán,31,Tzucacab,31098,8479,8334,16813
2028,Yucatán,31,Uayma,31099,2396,2301,4697
2028,Yucatán,31,Ucú,31100,2166,2129,4295
2028,Yucatán,31,Umán,31101,30897,30897,61794
2028,Yucatán,31,Valladolid,31102,45345,46240,91585
2028,Yucatán,31,Xocchel,31103,2074,1993,4067
2028,Yucatán,31,Yaxcabá,31104,8983,8466,17449
2028,Yucatán,31,Yaxkukul,31105,1835,1849,3684
2028,Yucatán,31,Yobaín,31106,1381,1329,2710
2028,Zacatecas,32,Apozol,32001,3275,3515,6790
2028,Zacatecas,32,Apulco,32002,2554,2815,5369
2028,Zacatecas,32,Atolinga,32003,1392,1507,2899
2028,Zacatecas,32,Benito Juárez,32004,2295,2258,4553
2028,Zacatecas,32,Calera,32005,24292,24264,48556
2028,Zacatecas,32,Cañitas de Felipe Pescador,32006,4534,4640,9174
2028,Zacatecas,32,Chalchihuites,32009,6238,6565,12803
2028,Zacatecas,32,Concepción del Oro,32007,7503,7409,14912
2028,Zacatecas,32,Cuauhtémoc,32008,6699,7066,13765
2028,Zacatecas,32,El Plateado de Joaquín Amaro,32015,682,720,1402
2028,Zacatecas,32,El Salvador,32041,1363,1331,2694
2028,Zacatecas,32,Fresnillo,32010,124769,128589,253358
2028,Zacatecas,32,Genaro Codina,32012,4387,4565,8952
2028,Zacatecas,32,General Enrique Estrada,32013,3420,3478,6898
2028,Zacatecas,32,General Francisco R. Murguía,32014,11812,12445,24257
2028,Zacatecas,32,General Pánfilo Natera,32016,12444,12941,25385
2028,Zacatecas,32,Guadalupe,32017,101253,106334,207587
2028,Zacatecas,32,Huanusco,32018,2253,2383,4636
2028,Zacatecas,32,Jalpa,32019,13144,13801,26945
2028,Zacatecas,32,Jerez,32020,32602,34881,67483
2028,Zacatecas,32,Jiménez del Teul,32021,2289,2353,4642
2028,Zacatecas,32,Juan Aldama,32022,11667,12349,24016
2028,Zacatecas,32,Juchipila,32023,6773,7622,14395
2028,Zacatecas,32,Loreto,32024,29154,29601,58755
2028,Zacatecas,32,Luis Moya,32025,7304,7386,14690
2028,Zacatecas,32,Mazapil,32026,10341,9470,19811
2028,Zacatecas,32,Melchor Ocampo,32027,1799,1568,3367
2028,Zacatecas,32,Mezquital del Oro,32028,1348,1461,2809
2028,Zacatecas,32,Miguel Auza,32029,12697,13228,25925
2028,Zacatecas,32,Momax,32030,1318,1435,2753
2028,Zacatecas,32,Monte Escobedo,32031,5187,5379,10566
2028,Zacatecas,32,Morelos,32032,6823,6883,13706
2028,Zacatecas,32,Moyahua de Estrada,32033,2144,2474,4618
2028,Zacatecas,32,Nochistlán de Mejía,32034,14930,16563,31493
2028,Zacatecas,32,Noria de Ángeles,32035,9109,9350,18459
2028,Zacatecas,32,Ojocaliente,32036,22998,23935,46933
2028,Zacatecas,32,Pinos,32038,39208,40971,80179
2028,Zacatecas,32,Pánuco,32037,9791,9749,19540
2028,Zacatecas,32,Río Grande,32039,34494,36600,71094
2028,Zacatecas,32,Sain Alto,32040,11934,12544,24478
2028,Zacatecas,32,Santa María de la Paz,32058,1467,1510,2977
2028,Zacatecas,32,Sombrerete,32042,33902,34931,68833
2028,Zacatecas,32,Susticacán,32043,742,815,1557
2028,Zacatecas,32,Tabasco,32044,8379,8866,17245
2028,Zacatecas,32,Tepechitlán,32045,4703,5161,9864
2028,Zacatecas,32,Tepetongo,32046,4001,4307,8308
2028,Zacatecas,32,Teúl de González Ortega,32047,2710,2879,5589
2028,Zacatecas,32,Tlaltenango de Sánchez Román,32048,14469,15207,29676
2028,Zacatecas,32,Trancoso,32057,10449,10709,21158
2028,Zacatecas,32,Trinidad García de la Cadena,32011,1591,1672,3263
2028,Zacatecas,32,Valparaíso,32049,18350,19086,37436
2028,Zacatecas,32,Vetagrande,32050,5417,5535,10952
2028,Zacatecas,32,Villa García,32052,10393,10515,20908
2028,Zacatecas,32,Villa González Ortega,32053,7104,7508,14612
2028,Zacatecas,32,Villa Hidalgo,32054,10395,10531,20926
2028,Zacatecas,32,Villa de Cos,32051,19616,19297,38913
2028,Zacatecas,32,Villanueva,32055,16635,17437,34072
2028,Zacatecas,32,Zacatecas,32056,78708,83991,162699
2029,Aguascalientes,01,Aguascalientes,01001,523901,546662,1070563
2029,Aguascalientes,01,Asientos,01002,27972,28059,56031
2029,Aguascalientes,01,Calvillo,01003,33863,34929,68792
2029,Aguascalientes,01,Cosío,01004,9197,9420,18617
2029,Aguascalientes,01,El Llano,01010,12266,11961,24227
2029,Aguascalientes,01,Jesús María,01005,71246,70122,141368
2029,Aguascalientes,01,Pabellón de Arteaga,01006,26748,27917,54665
2029,Aguascalientes,01,Rincón de Romos,01007,31681,31878,63559
2029,Aguascalientes,01,San Francisco de los Romo,01011,27612,27606,55218
2029,Aguascalientes,01,San José de Gracia,01008,5253,5497,10750
2029,Aguascalientes,01,Tepezalá,01009,12553,12752,25305
2029,Baja California,02,Ensenada,02001,301919,304285,606204
2029,Baja California,02,Mexicali,02002,618714,626993,1245707
2029,Baja California,02,Playas de Rosarito,02005,60710,60305,121015
2029,Baja California,02,Tecate,02003,65184,62693,127877
2029,Baja California,02,Tijuana,02004,990891,1001421,1992312
2029,Baja California Sur,03,Comondú,03001,51232,50144,101376
2029,Baja California Sur,03,La Paz,03003,177303,180618,357921
2029,Baja California Sur,03,Loreto,03009,13454,12432,25886
2029,Baja California Sur,03,Los Cabos,03008,194468,183622,378090
2029,Baja California Sur,03,Mulegé,03002,40797,38295,79092
2029,Campeche,04,Calakmul,04010,17993,17148,35141
2029,Campeche,04,Calkiní,04001,35555,36949,72504
2029,Campeche,04,Campeche,04002,174993,189135,364128
2029,Campeche,04,Candelaria,04011,28097,27079,55176
2029,Campeche,04,Carmen,04003,155418,156261,311679
2029,Campeche,04,Champotón,04004,58086,57070,115156
2029,Campeche,04,Escárcega,04009,35973,36237,72210
2029,Campeche,04,Hecelchakán,04005,19615,19778,39393
2029,Campeche,04,Hopelchén,04006,26029,24747,50776
2029,Campeche,04,Palizada,04007,5757,5630,11387
2029,Campeche,04,Tenabo,04008,6945,6624,13569
2029,Chiapas,07,Acacoyagua,07001,11262,11089,22351
2029,Chiapas,07,Acala,07002,19373,19887,39260
2029,Chiapas,07,Acapetahua,07003,17858,17798,35656
2029,Chiapas,07,Aldama,07113,3824,4171,7995
2029,Chiapas,07,Altamirano,07004,19914,19801,39715
2029,Chiapas,07,Amatenango de la Frontera,07006,18692,19606,38298
2029,Chiapas,07,Amatenango del Valle,07007,5703,6239,11942
2029,Chiapas,07,Amatán,07005,12219,11846,24065
2029,Chiapas,07,Angel Albino Corzo,07008,17259,17353,34612
2029,Chiapas,07,Arriaga,07009,24642,26592,51234
2029,Chiapas,07,Bejucal de Ocampo,07010,4698,4673,9371
2029,Chiapas,07,Bella Vista,07011,12484,12531,25015
2029,Chiapas,07,Benemérito de las Américas,07114,12528,12244,24772
2029,Chiapas,07,Berriozábal,07012,31653,32160,63813
2029,Chiapas,07,Bochil,07013,20671,21203,41874
2029,Chiapas,07,Cacahoatán,07015,27981,29391,57372
2029,Chiapas,07,Catazajá,07016,11063,10976,22039
2029,Chiapas,07,Chalchihuitán,07022,9687,9856,19543
2029,Chiapas,07,Chamula,07023,48513,57095,105608
2029,Chiapas,07,Chanal,07024,7312,7373,14685
2029,Chiapas,07,Chapultenango,07025,4639,4625,9264
2029,Chiapas,07,Chenalhó,07026,23861,24401,48262
2029,Chiapas,07,Chiapa de Corzo,07027,61379,64108,125487
2029,Chiapas,07,Chiapilla,07028,3712,3606,7318
2029,Chiapas,07,Chicoasén,07029,3127,3144,6271
2029,Chiapas,07,Chicomuselo,07030,21545,21743,43288
2029,Chiapas,07,Chilón,07031,76064,77861,153925
2029,Chiapas,07,Cintalapa,07017,52605,53961,106566
2029,Chiapas,07,Coapilla,07018,5534,5690,11224
2029,Chiapas,07,Comitán de Domínguez,07019,90993,100676,191669
2029,Chiapas,07,Copainalá,07021,13265,13903,27168
2029,Chiapas,07,El Bosque,07014,13118,14017,27135
2029,Chiapas,07,El Porvenir,07070,8635,8761,17396
2029,Chiapas,07,Escuintla,07032,19422,19930,39352
2029,Chiapas,07,Francisco León,07033,4640,4459,9099
2029,Chiapas,07,Frontera Comalapa,07034,44503,46671,91174
2029,Chiapas,07,Frontera Hidalgo,07035,8722,9224,17946
2029,Chiapas,07,Huehuetán,07037,21272,22374,43646
2029,Chiapas,07,Huitiupán,07039,14003,13846,27849
2029,Chiapas,07,Huixtla,07040,32634,35185,67819
2029,Chiapas,07,Huixtán,07038,14162,14753,28915
2029,Chiapas,07,Ixhuatán,07042,6831,6969,13800
2029,Chiapas,07,Ixtacomitán,07043,6541,6676,13217
2029,Chiapas,07,Ixtapa,07044,16337,16634,32971
2029,Chiapas,07,Ixtapangajoya,07045,3418,3348,6766
2029,Chiapas,07,Jiquipilas,07046,24699,25647,50346
2029,Chiapas,07,Jitotol,07047,12520,12274,24794
2029,Chiapas,07,Juárez,07048,13376,13785,27161
2029,Chiapas,07,La Concordia,07020,28768,28253,57021
2029,Chiapas,07,La Grandeza,07036,4323,4453,8776
2029,Chiapas,07,La Independencia,07041,27299,28360,55659
2029,Chiapas,07,La Libertad,07050,3095,3208,6303
2029,Chiapas,07,La Trinitaria,07099,47778,49892,97670
2029,Chiapas,07,Larráinzar,07049,13943,14474,28417
2029,Chiapas,07,Las Margaritas,07052,74777,76224,151001
2029,Chiapas,07,Las Rosas,07075,17006,17534,34540
2029,Chiapas,07,Mapastepec,07051,29193,30056,59249
2029,Chiapas,07,Maravilla Tenejapa,07115,7866,7649,15515
2029,Chiapas,07,Marqués de Comillas,07116,7184,6972,14156
2029,Chiapas,07,Mazapa de Madero,07053,4815,5019,9834
2029,Chiapas,07,Mazatán,07054,17974,18611,36585
2029,Chiapas,07,Metapa,07055,3386,3686,7072
2029,Chiapas,07,Mitontic,07056,7142,7231,14373
2029,Chiapas,07,Montecristo de Guerrero,07117,4589,4516,9105
2029,Chiapas,07,Motozintla,07057,43996,45602,89598
2029,Chiapas,07,Nicolás Ruíz,07058,2678,2533,5211
2029,Chiapas,07,Ocosingo,07059,131084,132120,263204
2029,Chiapas,07,Ocotepec,07060,7330,7714,15044
2029,Chiapas,07,Ocozocoautla de Espinosa,07061,55114,56847,111961
2029,Chiapas,07,Ostuacán,07062,11397,11239,22636
2029,Chiapas,07,Osumacinta,07063,2292,2295,4587
2029,Chiapas,07,Oxchuc,07064,28660,28553,57213
2029,Chiapas,07,Palenque,07065,71920,74006,145926
2029,Chiapas,07,Pantelhó,07066,13021,13252,26273
2029,Chiapas,07,Pantepec,07067,7350,7505,14855
2029,Chiapas,07,Pichucalco,07068,19337,19913,39250
2029,Chiapas,07,Pijijiapan,07069,33046,33958,67004
2029,Chiapas,07,Pueblo Nuevo Solistahuacán,07072,18319,20005,38324
2029,Chiapas,07,Rayón,07073,5781,5918,11699
2029,Chiapas,07,Reforma,07074,27796,28241,56037
2029,Chiapas,07,Sabanilla,07076,16327,16192,32519
2029,Chiapas,07,Salto de Agua,07077,38162,38659,76821
2029,Chiapas,07,San Andrés Duraznal,07118,3304,3485,6789
2029,Chiapas,07,San Cristóbal de las Casas,07078,120966,135772,256738
2029,Chiapas,07,San Fernando,07079,24467,23954,48421
2029,Chiapas,07,San Juan Cancuc,07112,20438,21349,41787
2029,Chiapas,07,San Lucas,07110,4383,4410,8793
2029,Chiapas,07,Santiago el Pinar,07119,2168,2122,4290
2029,Chiapas,07,Siltepec,07080,22332,21564,43896
2029,Chiapas,07,Simojovel,07081,26293,26849,53142
2029,Chiapas,07,Sitalá,07082,8449,8579,17028
2029,Chiapas,07,Socoltenango,07083,11323,11355,22678
2029,Chiapas,07,Solosuchiapa,07084,4944,4887,9831
2029,Chiapas,07,Soyaló,07085,6579,6550,13129
2029,Chiapas,07,Suchiapa,07086,14857,14944,29801
2029,Chiapas,07,Suchiate,07087,23161,24299,47460
2029,Chiapas,07,Sunuapa,07088,1476,1470,2946
2029,Chiapas,07,Tapachula,07089,207982,229279,437261
2029,Chiapas,07,Tapalapa,07090,2385,2526,4911
2029,Chiapas,07,Tapilula,07091,7788,8241,16029
2029,Chiapas,07,Tecpatán,07092,25586,25883,51469
2029,Chiapas,07,Tenejapa,07093,25333,26898,52231
2029,Chiapas,07,Teopisca,07094,25222,26770,51992
2029,Chiapas,07,Tila,07096,47634,47730,95364
2029,Chiapas,07,Tonalá,07097,55083,56997,112080
2029,Chiapas,07,Totolapa,07098,4419,4373,8792
2029,Chiapas,07,Tumbalá,07100,20286,21445,41731
2029,Chiapas,07,Tuxtla Chico,07102,25538,27296,52834
2029,Chiapas,07,Tuxtla Gutiérrez,07101,352466,393386,745852
2029,Chiapas,07,Tuzantán,07103,19685,20235,39920
2029,Chiapas,07,Tzimol,07104,9370,9820,19190
2029,Chiapas,07,Unión Juárez,07105,9463,9959,19422
2029,Chiapas,07,Venustiano Carranza,07106,39754,40235,79989
2029,Chiapas,07,Villa Comaltitlán,07071,17787,18106,35893
2029,Chiapas,07,Villa Corzo,07107,47716,49308,97024
2029,Chiapas,07,Villaflores,07108,64173,67386,131559
2029,Chiapas,07,Yajalón,07109,22650,23823,46473
2029,Chiapas,07,Zinacantán,07111,23044,26412,49456
2029,Chihuahua,08,Ahumada,08001,7117,6943,14060
2029,Chihuahua,08,Aldama,08002,14182,14289,28471
2029,Chihuahua,08,Allende,08003,5512,5388,10900
2029,Chihuahua,08,Aquiles Serdán,08004,9993,9839,19832
2029,Chihuahua,08,Ascensión,08005,14146,13821,27967
2029,Chihuahua,08,Bachíniva,08006,4029,3877,7906
2029,Chihuahua,08,Balleza,08007,9691,9377,19068
2029,Chihuahua,08,Batopilas,08008,6728,6699,13427
2029,Chihuahua,08,Bocoyna,08009,15565,16227,31792
2029,Chihuahua,08,Buenaventura,08010,13660,13299,26959
2029,Chihuahua,08,Camargo,08011,29891,31034,60925
2029,Chihuahua,08,Carichí,08012,5748,5547,11295
2029,Chihuahua,08,Casas Grandes,08013,6963,6599,13562
2029,Chihuahua,08,Chihuahua,08019,496072,528250,1024322
2029,Chihuahua,08,Chínipas,08020,4808,4359,9167
2029,Chihuahua,08,Coronado,08014,1445,1327,2772
2029,Chihuahua,08,Coyame del Sotol,08015,1177,961,2138
2029,Chihuahua,08,Cuauhtémoc,08017,94681,101252,195933
2029,Chihuahua,08,Cusihuiriachi,08018,3062,2819,5881
2029,Chihuahua,08,Delicias,08021,84791,89732,174523
2029,Chihuahua,08,Dr. Belisario Domínguez,08022,1831,1755,3586
2029,Chihuahua,08,El Tule,08064,1109,1063,2172
2029,Chihuahua,08,Galeana,08023,3707,3712,7419
2029,Chihuahua,08,Gran Morelos,08026,1770,1711,3481
2029,Chihuahua,08,Guachochi,08027,25625,26813,52438
2029,Chihuahua,08,Guadalupe,08028,2523,2520,5043
2029,Chihuahua,08,Guadalupe y Calvo,08029,30727,30079,60806
2029,Chihuahua,08,Guazapares,08030,4833,4624,9457
2029,Chihuahua,08,Guerrero,08031,23936,23493,47429
2029,Chihuahua,08,Gómez Farías,08025,5534,5479,11013
2029,Chihuahua,08,Hidalgo del Parral,08032,61850,66339,128189
2029,Chihuahua,08,Huejotitán,08033,644,646,1290
2029,Chihuahua,08,Ignacio Zaragoza,08034,4402,4286,8688
2029,Chihuahua,08,Janos,08035,6765,6187,12952
2029,Chihuahua,08,Jiménez,08036,24696,25207,49903
2029,Chihuahua,08,Julimes,08038,2857,2771,5628
2029,Chihuahua,08,Juárez,08037,765434,771069,1536503
2029,Chihuahua,08,La Cruz,08016,2439,2315,4754
2029,Chihuahua,08,López,08039,2607,2404,5011
2029,Chihuahua,08,Madera,08040,17373,17127,34500
2029,Chihuahua,08,Maguarichi,08041,955,895,1850
2029,Chihuahua,08,Manuel Benavides,08042,1030,867,1897
2029,Chihuahua,08,Matachí,08043,1936,1927,3863
2029,Chihuahua,08,Matamoros,08044,2832,2710,5542
2029,Chihuahua,08,Meoqui,08045,26049,26636,52685
2029,Chihuahua,08,Morelos,08046,4387,4314,8701
2029,Chihuahua,08,Moris,08047,3122,2927,6049
2029,Chihuahua,08,Namiquipa,08048,15196,14528,29724
2029,Chihuahua,08,Nonoava,08049,1669,1572,3241
2029,Chihuahua,08,Nuevo Casas Grandes,08050,35662,37384,73046
2029,Chihuahua,08,Ocampo,08051,4470,4160,8630
2029,Chihuahua,08,Ojinaga,08052,16666,16440,33106
2029,Chihuahua,08,Praxedis G. Guerrero,08053,2918,2831,5749
2029,Chihuahua,08,Riva Palacio,08054,4675,4473,9148
2029,Chihuahua,08,Rosales,08055,10213,10055,20268
2029,Chihuahua,08,Rosario,08056,1344,1266,2610
2029,Chihuahua,08,San Francisco de Borja,08057,1533,1440,2973
2029,Chihuahua,08,San Francisco de Conchos,08058,1677,1583,3260
2029,Chihuahua,08,San Francisco del Oro,08059,3301,3295,6596
2029,Chihuahua,08,Santa Bárbara,08060,6584,6742,13326
2029,Chihuahua,08,Santa Isabel,08024,2486,2521,5007
2029,Chihuahua,08,Satevó,08061,2149,2011,4160
2029,Chihuahua,08,Saucillo,08062,19054,18926,37980
2029,Chihuahua,08,Temósachic,08063,4177,3989,8166
2029,Chihuahua,08,Urique,08065,12192,11778,23970
2029,Chihuahua,08,Uruachi,08066,3401,3205,6606
2029,Chihuahua,08,Valle de Zaragoza,08067,3423,3249,6672
2029,Ciudad de México,09,Azcapotzalco,09002,191615,217499,409114
2029,Ciudad de México,09,Benito Juárez,09014,201953,240996,442949
2029,Ciudad de México,09,Coyoacán,09003,290445,331662,622107
2029,Ciudad de México,09,Cuajimalpa de Morelos,09004,90904,97020,187924
2029,Ciudad de México,09,Cuauhtémoc,09015,258265,289496,547761
2029,Ciudad de México,09,Gustavo A. Madero,09005,556418,606617,1163035
2029,Ciudad de México,09,Iztacalco,09006,185096,206642,391738
2029,Ciudad de México,09,Iztapalapa,09007,840238,892452,1732690
2029,Ciudad de México,09,La Magdalena Contreras,09008,113473,122453,235926
2029,Ciudad de México,09,Miguel Hidalgo,09016,175491,206152,381643
2029,Ciudad de México,09,Milpa Alta,09009,63348,65819,129167
2029,Ciudad de México,09,Tlalpan,09012,314084,342974,657058
2029,Ciudad de México,09,Tláhuac,09011,165459,177290,342749
2029,Ciudad de México,09,Venustiano Carranza,09017,203150,230791,433941
2029,Ciudad de México,09,Xochimilco,09013,192736,202334,395070
2029,Ciudad de México,09,Álvaro Obregón,09010,350162,384483,734645
2029,Coahuila,05,Abasolo,05001,684,671,1355
2029,Coahuila,05,Acuña,05002,87988,87064,175052
2029,Coahuila,05,Allende,05003,13649,13965,27614
2029,Coahuila,05,Arteaga,05004,14717,13980,28697
2029,Coahuila,05,Candela,05005,1184,1080,2264
2029,Coahuila,05,Castaños,05006,17157,17055,34212
2029,Coahuila,05,Cuatro Ciénegas,05007,8370,8181,16551
2029,Coahuila,05,Escobedo,05008,1960,1864,3824
2029,Coahuila,05,Francisco I. Madero,05009,36310,36336,72646
2029,Coahuila,05,Frontera,05010,49218,48787,98005
2029,Coahuila,05,General Cepeda,05011,8113,7387,15500
2029,Coahuila,05,Guerrero,05012,1202,1065,2267
2029,Coahuila,05,Hidalgo,05013,1052,1001,2053
2029,Coahuila,05,Jiménez,05014,6269,6012,12281
2029,Coahuila,05,Juárez,05015,1034,937,1971
2029,Coahuila,05,Lamadrid,05016,1200,1131,2331
2029,Coahuila,05,Matamoros,05017,66607,66253,132860
2029,Coahuila,05,Monclova,05018,139756,142351,282107
2029,Coahuila,05,Morelos,05019,5372,5250,10622
2029,Coahuila,05,Múzquiz,05020,43311,42465,85776
2029,Coahuila,05,Nadadores,05021,4104,4010,8114
2029,Coahuila,05,Nava,05022,18605,17588,36193
2029,Coahuila,05,Ocampo,05023,6683,6105,12788
2029,Coahuila,05,Parras,05024,27874,26645,54519
2029,Coahuila,05,Piedras Negras,05025,97479,96897,194376
2029,Coahuila,05,Progreso,05026,2179,2022,4201
2029,Coahuila,05,Ramos Arizpe,05027,57743,55220,112963
2029,Coahuila,05,Sabinas,05028,39074,38990,78064
2029,Coahuila,05,Sacramento,05029,1507,1450,2957
2029,Coahuila,05,Saltillo,05030,477890,482006,959896
2029,Coahuila,05,San Buenaventura,05031,14675,14669,29344
2029,Coahuila,05,San Juan de Sabinas,05032,26452,27763,54215
2029,Coahuila,05,San Pedro,05033,66533,66626,133159
2029,Coahuila,05,Sierra Mojada,05034,4719,4300,9019
2029,Coahuila,05,Torreón,05035,405363,426798,832161
2029,Coahuila,05,Viesca,05036,13798,13190,26988
2029,Coahuila,05,Villa Unión,05037,3974,3761,7735
2029,Coahuila,05,Zaragoza,05038,8012,7925,15937
2029,Colima,06,Armería,06001,18898,18411,37309
2029,Colima,06,Colima,06002,94755,100211,194966
2029,Colima,06,Comala,06003,13733,13522,27255
2029,Colima,06,Coquimatlán,06004,12855,12461,25316
2029,Colima,06,Cuauhtémoc,06005,19192,18809,38001
2029,Colima,06,Ixtlahuacán,06006,3602,3488,7090
2029,Colima,06,Manzanillo,06007,115338,111844,227182
2029,Colima,06,Minatitlán,06008,5848,5295,11143
2029,Colima,06,Tecomán,06009,76621,74628,151249
2029,Colima,06,Villa de Álvarez,06010,81383,84949,166332
2029,Durango,10,Canatlán,10001,18822,19299,38121
2029,Durango,10,Canelas,10002,2666,2457,5123
2029,Durango,10,Coneto de Comonfort,10003,2531,2521,5052
2029,Durango,10,Cuencamé,10004,20465,20118,40583
2029,Durango,10,Durango,10005,356519,383196,739715
2029,Durango,10,El Oro,10018,6879,7003,13882
2029,Durango,10,General Simón Bolívar,10006,5917,5950,11867
2029,Durango,10,Guadalupe Victoria,10008,20200,20622,40822
2029,Durango,10,Guanaceví,10009,5913,5543,11456
2029,Durango,10,Gómez Palacio,10007,193671,198846,392517
2029,Durango,10,Hidalgo,10010,2373,2308,4681
2029,Durango,10,Indé,10011,3144,3089,6233
2029,Durango,10,Lerdo,10012,86798,87892,174690
2029,Durango,10,Mapimí,10013,15199,15126,30325
2029,Durango,10,Mezquital,10014,20436,21166,41602
2029,Durango,10,Nazas,10015,7642,7614,15256
2029,Durango,10,Nombre de Dios,10016,11418,11434,22852
2029,Durango,10,Nuevo Ideal,10039,15548,15741,31289
2029,Durango,10,Ocampo,10017,5954,5731,11685
2029,Durango,10,Otáez,10019,3010,2769,5779
2029,Durango,10,Peñón Blanco,10021,6358,6236,12594
2029,Durango,10,Poanas,10022,14570,14814,29384
2029,Durango,10,Pueblo Nuevo,10023,27381,27584,54965
2029,Durango,10,Pánuco de Coronado,10020,7074,7228,14302
2029,Durango,10,Rodeo,10024,7976,7921,15897
2029,Durango,10,San Bernardo,10025,2131,1888,4019
2029,Durango,10,San Dimas,10026,11038,10374,21412
2029,Durango,10,San Juan de Guadalupe,10027,3213,3328,6541
2029,Durango,10,San Juan del Río,10028,7312,7381,14693
2029,Durango,10,San Luis del Cordero,10029,1268,1234,2502
2029,Durango,10,San Pedro del Gallo,10030,970,884,1854
2029,Durango,10,Santa Clara,10031,4132,4123,8255
2029,Durango,10,Santiago Papasquiaro,10032,27431,27480,54911
2029,Durango,10,Súchil,10033,3541,3816,7357
2029,Durango,10,Tamazula,10034,14816,13464,28280
2029,Durango,10,Tepehuanes,10035,6333,6429,12762
2029,Durango,10,Tlahualilo,10036,13830,13668,27498
2029,Durango,10,Topia,10037,5482,5081,10563
2029,Durango,10,Vicente Guerrero,10038,12144,12850,24994
2029,Estado de México,15,Acambay de Ruíz Castañeda,15001,36578,38520,75098
2029,Estado de México,15,Acolman,15002,98812,98900,197712
2029,Estado de México,15,Aculco,15003,27802,28190,55992
2029,Estado de México,15,Almoloya de Alquisiras,15004,8141,8732,16873
2029,Estado de México,15,Almoloya de Juárez,15005,98174,100163,198337
2029,Estado de México,15,Almoloya del Río,15006,6331,6788,13119
2029,Estado de México,15,Amanalco,15007,13559,13963,27522
2029,Estado de México,15,Amatepec,15008,15712,16381,32093
2029,Estado de México,15,Amecameca,15009,28566,30552,59118
2029,Estado de México,15,Apaxco,15010,16775,17133,33908
2029,Estado de México,15,Atenco,15011,36594,37488,74082
2029,Estado de México,15,Atizapán,15012,6417,6756,13173
2029,Estado de México,15,Atizapán de Zaragoza,15013,292153,310319,602472
2029,Estado de México,15,Atlacomulco,15014,54384,59268,113652
2029,Estado de México,15,Atlautla,15015,17411,18002,35413
2029,Estado de México,15,Axapusco,15016,16236,16266,32502
2029,Estado de México,15,Ayapango,15017,5836,6046,11882
2029,Estado de México,15,Calimaya,15018,31499,32901,64400
2029,Estado de México,15,Capulhuac,15019,19805,21020,40825
2029,Estado de México,15,Chalco,15025,212829,219996,432825
2029,Estado de México,15,Chapa de Mota,15026,15859,16495,32354
2029,Estado de México,15,Chapultepec,15027,6839,7004,13843
2029,Estado de México,15,Chiautla,15028,16840,17436,34276
2029,Estado de México,15,Chicoloapan,15029,115303,122366,237669
2029,Estado de México,15,Chiconcuac,15030,14603,14993,29596
2029,Estado de México,15,Chimalhuacán,15031,367500,379005,746505
2029,Estado de México,15,Coacalco de Berriozábal,15020,160217,173520,333737
2029,Estado de México,15,Coatepec Harinas,15021,21583,22984,44567
2029,Estado de México,15,Cocotitlán,15022,8143,8526,16669
2029,Estado de México,15,Coyotepec,15023,23072,23497,46569
2029,Estado de México,15,Cuautitlán,15024,91160,93166,184326
2029,Estado de México,15,Cuautitlán Izcalli,15121,304165,320516,624681
2029,Estado de México,15,Donato Guerra,15032,18593,19220,37813
2029,Estado de México,15,Ecatepec de Morelos,15033,916269,941371,1857640
2029,Estado de México,15,Ecatzingo,15034,5276,5389,10665
2029,Estado de México,15,El Oro,15064,20557,22071,42628
2029,Estado de México,15,Huehuetoca,15035,75994,77679,153673
2029,Estado de México,15,Hueypoxtla,15036,25431,24803,50234
2029,Estado de México,15,Huixquilucan,15037,150799,161899,312698
2029,Estado de México,15,Isidro Fabela,15038,6607,6659,13266
2029,Estado de México,15,Ixtapaluca,15039,281076,290221,571297
2029,Estado de México,15,Ixtapan de la Sal,15040,19883,21326,41209
2029,Estado de México,15,Ixtapan del Oro,15041,4008,3895,7903
2029,Estado de México,15,Ixtlahuaca,15042,83838,89931,173769
2029,Estado de México,15,Jaltenco,15044,15292,16242,31534
2029,Estado de México,15,Jilotepec,15045,50308,51659,101967
2029,Estado de México,15,Jilotzingo,15046,10735,11306,22041
2029,Estado de México,15,Jiquipilco,15047,40972,43535,84507
2029,Estado de México,15,Jocotitlán,15048,36633,39049,75682
2029,Estado de México,15,Joquicingo,15049,7735,7987,15722
2029,Estado de México,15,Juchitepec,15050,14350,14730,29080
2029,Estado de México,15,La Paz,15070,161947,165607,327554
2029,Estado de México,15,Lerma,15051,84188,86358,170546
2029,Estado de México,15,Luvianos,15123,16091,16344,32435
2029,Estado de México,15,Malinalco,15052,15812,16138,31950
2029,Estado de México,15,Melchor Ocampo,15053,32074,33351,65425
2029,Estado de México,15,Metepec,15054,129406,137942,267348
2029,Estado de México,15,Mexicaltzingo,15055,7139,7601,14740
2029,Estado de México,15,Morelos,15056,16616,17968,34584
2029,Estado de México,15,Naucalpan de Juárez,15057,491759,523588,1015347
2029,Estado de México,15,Nextlalpan,15059,22613,23083,45696
2029,Estado de México,15,Nezahualcóyotl,15058,618756,667784,1286540
2029,Estado de México,15,Nicolás Romero,15060,229875,239138,469013
2029,Estado de México,15,Nopaltepec,15061,5247,5246,10493
2029,Estado de México,15,Ocoyoacac,15062,37858,39133,76991
2029,Estado de México,15,Ocuilan,15063,19159,19739,38898
2029,Estado de México,15,Otumba,15065,20681,20384,41065
2029,Estado de México,15,Otzoloapan,15066,2320,2250,4570
2029,Estado de México,15,Otzolotepec,15067,47025,48170,95195
2029,Estado de México,15,Ozumba,15068,16178,17389,33567
2029,Estado de México,15,Papalotla,15069,2276,2401,4677
2029,Estado de México,15,Polotitlán,15071,8117,8378,16495
2029,Estado de México,15,Rayón,15072,7718,7925,15643
2029,Estado de México,15,San Antonio la Isla,15073,16540,16843,33383
2029,Estado de México,15,San Felipe del Progreso,15074,70799,78820,149619
2029,Estado de México,15,San José del Rincón,15124,50050,51263,101313
2029,Estado de México,15,San Martín de las Pirámides,15075,15516,15782,31298
2029,Estado de México,15,San Mateo Atenco,15076,42044,43401,85445
2029,Estado de México,15,San Simón de Guerrero,15077,3416,3600,7016
2029,Estado de México,15,Santo Tomás,15078,5511,5608,11119
2029,Estado de México,15,Soyaniquilpan de Juárez,15079,7739,7807,15546
2029,Estado de México,15,Sultepec,15080,14716,16139,30855
2029,Estado de México,15,Tecámac,15081,258826,270568,529394
2029,Estado de México,15,Tejupilco,15082,42175,45114,87289
2029,Estado de México,15,Temamatla,15083,7088,7363,14451
2029,Estado de México,15,Temascalapa,15084,22276,22224,44500
2029,Estado de México,15,Temascalcingo,15085,35169,37941,73110
2029,Estado de México,15,Temascaltepec,15086,18199,18787,36986
2029,Estado de México,15,Temoaya,15087,55614,58816,114430
2029,Estado de México,15,Tenancingo,15088,54921,57836,112757
2029,Estado de México,15,Tenango del Aire,15089,7125,7286,14411
2029,Estado de México,15,Tenango del Valle,15090,48014,49905,97919
2029,Estado de México,15,Teoloyucan,15091,36021,36816,72837
2029,Estado de México,15,Teotihuacán,15092,32125,33059,65184
2029,Estado de México,15,Tepetlaoxtoc,15093,17679,17856,35535
2029,Estado de México,15,Tepetlixpa,15094,11326,11584,22910
2029,Estado de México,15,Tepotzotlán,15095,54715,56583,111298
2029,Estado de México,15,Tequixquiac,15096,21204,21345,42549
2029,Estado de México,15,Texcaltitlán,15097,10484,11036,21520
2029,Estado de México,15,Texcalyacac,15098,3012,3104,6116
2029,Estado de México,15,Texcoco,15099,136868,145393,282261
2029,Estado de México,15,Tezoyuca,15100,24582,24760,49342
2029,Estado de México,15,Tianguistenco,15101,42750,45013,87763
2029,Estado de México,15,Timilpan,15102,8858,9549,18407
2029,Estado de México,15,Tlalmanalco,15103,27068,29056,56124
2029,Estado de México,15,Tlalnepantla de Baz,15104,414636,444723,859359
2029,Estado de México,15,Tlatlaya,15105,20829,21562,42391
2029,Estado de México,15,Toluca,15106,489636,525869,1015505
2029,Estado de México,15,Tonanitla,15125,5446,5568,11014
2029,Estado de México,15,Tonatico,15107,7314,7827,15141
2029,Estado de México,15,Tultepec,15108,82854,85710,168564
2029,Estado de México,15,Tultitlán,15109,289395,300660,590055
2029,Estado de México,15,Valle de Bravo,15110,36562,37913,74475
2029,Estado de México,15,Valle de Chalco Solidaridad,15122,218901,225523,444424
2029,Estado de México,15,Villa Guerrero,15113,37575,38503,76078
2029,Estado de México,15,Villa Victoria,15114,57496,58232,115728
2029,Estado de México,15,Villa de Allende,15111,28135,29406,57541
2029,Estado de México,15,Villa del Carbón,15112,26981,26651,53632
2029,Estado de México,15,Xalatlaco,15043,16621,17467,34088
2029,Estado de México,15,Xonacatlán,15115,29083,28830,57913
2029,Estado de México,15,Zacazonapan,15116,2324,2273,4597
2029,Estado de México,15,Zacualpan,15117,8503,9328,17831
2029,Estado de México,15,Zinacantepec,15118,105391,107934,213325
2029,Estado de México,15,Zumpahuacán,15119,9139,9940,19079
2029,Estado de México,15,Zumpango,15120,111266,118576,229842
2029,Guanajuato,11,Abasolo,11001,49866,52583,102449
2029,Guanajuato,11,Acámbaro,11002,63308,68412,131720
2029,Guanajuato,11,Apaseo el Alto,11004,37473,39158,76631
2029,Guanajuato,11,Apaseo el Grande,11005,50975,53988,104963
2029,Guanajuato,11,Atarjea,11006,3005,3084,6089
2029,Guanajuato,11,Celaya,11007,273838,290456,564294
2029,Guanajuato,11,Comonfort,11009,43706,48328,92034
2029,Guanajuato,11,Coroneo,11010,6651,7408,14059
2029,Guanajuato,11,Cortazar,11011,52941,56135,109076
2029,Guanajuato,11,Cuerámaro,11012,15598,16786,32384
2029,Guanajuato,11,Doctor Mora,11013,12947,13926,26873
2029,Guanajuato,11,Dolores Hidalgo Cuna de la Independencia Nacional,11014,79836,88791,168627
2029,Guanajuato,11,Guanajuato,11015,103045,107760,210805
2029,Guanajuato,11,Huanímaro,11016,11723,12848,24571
2029,Guanajuato,11,Irapuato,11017,316092,332971,649063
2029,Guanajuato,11,Jaral del Progreso,11018,22069,22587,44656
2029,Guanajuato,11,Jerécuaro,11019,26216,29631,55847
2029,Guanajuato,11,León,11020,875397,892771,1768168
2029,Guanajuato,11,Manuel Doblado,11008,21326,22925,44251
2029,Guanajuato,11,Moroleón,11021,28631,31606,60237
2029,Guanajuato,11,Ocampo,11022,12818,13575,26393
2029,Guanajuato,11,Pueblo Nuevo,11024,6611,7254,13865
2029,Guanajuato,11,Purísima del Rincón,11025,44875,44570,89445
2029,Guanajuato,11,Pénjamo,11023,82851,90135,172986
2029,Guanajuato,11,Romita,11026,32652,33997,66649
2029,Guanajuato,11,Salamanca,11027,154259,162690,316949
2029,Guanajuato,11,Salvatierra,11028,56393,61989,118382
2029,Guanajuato,11,San Diego de la Unión,11029,20667,23600,44267
2029,Guanajuato,11,San Felipe,11030,61191,64474,125665
2029,Guanajuato,11,San Francisco del Rincón,11031,64870,68113,132983
2029,Guanajuato,11,San José Iturbide,11032,42597,44947,87544
2029,Guanajuato,11,San Luis de la Paz,11033,63788,69949,133737
2029,Guanajuato,11,San Miguel de Allende,11003,93770,100783,194553
2029,Guanajuato,11,Santa Catarina,11034,2854,3142,5996
2029,Guanajuato,11,Santa Cruz de Juventino Rosas,11035,45463,48332,93795
2029,Guanajuato,11,Santiago Maravatío,11036,4005,4413,8418
2029,Guanajuato,11,Silao de la Victoria,11037,104677,107006,211683
2029,Guanajuato,11,Tarandacuao,11038,6870,7570,14440
2029,Guanajuato,11,Tarimoro,11039,19691,20640,40331
2029,Guanajuato,11,Tierra Blanca,11040,10242,11061,21303
2029,Guanajuato,11,Uriangato,11041,35147,37522,72669
2029,Guanajuato,11,Valle de Santiago,11042,79545,87373,166918
2029,Guanajuato,11,Victoria,11043,10908,12215,23123
2029,Guanajuato,11,Villagrán,11044,32566,33981,66547
2029,Guanajuato,11,Xichú,11045,6385,6979,13364
2029,Guanajuato,11,Yuriria,11046,39150,42724,81874
2029,Guerrero,12,Acapulco de Juárez,12001,414148,449753,863901
2029,Guerrero,12,Acatepec,12076,17957,18987,36944
2029,Guerrero,12,Ahuacuotzingo,12002,12872,14560,27432
2029,Guerrero,12,Ajuchitlán del Progreso,12003,19288,20476,39764
2029,Guerrero,12,Alcozauca de Guerrero,12004,9436,10705,20141
2029,Guerrero,12,Alpoyeca,12005,3348,3733,7081
2029,Guerrero,12,Apaxtla,12006,5922,6397,12319
2029,Guerrero,12,Arcelia,12007,16357,17381,33738
2029,Guerrero,12,Atenango del Río,12008,4470,4823,9293
2029,Guerrero,12,Atlamajalcingo del Monte,12009,2520,2779,5299
2029,Guerrero,12,Atlixtac,12010,13386,14274,27660
2029,Guerrero,12,Atoyac de Álvarez,12011,31866,33093,64959
2029,Guerrero,12,Ayutla de los Libres,12012,34055,35373,69428
2029,Guerrero,12,Azoyú,12013,7179,7550,14729
2029,Guerrero,12,Benito Juárez,12014,8290,8722,17012
2029,Guerrero,12,Buenavista de Cuéllar,12015,6964,7353,14317
2029,Guerrero,12,Chilapa de Álvarez,12028,63253,70503,133756
2029,Guerrero,12,Chilpancingo de los Bravo,12029,137039,149214,286253
2029,Guerrero,12,Coahuayutla de José María Izazaga,12016,6666,6330,12996
2029,Guerrero,12,Cochoapa el Grande,12078,8631,9565,18196
2029,Guerrero,12,Cocula,12017,7195,7681,14876
2029,Guerrero,12,Copala,12018,7416,7673,15089
2029,Guerrero,12,Copalillo,12019,7261,7914,15175
2029,Guerrero,12,Copanatoyac,12020,9779,10788,20567
2029,Guerrero,12,Coyuca de Benítez,12021,39733,41273,81006
2029,Guerrero,12,Coyuca de Catalán,12022,21115,20888,42003
2029,Guerrero,12,Cuajinicuilapa,12023,14335,14255,28590
2029,Guerrero,12,Cualác,12024,3849,4060,7909
2029,Guerrero,12,Cuautepec,12025,8400,8388,16788
2029,Guerrero,12,Cuetzala del Progreso,12026,4611,4858,9469
2029,Guerrero,12,Cutzamala de Pinzón,12027,10775,11226,22001
2029,Guerrero,12,Eduardo Neri,12075,26332,27461,53793
2029,Guerrero,12,Florencio Villarreal,12030,10801,11035,21836
2029,Guerrero,12,General Canuto A. Neri,12031,3061,3336,6397
2029,Guerrero,12,General Heliodoro Castillo,12032,18812,18750,37562
2029,Guerrero,12,Huamuxtitlán,12033,7658,8602,16260
2029,Guerrero,12,Huitzuco de los Figueroa,12034,19523,21094,40617
2029,Guerrero,12,Iguala de la Independencia,12035,77861,84164,162025
2029,Guerrero,12,Igualapa,12036,5718,5874,11592
2029,Guerrero,12,Iliatenco,12081,5362,5969,11331
2029,Guerrero,12,Ixcateopan de Cuauhtémoc,12037,3238,3617,6855
2029,Guerrero,12,José Joaquín de Herrera,12079,8790,8998,17788
2029,Guerrero,12,Juan R. Escudero,12039,12926,13519,26445
2029,Guerrero,12,Juchitán,12080,4024,3977,8001
2029,Guerrero,12,La Unión de Isidoro Montes de Oca,12068,14317,13642,27959
2029,Guerrero,12,Leonardo Bravo,12040,13412,13655,27067
2029,Guerrero,12,Malinaltepec,12041,13333,14971,28304
2029,Guerrero,12,Marquelia,12077,7163,7271,14434
2029,Guerrero,12,Metlatónoc,12043,8962,10281,19243
2029,Guerrero,12,Mochitlán,12044,6670,6954,13624
2029,Guerrero,12,Mártir de Cuilapan,12042,9340,10213,19553
2029,Guerrero,12,Olinalá,12045,12841,13705,26546
2029,Guerrero,12,Ometepec,12046,34002,35708,69710
2029,Guerrero,12,Pedro Ascencio Alquisiras,12047,3380,3920,7300
2029,Guerrero,12,Petatlán,12048,23117,23588,46705
2029,Guerrero,12,Pilcaya,12049,6667,7043,13710
2029,Guerrero,12,Pungarabato,12050,18969,20288,39257
2029,Guerrero,12,Quechultenango,12051,18309,19019,37328
2029,Guerrero,12,San Luis Acatlán,12052,21972,22534,44506
2029,Guerrero,12,San Marcos,12053,25778,26588,52366
2029,Guerrero,12,San Miguel Totolapan,12054,13972,14548,28520
2029,Guerrero,12,Taxco de Alarcón,12055,55470,60775,116245
2029,Guerrero,12,Tecoanapa,12056,23751,24408,48159
2029,Guerrero,12,Teloloapan,12058,28976,32616,61592
2029,Guerrero,12,Tepecoacuilco de Trujano,12059,16785,18290,35075
2029,Guerrero,12,Tetipac,12060,7518,7878,15396
2029,Guerrero,12,Tixtla de Guerrero,12061,21781,23651,45432
2029,Guerrero,12,Tlacoachistlahuaca,12062,11260,12647,23907
2029,Guerrero,12,Tlacoapa,12063,4990,5598,10588
2029,Guerrero,12,Tlalchapa,12064,6859,6915,13774
2029,Guerrero,12,Tlalixtaquilla de Maldonado,12065,3784,4073,7857
2029,Guerrero,12,Tlapa de Comonfort,12066,43895,48829,92724
2029,Guerrero,12,Tlapehuala,12067,11284,12154,23438
2029,Guerrero,12,Técpan de Galeana,12057,34701,35283,69984
2029,Guerrero,12,Xalpatláhuac,12069,5721,6652,12373
2029,Guerrero,12,Xochihuehuetlán,12070,3636,4123,7759
2029,Guerrero,12,Xochistlahuaca,12071,14561,15430,29991
2029,Guerrero,12,Zapotitlán Tablas,12072,6458,7101,13559
2029,Guerrero,12,Zihuatanejo de Azueta,12038,64853,66593,131446
2029,Guerrero,12,Zirándaro,12073,9676,9317,18993
2029,Guerrero,12,Zitlala,12074,11360,12702,24062
2029,Hidalgo,13,Acatlán,13001,11660,12413,24073
2029,Hidalgo,13,Acaxochitlán,13002,23773,25851,49624
2029,Hidalgo,13,Actopan,13003,31805,35381,67186
2029,Hidalgo,13,Agua Blanca de Iturbide,13004,5071,5604,10675
2029,Hidalgo,13,Ajacuba,13005,10786,11185,21971
2029,Hidalgo,13,Alfajayucan,13006,12089,12691,24780
2029,Hidalgo,13,Almoloya,13007,7156,7227,14383
2029,Hidalgo,13,Apan,13008,25334,27549,52883
2029,Hidalgo,13,Atitalaquia,13010,17371,17753,35124
2029,Hidalgo,13,Atlapexco,13011,11481,12501,23982
2029,Hidalgo,13,Atotonilco de Tula,13013,21685,22807,44492
2029,Hidalgo,13,Atotonilco el Grande,13012,15520,17216,32736
2029,Hidalgo,13,Calnali,13014,10082,10965,21047
2029,Hidalgo,13,Cardonal,13015,10725,11532,22257
2029,Hidalgo,13,Chapantongo,13017,8064,8439,16503
2029,Hidalgo,13,Chapulhuacán,13018,14095,13854,27949
2029,Hidalgo,13,Chilcuautla,13019,10658,10898,21556
2029,Hidalgo,13,Cuautepec de Hinojosa,13016,32428,35429,67857
2029,Hidalgo,13,El Arenal,13009,10550,11429,21979
2029,Hidalgo,13,Eloxochitlán,13020,1630,1843,3473
2029,Hidalgo,13,Emiliano Zapata,13021,8291,9204,17495
2029,Hidalgo,13,Epazoyucan,13022,8577,9086,17663
2029,Hidalgo,13,Francisco I. Madero,13023,20520,22292,42812
2029,Hidalgo,13,Huasca de Ocampo,13024,10029,10895,20924
2029,Hidalgo,13,Huautla,13025,12536,13951,26487
2029,Hidalgo,13,Huazalingo,13026,7921,8444,16365
2029,Hidalgo,13,Huehuetla,13027,14632,15547,30179
2029,Hidalgo,13,Huejutla de Reyes,13028,73994,77214,151208
2029,Hidalgo,13,Huichapan,13029,26384,28493,54877
2029,Hidalgo,13,Ixmiquilpan,13030,51478,57637,109115
2029,Hidalgo,13,Jacala de Ledezma,13031,7786,8636,16422
2029,Hidalgo,13,Jaltocán,13032,6943,7175,14118
2029,Hidalgo,13,Juárez Hidalgo,13033,1861,2033,3894
2029,Hidalgo,13,La Misión,13040,6103,6228,12331
2029,Hidalgo,13,Lolotla,13034,5515,5834,11349
2029,Hidalgo,13,Metepec,13035,6409,7201,13610
2029,Hidalgo,13,Metztitlán,13037,11923,13155,25078
2029,Hidalgo,13,Mineral de la Reforma,13051,94958,104790,199748
2029,Hidalgo,13,Mineral del Chico,13038,5198,5500,10698
2029,Hidalgo,13,Mineral del Monte,13039,8337,9177,17514
2029,Hidalgo,13,Mixquiahuala de Juárez,13041,26463,28332,54795
2029,Hidalgo,13,Molango de Escamilla,13042,6837,7155,13992
2029,Hidalgo,13,Nicolás Flores,13043,3942,4401,8343
2029,Hidalgo,13,Nopala de Villagrán,13044,10010,10309,20319
2029,Hidalgo,13,Omitlán de Juárez,13045,5560,5996,11556
2029,Hidalgo,13,Pachuca de Soto,13048,144688,160968,305656
2029,Hidalgo,13,Pacula,13047,2842,3235,6077
2029,Hidalgo,13,Pisaflores,13049,10244,10129,20373
2029,Hidalgo,13,Progreso de Obregón,13050,13265,14773,28038
2029,Hidalgo,13,San Agustín Metzquititlán,13036,5571,6065,11636
2029,Hidalgo,13,San Agustín Tlaxiaca,13052,20941,21849,42790
2029,Hidalgo,13,San Bartolo Tutotepec,13053,10923,11277,22200
2029,Hidalgo,13,San Felipe Orizatlán,13046,22437,23374,45811
2029,Hidalgo,13,San Salvador,13054,20199,21648,41847
2029,Hidalgo,13,Santiago Tulantepec de Lugo Guerrero,13056,20673,22611,43284
2029,Hidalgo,13,Santiago de Anaya,13055,9937,10360,20297
2029,Hidalgo,13,Singuilucan,13057,9478,9657,19135
2029,Hidalgo,13,Tasquillo,13058,9056,10487,19543
2029,Hidalgo,13,Tecozautla,13059,21469,22961,44430
2029,Hidalgo,13,Tenango de Doria,13060,10268,11293,21561
2029,Hidalgo,13,Tepeapulco,13061,31662,33712,65374
2029,Hidalgo,13,Tepehuacán de Guerrero,13062,17952,17428,35380
2029,Hidalgo,13,Tepeji del Río de Ocampo,13063,50061,51344,101405
2029,Hidalgo,13,Tepetitlán,13064,6402,6765,13167
2029,Hidalgo,13,Tetepango,13065,6793,6815,13608
2029,Hidalgo,13,Tezontepec de Aldama,13067,30591,31221,61812
2029,Hidalgo,13,Tianguistengo,13068,8711,9135,17846
2029,Hidalgo,13,Tizayuca,13069,72674,74715,147389
2029,Hidalgo,13,Tlahuelilpan,13070,11062,11469,22531
2029,Hidalgo,13,Tlahuiltepa,13071,6236,6202,12438
2029,Hidalgo,13,Tlanalapa,13072,6013,6401,12414
2029,Hidalgo,13,Tlanchinol,13073,22673,23019,45692
2029,Hidalgo,13,Tlaxcoapan,13074,16476,16861,33337
2029,Hidalgo,13,Tolcayuca,13075,9340,9911,19251
2029,Hidalgo,13,Tula de Allende,13076,63166,67096,130262
2029,Hidalgo,13,Tulancingo de Bravo,13077,87122,97116,184238
2029,Hidalgo,13,Villa de Tezontepec,13066,7099,7432,14531
2029,Hidalgo,13,Xochiatipan,13078,11102,11955,23057
2029,Hidalgo,13,Xochicoatlán,13079,4677,4832,9509
2029,Hidalgo,13,Yahualica,13080,13879,14629,28508
2029,Hidalgo,13,Zacualtipán de Ángeles,13081,19502,21324,40826
2029,Hidalgo,13,Zapotlán de Juárez,13082,10646,11547,22193
2029,Hidalgo,13,Zempoala,13083,26959,28560,55519
2029,Hidalgo,13,Zimapán,13084,21954,25215,47169
2029,Jalisco,14,Acatic,14001,12135,12623,24758
2029,Jalisco,14,Acatlán de Juárez,14002,12872,12734,25606
2029,Jalisco,14,Ahualulco de Mercado,14003,13274,13629,26903
2029,Jalisco,14,Amacueca,14004,3146,3278,6424
2029,Jalisco,14,Amatitán,14005,8741,8773,17514
2029,Jalisco,14,Ameca,14006,35324,36578,71902
2029,Jalisco,14,Arandas,14008,41165,44445,85610
2029,Jalisco,14,Atemajac de Brizuela,14010,3768,3808,7576
2029,Jalisco,14,Atengo,14011,3428,3200,6628
2029,Jalisco,14,Atenguillo,14012,2359,2462,4821
2029,Jalisco,14,Atotonilco el Alto,14013,34447,35487,69934
2029,Jalisco,14,Atoyac,14014,4702,5022,9724
2029,Jalisco,14,Autlán de Navarro,14015,35017,36193,71210
2029,Jalisco,14,Ayotlán,14016,21449,22279,43728
2029,Jalisco,14,Ayutla,14017,7494,7412,14906
2029,Jalisco,14,Bolaños,14019,4370,4351,8721
2029,Jalisco,14,Cabo Corrientes,14020,6344,5777,12121
2029,Jalisco,14,Casimiro Castillo,14021,12922,12802,25724
2029,Jalisco,14,Cañadas de Obregón,14117,2488,2610,5098
2029,Jalisco,14,Chapala,14030,29261,30803,60064
2029,Jalisco,14,Chimaltitán,14031,1912,1948,3860
2029,Jalisco,14,Chiquilistlán,14032,3537,3472,7009
2029,Jalisco,14,Cihuatlán,14022,24079,23360,47439
2029,Jalisco,14,Cocula,14024,15430,16130,31560
2029,Jalisco,14,Colotlán,14025,10197,10888,21085
2029,Jalisco,14,Concepción de Buenos Aires,14026,3696,3565,7261
2029,Jalisco,14,Cuautitlán de García Barragán,14027,10434,10106,20540
2029,Jalisco,14,Cuautla,14028,1284,1375,2659
2029,Jalisco,14,Cuquío,14029,10339,11097,21436
2029,Jalisco,14,Degollado,14033,12201,12868,25069
2029,Jalisco,14,Ejutla,14034,1220,1137,2357
2029,Jalisco,14,El Arenal,14009,11206,11209,22415
2029,Jalisco,14,El Grullo,14037,13995,14818,28813
2029,Jalisco,14,El Limón,14054,3411,3406,6817
2029,Jalisco,14,El Salto,14070,103939,104133,208072
2029,Jalisco,14,Encarnación de Díaz,14035,29972,31939,61911
2029,Jalisco,14,Etzatlán,14036,11295,11831,23126
2029,Jalisco,14,Guachinango,14038,2648,2533,5181
2029,Jalisco,14,Guadalajara,14039,809970,866105,1676075
2029,Jalisco,14,Gómez Farías,14079,8031,8584,16615
2029,Jalisco,14,Hostotipaquillo,14040,6414,5567,11981
2029,Jalisco,14,Huejuquilla el Alto,14042,5049,5459,10508
2029,Jalisco,14,Huejúcar,14041,3416,3730,7146
2029,Jalisco,14,Ixtlahuacán de los Membrillos,14044,31592,31973,63565
2029,Jalisco,14,Ixtlahuacán del Río,14045,10913,11516,22429
2029,Jalisco,14,Jalostotitlán,14046,19133,19631,38764
2029,Jalisco,14,Jamay,14047,14348,14271,28619
2029,Jalisco,14,Jesús María,14048,10370,12146,22516
2029,Jalisco,14,Jilotlán de los Dolores,14049,5688,5355,11043
2029,Jalisco,14,Jocotepec,14050,26378,26661,53039
2029,Jalisco,14,Juanacatlán,14051,10351,10246,20597
2029,Jalisco,14,Juchitlán,14052,3292,3456,6748
2029,Jalisco,14,La Barca,14018,36841,38995,75836
2029,Jalisco,14,La Huerta,14043,14667,13971,28638
2029,Jalisco,14,La Manzanilla de la Paz,14057,2176,2315,4491
2029,Jalisco,14,Lagos de Moreno,14053,91720,95317,187037
2029,Jalisco,14,Magdalena,14055,12968,12942,25910
2029,Jalisco,14,Mascota,14058,8631,8863,17494
2029,Jalisco,14,Mazamitla,14059,7786,8407,16193
2029,Jalisco,14,Mexticacán,14060,2828,3319,6147
2029,Jalisco,14,Mezquitic,14061,10607,11241,21848
2029,Jalisco,14,Mixtlán,14062,2131,2101,4232
2029,Jalisco,14,Ocotlán,14063,56025,58001,114026
2029,Jalisco,14,Ojuelos de Jalisco,14064,17666,18502,36168
2029,Jalisco,14,Pihuamo,14065,6909,6818,13727
2029,Jalisco,14,Poncitlán,14066,28784,29437,58221
2029,Jalisco,14,Puerto Vallarta,14067,159726,155746,315472
2029,Jalisco,14,Quitupan,14069,4823,5323,10146
2029,Jalisco,14,San Cristóbal de la Barranca,14071,1798,1774,3572
2029,Jalisco,14,San Diego de Alejandría,14072,4037,4311,8348
2029,Jalisco,14,San Gabriel,14113,9445,9755,19200
2029,Jalisco,14,San Ignacio Cerro Gordo,14125,10481,11087,21568
2029,Jalisco,14,San Juan de los Lagos,14073,39341,39787,79128
2029,Jalisco,14,San Juanito de Escobedo,14007,5550,5425,10975
2029,Jalisco,14,San Julián,14074,8824,9716,18540
2029,Jalisco,14,San Marcos,14075,2249,2189,4438
2029,Jalisco,14,San Martín Hidalgo,14077,16191,16845,33036
2029,Jalisco,14,San Martín de Bolaños,14076,1790,1789,3579
2029,Jalisco,14,San Miguel el Alto,14078,18470,19485,37955
2029,Jalisco,14,San Pedro Tlaquepaque,14098,372582,375701,748283
2029,Jalisco,14,San Sebastián del Oeste,14080,3569,3187,6756
2029,Jalisco,14,Santa María de los Ángeles,14081,1868,2051,3919
2029,Jalisco,14,Santa María del Oro,14056,1247,1232,2479
2029,Jalisco,14,Sayula,14082,20504,21959,42463
2029,Jalisco,14,Tala,14083,45826,46193,92019
2029,Jalisco,14,Talpa de Allende,14084,8892,8722,17614
2029,Jalisco,14,Tamazula de Gordiano,14085,22484,23610,46094
2029,Jalisco,14,Tapalpa,14086,10711,11087,21798
2029,Jalisco,14,Tecalitlán,14087,9618,10021,19639
2029,Jalisco,14,Techaluta de Montenegro,14089,2196,2238,4434
2029,Jalisco,14,Tecolotlán,14088,10243,10226,20469
2029,Jalisco,14,Tenamaxtlán,14090,4150,4183,8333
2029,Jalisco,14,Teocaltiche,14091,23148,25143,48291
2029,Jalisco,14,Teocuitatlán de Corona,14092,6233,6461,12694
2029,Jalisco,14,Tepatitlán de Morelos,14093,79057,81946,161003
2029,Jalisco,14,Tequila,14094,23582,23899,47481
2029,Jalisco,14,Teuchitlán,14095,5644,5800,11444
2029,Jalisco,14,Tizapán el Alto,14096,12122,12610,24732
2029,Jalisco,14,Tlajomulco de Zúñiga,14097,334359,338360,672719
2029,Jalisco,14,Tolimán,14099,5995,6020,12015
2029,Jalisco,14,Tomatlán,14100,21222,19893,41115
2029,Jalisco,14,Tonalá,14101,299044,300267,599311
2029,Jalisco,14,Tonaya,14102,3568,3701,7269
2029,Jalisco,14,Tonila,14103,4679,4697,9376
2029,Jalisco,14,Totatiche,14104,2729,2781,5510
2029,Jalisco,14,Tototlán,14105,13303,13566,26869
2029,Jalisco,14,Tuxcacuesco,14106,2655,2523,5178
2029,Jalisco,14,Tuxcueca,14107,3539,3749,7288
2029,Jalisco,14,Tuxpan,14108,19860,21058,40918
2029,Jalisco,14,Unión de San Antonio,14109,10108,10766,20874
2029,Jalisco,14,Unión de Tula,14110,7838,8300,16138
2029,Jalisco,14,Valle de Guadalupe,14111,4048,4095,8143
2029,Jalisco,14,Valle de Juárez,14112,3201,3388,6589
2029,Jalisco,14,Villa Corona,14114,10425,10687,21112
2029,Jalisco,14,Villa Guerrero,14115,3236,3367,6603
2029,Jalisco,14,Villa Hidalgo,14116,11297,12010,23307
2029,Jalisco,14,Villa Purificación,14068,6764,6261,13025
2029,Jalisco,14,Yahualica de González Gallo,14118,12627,13913,26540
2029,Jalisco,14,Zacoalco de Torres,14119,16588,16843,33431
2029,Jalisco,14,Zapopan,14120,749787,777441,1527228
2029,Jalisco,14,Zapotiltic,14121,16940,17549,34489
2029,Jalisco,14,Zapotitlán de Vadillo,14122,4135,4101,8236
2029,Jalisco,14,Zapotlanejo,14124,38190,38981,77171
2029,Jalisco,14,Zapotlán del Rey,14123,10489,10465,20954
2029,Jalisco,14,Zapotlán el Grande,14023,59815,63264,123079
2029,Michoacán,16,Acuitzio,16001,6118,6590,12708
2029,Michoacán,16,Aguililla,16002,8226,8017,16243
2029,Michoacán,16,Angamacutiro,16004,8317,8970,17287
2029,Michoacán,16,Angangueo,16005,6030,6400,12430
2029,Michoacán,16,Apatzingán,16006,69387,70267,139654
2029,Michoacán,16,Aporo,16007,1741,1857,3598
2029,Michoacán,16,Aquila,16008,13800,13447,27247
2029,Michoacán,16,Ario,16009,19802,20871,40673
2029,Michoacán,16,Arteaga,16010,12079,12152,24231
2029,Michoacán,16,Briseñas,16011,6207,6513,12720
2029,Michoacán,16,Buenavista,16012,26644,25223,51867
2029,Michoacán,16,Carácuaro,16013,5172,5102,10274
2029,Michoacán,16,Charapan,16021,6500,7278,13778
2029,Michoacán,16,Charo,16022,12399,11978,24377
2029,Michoacán,16,Chavinda,16023,5743,6054,11797
2029,Michoacán,16,Cherán,16024,10104,10842,20946
2029,Michoacán,16,Chilchota,16025,20711,22273,42984
2029,Michoacán,16,Chinicuila,16026,2844,2561,5405
2029,Michoacán,16,Chucándiro,16027,2428,2713,5141
2029,Michoacán,16,Churintzio,16028,2905,3303,6208
2029,Michoacán,16,Churumuco,16029,8461,8384,16845
2029,Michoacán,16,Coahuayana,16014,8398,7727,16125
2029,Michoacán,16,Coalcomán de Vázquez Pallares,16015,9746,9779,19525
2029,Michoacán,16,Coeneo,16016,11261,12905,24166
2029,Michoacán,16,Cojumatlán de Régules,16074,5749,5985,11734
2029,Michoacán,16,Contepec,16017,18393,19047,37440
2029,Michoacán,16,Copándaro,16018,4864,5283,10147
2029,Michoacán,16,Cotija,16019,10050,10976,21026
2029,Michoacán,16,Cuitzeo,16020,15905,17411,33316
2029,Michoacán,16,Ecuandureo,16030,6753,7834,14587
2029,Michoacán,16,Epitacio Huerta,16031,9175,9438,18613
2029,Michoacán,16,Erongarícuaro,16032,8270,8859,17129
2029,Michoacán,16,Gabriel Zamora,16033,12596,12571,25167
2029,Michoacán,16,Hidalgo,16034,65694,68865,134559
2029,Michoacán,16,Huandacareo,16036,6357,7303,13660
2029,Michoacán,16,Huaniqueo,16037,4472,5172,9644
2029,Michoacán,16,Huetamo,16038,22346,23520,45866
2029,Michoacán,16,Huiramba,16039,4732,4901,9633
2029,Michoacán,16,Indaparapeo,16040,9107,9438,18545
2029,Michoacán,16,Irimbo,16041,7984,8632,16616
2029,Michoacán,16,Ixtlán,16042,7253,7417,14670
2029,Michoacán,16,Jacona,16043,36670,38680,75350
2029,Michoacán,16,Jiménez,16044,7150,7726,14876
2029,Michoacán,16,Jiquilpan,16045,17907,19680,37587
2029,Michoacán,16,José Sixto Verduzco,16113,14376,15687,30063
2029,Michoacán,16,Jungapeo,16047,11628,11626,23254
2029,Michoacán,16,Juárez,16046,7888,8180,16068
2029,Michoacán,16,La Huacana,16035,18922,19024,37946
2029,Michoacán,16,La Piedad,16069,55873,61037,116910
2029,Michoacán,16,Lagunillas,16048,3087,3170,6257
2029,Michoacán,16,Los Reyes,16075,37592,39420,77012
2029,Michoacán,16,Lázaro Cárdenas,16052,100135,98998,199133
2029,Michoacán,16,Madero,16049,9975,9675,19650
2029,Michoacán,16,Maravatío,16050,46955,49923,96878
2029,Michoacán,16,Marcos Castellanos,16051,7482,7983,15465
2029,Michoacán,16,Morelia,16053,415924,450233,866157
2029,Michoacán,16,Morelos,16054,4061,4703,8764
2029,Michoacán,16,Múgica,16055,24889,25330,50219
2029,Michoacán,16,Nahuatzen,16056,15202,16006,31208
2029,Michoacán,16,Nocupétaro,16057,4501,4509,9010
2029,Michoacán,16,Nuevo Parangaricutiro,16058,10665,10960,21625
2029,Michoacán,16,Nuevo Urecho,16059,4561,4493,9054
2029,Michoacán,16,Numarán,16060,5282,5787,11069
2029,Michoacán,16,Ocampo,16061,12916,12922,25838
2029,Michoacán,16,Pajacuarán,16062,10442,11180,21622
2029,Michoacán,16,Panindícuaro,16063,8616,9569,18185
2029,Michoacán,16,Paracho,16065,19852,21577,41429
2029,Michoacán,16,Parácuaro,16064,14926,14383,29309
2029,Michoacán,16,Penjamillo,16067,9183,10517,19700
2029,Michoacán,16,Peribán,16068,15337,15118,30455
2029,Michoacán,16,Puruándiro,16071,35855,39421,75276
2029,Michoacán,16,Purépero,16070,8438,8836,17274
2029,Michoacán,16,Pátzcuaro,16066,49307,53510,102817
2029,Michoacán,16,Queréndaro,16072,7504,7740,15244
2029,Michoacán,16,Quiroga,16073,14788,16121,30909
2029,Michoacán,16,Sahuayo,16076,41740,43756,85496
2029,Michoacán,16,Salvador Escalante,16079,26229,27485,53714
2029,Michoacán,16,San Lucas,16077,10167,10321,20488
2029,Michoacán,16,Santa Ana Maya,16078,6710,7576,14286
2029,Michoacán,16,Senguio,16080,10214,10760,20974
2029,Michoacán,16,Susupuato,16081,4846,4803,9649
2029,Michoacán,16,Tacámbaro,16082,41609,43170,84779
2029,Michoacán,16,Tancítaro,16083,17176,16598,33774
2029,Michoacán,16,Tangamandapio,16084,15634,16551,32185
2029,Michoacán,16,Tangancícuaro,16085,18453,19553,38006
2029,Michoacán,16,Tanhuato,16086,8509,8873,17382
2029,Michoacán,16,Taretan,16087,8171,8276,16447
2029,Michoacán,16,Tarímbaro,16088,59477,63970,123447
2029,Michoacán,16,Tepalcatepec,16089,13528,13187,26715
2029,Michoacán,16,Tingambato,16090,8065,8495,16560
2029,Michoacán,16,Tingüindín,16091,7887,8519,16406
2029,Michoacán,16,Tiquicheo de Nicolás Romero,16092,7456,7574,15030
2029,Michoacán,16,Tlalpujahua,16093,14987,16621,31608
2029,Michoacán,16,Tlazazalca,16094,3684,3943,7627
2029,Michoacán,16,Tocumbo,16095,6805,6904,13709
2029,Michoacán,16,Tumbiscatío,16096,3779,3608,7387
2029,Michoacán,16,Turicato,16097,16926,17610,34536
2029,Michoacán,16,Tuxpan,16098,14405,15273,29678
2029,Michoacán,16,Tuzantla,16099,8518,8508,17026
2029,Michoacán,16,Tzintzuntzan,16100,7656,8396,16052
2029,Michoacán,16,Tzitzio,16101,4869,4713,9582
2029,Michoacán,16,Uruapan,16102,179276,191367,370643
2029,Michoacán,16,Venustiano Carranza,16103,13736,14357,28093
2029,Michoacán,16,Villamar,16104,9310,9865,19175
2029,Michoacán,16,Vista Hermosa,16105,11381,11821,23202
2029,Michoacán,16,Yurécuaro,16106,17063,17855,34918
2029,Michoacán,16,Zacapu,16107,40752,44044,84796
2029,Michoacán,16,Zamora,16108,106112,112406,218518
2029,Michoacán,16,Zinapécuaro,16110,25513,27415,52928
2029,Michoacán,16,Zináparo,16109,1772,2059,3831
2029,Michoacán,16,Ziracuaretiro,16111,9435,9551,18986
2029,Michoacán,16,Zitácuaro,16112,85607,93649,179256
2029,Michoacán,16,Álvaro Obregón,16003,11854,12508,24362
2029,Morelos,17,Amacuzac,17001,10110,10512,20622
2029,Morelos,17,Atlatlahucan,17002,12897,13195,26092
2029,Morelos,17,Axochiapan,17003,20593,20808,41401
2029,Morelos,17,Ayala,17004,47715,50538,98253
2029,Morelos,17,Coatlán del Río,17005,5821,5921,11742
2029,Morelos,17,Cuautla,17006,109249,116743,225992
2029,Morelos,17,Cuernavaca,17007,206059,233395,439454
2029,Morelos,17,Emiliano Zapata,17008,55924,57270,113194
2029,Morelos,17,Huitzilac,17009,10888,10912,21800
2029,Morelos,17,Jantetelco,17010,9795,10104,19899
2029,Morelos,17,Jiutepec,17011,117508,124588,242096
2029,Morelos,17,Jojutla,17012,32799,34934,67733
2029,Morelos,17,Jonacatepec,17013,8873,9442,18315
2029,Morelos,17,Mazatepec,17014,5748,5934,11682
2029,Morelos,17,Miacatlán,17015,15127,15624,30751
2029,Morelos,17,Ocuituco,17016,10574,10680,21254
2029,Morelos,17,Puente de Ixtla,17017,37541,38821,76362
2029,Morelos,17,Temixco,17018,65077,67454,132531
2029,Morelos,17,Temoac,17033,8974,9333,18307
2029,Morelos,17,Tepalcingo,17019,15623,15993,31616
2029,Morelos,17,Tepoztlán,17020,27555,28259,55814
2029,Morelos,17,Tetecala,17021,4593,4584,9177
2029,Morelos,17,Tetela del Volcán,17022,11582,11990,23572
2029,Morelos,17,Tlalnepantla,17023,4198,4066,8264
2029,Morelos,17,Tlaltizapán de Zapata,17024,29683,30833,60516
2029,Morelos,17,Tlaquiltenango,17025,19736,20184,39920
2029,Morelos,17,Tlayacapan,17026,10237,10321,20558
2029,Morelos,17,Totolapan,17027,6766,6870,13636
2029,Morelos,17,Xochitepec,17028,39822,39362,79184
2029,Morelos,17,Yautepec,17029,57827,60651,118478
2029,Morelos,17,Yecapixtla,17030,29851,30303,60154
2029,Morelos,17,Zacatepec,17031,20817,22472,43289
2029,Morelos,17,Zacualpan,17032,5511,5659,11170
2029,Nayarit,18,Acaponeta,18001,22910,22787,45697
2029,Nayarit,18,Ahuacatlán,18002,9949,9760,19709
2029,Nayarit,18,Amatlán de Cañas,18003,7552,7213,14765
2029,Nayarit,18,Bahía de Banderas,18020,97337,93013,190350
2029,Nayarit,18,Compostela,18004,46170,45693,91863
2029,Nayarit,18,Del Nayar,18009,24178,24077,48255
2029,Nayarit,18,Huajicori,18005,7550,7279,14829
2029,Nayarit,18,Ixtlán del Río,18006,17299,18414,35713
2029,Nayarit,18,Jala,18007,11055,11220,22275
2029,Nayarit,18,La Yesca,18019,8403,7869,16272
2029,Nayarit,18,Rosamorada,18010,21576,20516,42092
2029,Nayarit,18,Ruíz,18011,15311,14808,30119
2029,Nayarit,18,San Blas,18012,28931,25670,54601
2029,Nayarit,18,San Pedro Lagunillas,18013,4827,4665,9492
2029,Nayarit,18,Santa María del Oro,18014,14407,14062,28469
2029,Nayarit,18,Santiago Ixcuintla,18015,61759,59390,121149
2029,Nayarit,18,Tecuala,18016,25252,24423,49675
2029,Nayarit,18,Tepic,18017,240797,253450,494247
2029,Nayarit,18,Tuxpan,18018,19097,19187,38284
2029,Nayarit,18,Xalisco,18008,33448,34594,68042
2029,Nuevo León,19,Abasolo,19001,1584,1575,3159
2029,Nuevo León,19,Agualeguas,19002,1343,1276,2619
2029,Nuevo León,19,Allende,19004,21606,21358,42964
2029,Nuevo León,19,Anáhuac,19005,11294,11373,22667
2029,Nuevo León,19,Apodaca,19006,359221,351812,711033
2029,Nuevo León,19,Aramberri,19007,10546,10210,20756
2029,Nuevo León,19,Bustamante,19008,2525,2517,5042
2029,Nuevo León,19,Cadereyta Jiménez,19009,59575,57067,116642
2029,Nuevo León,19,Cerralvo,19011,4895,4594,9489
2029,Nuevo León,19,China,19013,7163,6802,13965
2029,Nuevo León,19,Ciénega de Flores,19012,27858,26710,54568
2029,Nuevo León,19,Doctor Arroyo,19014,22305,21540,43845
2029,Nuevo León,19,Doctor Coss,19015,1171,1142,2313
2029,Nuevo León,19,Doctor González,19016,1940,1824,3764
2029,Nuevo León,19,El Carmen,19010,25974,25371,51345
2029,Nuevo León,19,Galeana,19017,26383,25588,51971
2029,Nuevo León,19,García,19018,163214,160381,323595
2029,Nuevo León,19,General Bravo,19020,3706,3517,7223
2029,Nuevo León,19,General Escobedo,19021,249447,248150,497597
2029,Nuevo León,19,General Terán,19022,9660,9663,19323
2029,Nuevo León,19,General Treviño,19023,640,667,1307
2029,Nuevo León,19,General Zaragoza,19024,3904,3625,7529
2029,Nuevo León,19,General Zuazua,19025,49775,48683,98458
2029,Nuevo León,19,Guadalupe,19026,403294,396896,800190
2029,Nuevo León,19,Hidalgo,19047,8828,8756,17584
2029,Nuevo León,19,Higueras,19028,998,936,1934
2029,Nuevo León,19,Hualahuises,19029,4475,4497,8972
2029,Nuevo León,19,Iturbide,19030,2391,2220,4611
2029,Nuevo León,19,Juárez,19031,216111,209204,425315
2029,Nuevo León,19,Lampazos de Naranjo,19032,3388,3285,6673
2029,Nuevo León,19,Linares,19033,50118,50067,100185
2029,Nuevo León,19,Los Aldamas,19003,1034,1017,2051
2029,Nuevo León,19,Los Herreras,19027,1263,1285,2548
2029,Nuevo León,19,Los Ramones,19042,2857,2800,5657
2029,Nuevo León,19,Marín,19034,3503,3289,6792
2029,Nuevo León,19,Melchor Ocampo,19035,678,651,1329
2029,Nuevo León,19,Mier y Noriega,19036,4406,4278,8684
2029,Nuevo León,19,Mina,19037,3369,3185,6554
2029,Nuevo León,19,Montemorelos,19038,38609,38405,77014
2029,Nuevo León,19,Monterrey,19039,637175,669704,1306879
2029,Nuevo León,19,Parás,19040,663,627,1290
2029,Nuevo León,19,Pesquería,19041,61563,60838,122401
2029,Nuevo León,19,Rayones,19043,1848,1703,3551
2029,Nuevo León,19,Sabinas Hidalgo,19044,21826,22702,44528
2029,Nuevo León,19,Salinas Victoria,19045,34474,32580,67054
2029,Nuevo León,19,San Nicolás de los Garza,19046,263944,275813,539757
2029,Nuevo León,19,San Pedro Garza García,19019,74731,83500,158231
2029,Nuevo León,19,Santa Catarina,19048,177378,175333,352711
2029,Nuevo León,19,Santiago,19049,26773,26522,53295
2029,Nuevo León,19,Vallecillo,19050,1262,1095,2357
2029,Nuevo León,19,Villaldama,19051,2700,2695,5395
2029,Oaxaca,20,Abejones,20001,461,615,1076
2029,Oaxaca,20,Acatlán de Pérez Figueroa,20002,24582,25526,50108
2029,Oaxaca,20,Asunción Cacalotepec,20003,1124,1222,2346
2029,Oaxaca,20,Asunción Cuyotepeji,20004,510,580,1090
2029,Oaxaca,20,Asunción Ixtaltepec,20005,8493,8638,17131
2029,Oaxaca,20,Asunción Nochixtlán,20006,9527,10794,20321
2029,Oaxaca,20,Asunción Ocotlán,20007,1228,1516,2744
2029,Oaxaca,20,Asunción Tlacolulita,20008,432,462,894
2029,Oaxaca,20,Ayoquezco de Aldama,20398,2293,2546,4839
2029,Oaxaca,20,Ayotzintepec,20009,3817,3849,7666
2029,Oaxaca,20,Calihualá,20011,611,652,1263
2029,Oaxaca,20,Candelaria Loxicha,20012,5451,5657,11108
2029,Oaxaca,20,Capulálpam de Méndez,20247,777,954,1731
2029,Oaxaca,20,Chahuites,20025,6263,6329,12592
2029,Oaxaca,20,Chalcatongo de Hidalgo,20026,4681,5361,10042
2029,Oaxaca,20,Chiquihuitlán de Benito Juárez,20027,1187,1453,2640
2029,Oaxaca,20,Ciudad Ixtepec,20014,15381,16839,32220
2029,Oaxaca,20,Ciénega de Zimatlán,20013,1614,1790,3404
2029,Oaxaca,20,Coatecas Altas,20015,2268,2610,4878
2029,Oaxaca,20,Coicoyán de las Flores,20016,4830,5494,10324
2029,Oaxaca,20,Concepción Buenavista,20018,435,471,906
2029,Oaxaca,20,Concepción Pápalo,20019,1650,1664,3314
2029,Oaxaca,20,Constancia del Rosario,20020,1917,2194,4111
2029,Oaxaca,20,Cosolapa,20021,8184,8841,17025
2029,Oaxaca,20,Cosoltepec,20022,409,490,899
2029,Oaxaca,20,Cuilápam de Guerrero,20023,11426,12098,23524
2029,Oaxaca,20,Cuyamecalco Villa de Zaragoza,20024,2039,2026,4065
2029,Oaxaca,20,El Barrio de la Soledad,20010,7605,8237,15842
2029,Oaxaca,20,El Espinal,20030,4767,5021,9788
2029,Oaxaca,20,Eloxochitlán de Flores Magón,20029,2173,2463,4636
2029,Oaxaca,20,Fresnillo de Trujano,20032,556,608,1164
2029,Oaxaca,20,Guadalupe Etla,20033,1399,1570,2969
2029,Oaxaca,20,Guadalupe de Ramírez,20034,707,725,1432
2029,Oaxaca,20,Guelatao de Juárez,20035,299,298,597
2029,Oaxaca,20,Guevea de Humboldt,20036,2796,2894,5690
2029,Oaxaca,20,Heroica Ciudad de Ejutla de Crespo,20028,10987,12354,23341
2029,Oaxaca,20,Heroica Ciudad de Huajuapan de León,20039,39463,44269,83732
2029,Oaxaca,20,Heroica Ciudad de Juchitán de Zaragoza,20043,52105,55253,107358
2029,Oaxaca,20,Heroica Ciudad de Tlaxiaco,20397,20410,23309,43719
2029,Oaxaca,20,Huautepec,20040,3064,3557,6621
2029,Oaxaca,20,Huautla de Jiménez,20041,15582,18156,33738
2029,Oaxaca,20,Ixpantepec Nieves,20065,598,757,1355
2029,Oaxaca,20,Ixtlán de Juárez,20042,4345,4505,8850
2029,Oaxaca,20,La Compañía,20017,1747,1925,3672
2029,Oaxaca,20,La Pe,20069,1353,1452,2805
2029,Oaxaca,20,La Reforma,20076,1657,1801,3458
2029,Oaxaca,20,La Trinidad Vista Hermosa,20556,133,158,291
2029,Oaxaca,20,Loma Bonita,20044,22561,24733,47294
2029,Oaxaca,20,Magdalena Apasco,20045,4553,5070,9623
2029,Oaxaca,20,Magdalena Jaltepec,20046,1681,1963,3644
2029,Oaxaca,20,Magdalena Mixtepec,20048,674,709,1383
2029,Oaxaca,20,Magdalena Ocotlán,20049,607,656,1263
2029,Oaxaca,20,Magdalena Peñasco,20050,1750,2024,3774
2029,Oaxaca,20,Magdalena Teitipac,20051,2361,2520,4881
2029,Oaxaca,20,Magdalena Tequisistlán,20052,3344,3489,6833
2029,Oaxaca,20,Magdalena Tlacotepec,20053,680,741,1421
2029,Oaxaca,20,Magdalena Yodocono de Porfirio Díaz,20562,820,877,1697
2029,Oaxaca,20,Magdalena Zahuatlán,20054,220,246,466
2029,Oaxaca,20,Mariscala de Juárez,20055,1899,2063,3962
2029,Oaxaca,20,Matías Romero Avendaño,20057,20731,22128,42859
2029,Oaxaca,20,Mazatlán Villa de Flores,20058,7001,7157,14158
2029,Oaxaca,20,Mesones Hidalgo,20037,2187,2559,4746
2029,Oaxaca,20,Miahuatlán de Porfirio Díaz,20059,22448,24812,47260
2029,Oaxaca,20,Mixistlán de la Reforma,20060,1339,1490,2829
2029,Oaxaca,20,Monjas,20061,1382,1621,3003
2029,Oaxaca,20,Mártires de Tacubaya,20056,759,825,1584
2029,Oaxaca,20,Natividad,20062,339,396,735
2029,Oaxaca,20,Nazareno Etla,20063,2131,2342,4473
2029,Oaxaca,20,Nejapa de Madero,20064,4073,4218,8291
2029,Oaxaca,20,Nuevo Zoquiápam,20504,852,913,1765
2029,Oaxaca,20,Oaxaca de Juárez,20067,125485,145869,271354
2029,Oaxaca,20,Ocotlán de Morelos,20068,11442,12491,23933
2029,Oaxaca,20,Pinotepa de Don Luis,20070,3691,3818,7509
2029,Oaxaca,20,Pluma Hidalgo,20071,1578,1624,3202
2029,Oaxaca,20,Putla Villa de Guerrero,20073,16908,19089,35997
2029,Oaxaca,20,Reforma de Pineda,20075,1531,1640,3171
2029,Oaxaca,20,Reyes Etla,20077,2079,2211,4290
2029,Oaxaca,20,Rojas de Cuauhtémoc,20078,589,667,1256
2029,Oaxaca,20,Salina Cruz,20079,46582,50585,97167
2029,Oaxaca,20,San Agustín Amatengo,20080,784,895,1679
2029,Oaxaca,20,San Agustín Atenango,20081,917,1065,1982
2029,Oaxaca,20,San Agustín Chayuco,20082,2048,2211,4259
2029,Oaxaca,20,San Agustín Etla,20084,2153,2377,4530
2029,Oaxaca,20,San Agustín Loxicha,20085,12871,13384,26255
2029,Oaxaca,20,San Agustín Tlacotepec,20086,449,610,1059
2029,Oaxaca,20,San Agustín Yatareni,20087,2237,2537,4774
2029,Oaxaca,20,San Agustín de las Juntas,20083,5040,5270,10310
2029,Oaxaca,20,San Andrés Cabecera Nueva,20088,1502,1543,3045
2029,Oaxaca,20,San Andrés Dinicuiti,20089,1134,1197,2331
2029,Oaxaca,20,San Andrés Huaxpaltepec,20090,3219,3407,6626
2029,Oaxaca,20,San Andrés Huayápam,20091,2774,3070,5844
2029,Oaxaca,20,San Andrés Ixtlahuaca,20092,845,957,1802
2029,Oaxaca,20,San Andrés Lagunas,20093,260,301,561
2029,Oaxaca,20,San Andrés Nuxiño,20094,914,1006,1920
2029,Oaxaca,20,San Andrés Paxtlán,20095,2305,2299,4604
2029,Oaxaca,20,San Andrés Sinaxtla,20096,384,454,838
2029,Oaxaca,20,San Andrés Solaga,20097,946,1013,1959
2029,Oaxaca,20,San Andrés Teotilálpam,20098,2277,2499,4776
2029,Oaxaca,20,San Andrés Tepetlapa,20099,259,294,553
2029,Oaxaca,20,San Andrés Yaá,20100,247,290,537
2029,Oaxaca,20,San Andrés Zabache,20101,359,449,808
2029,Oaxaca,20,San Andrés Zautla,20102,2427,2605,5032
2029,Oaxaca,20,San Antonino Castillo Velasco,20103,3169,3505,6674
2029,Oaxaca,20,San Antonino Monte Verde,20105,3533,4112,7645
2029,Oaxaca,20,San Antonino el Alto,20104,1429,1462,2891
2029,Oaxaca,20,San Antonio Acutla,20106,128,164,292
2029,Oaxaca,20,San Antonio Huitepec,20108,2204,2627,4831
2029,Oaxaca,20,San Antonio Nanahuatípam,20109,676,685,1361
2029,Oaxaca,20,San Antonio Sinicahua,20110,772,906,1678
2029,Oaxaca,20,San Antonio Tepetlapa,20111,2214,2373,4587
2029,Oaxaca,20,San Antonio de la Cal,20107,12265,13720,25985
2029,Oaxaca,20,San Baltazar Chichicápam,20112,1359,1536,2895
2029,Oaxaca,20,San Baltazar Loxicha,20113,1559,1622,3181
2029,Oaxaca,20,San Baltazar Yatzachi el Bajo,20114,359,409,768
2029,Oaxaca,20,San Bartolo Coyotepec,20115,4954,5557,10511
2029,Oaxaca,20,San Bartolo Soyaltepec,20121,341,420,761
2029,Oaxaca,20,San Bartolo Yautepec,20122,374,376,750
2029,Oaxaca,20,San Bartolomé Ayautla,20116,2316,2493,4809
2029,Oaxaca,20,San Bartolomé Loxicha,20117,1216,1272,2488
2029,Oaxaca,20,San Bartolomé Quialana,20118,1125,1570,2695
2029,Oaxaca,20,San Bartolomé Yucuañe,20119,181,260,441
2029,Oaxaca,20,San Bartolomé Zoogocho,20120,160,206,366
2029,Oaxaca,20,San Bernardo Mixtepec,20123,1435,1528,2963
2029,Oaxaca,20,San Blas Atempa,20124,9705,9731,19436
2029,Oaxaca,20,San Carlos Yautepec,20125,6653,6512,13165
2029,Oaxaca,20,San Cristóbal Amatlán,20126,2594,2971,5565
2029,Oaxaca,20,San Cristóbal Amoltepec,20127,543,650,1193
2029,Oaxaca,20,San Cristóbal Lachirioag,20128,700,752,1452
2029,Oaxaca,20,San Cristóbal Suchixtlahuaca,20129,196,212,408
2029,Oaxaca,20,San Dionisio Ocotepec,20131,5484,6112,11596
2029,Oaxaca,20,San Dionisio Ocotlán,20132,635,649,1284
2029,Oaxaca,20,San Dionisio del Mar,20130,2850,2732,5582
2029,Oaxaca,20,San Esteban Atatlahuca,20133,1989,2109,4098
2029,Oaxaca,20,San Felipe Jalapa de Díaz,20134,14111,15134,29245
2029,Oaxaca,20,San Felipe Tejalápam,20135,4083,4452,8535
2029,Oaxaca,20,San Felipe Usila,20136,5985,6496,12481
2029,Oaxaca,20,San Francisco Cahuacuá,20137,1796,1838,3634
2029,Oaxaca,20,San Francisco Cajonos,20138,250,277,527
2029,Oaxaca,20,San Francisco Chapulapa,20139,1063,1146,2209
2029,Oaxaca,20,San Francisco Chindúa,20140,434,461,895
2029,Oaxaca,20,San Francisco Huehuetlán,20142,549,688,1237
2029,Oaxaca,20,San Francisco Ixhuatán,20143,4921,4947,9868
2029,Oaxaca,20,San Francisco Jaltepetongo,20144,554,592,1146
2029,Oaxaca,20,San Francisco Lachigoló,20145,2319,2400,4719
2029,Oaxaca,20,San Francisco Logueche,20146,1416,1653,3069
2029,Oaxaca,20,San Francisco Nuxaño,20147,217,207,424
2029,Oaxaca,20,San Francisco Ozolotepec,20148,979,1034,2013
2029,Oaxaca,20,San Francisco Sola,20149,870,964,1834
2029,Oaxaca,20,San Francisco Telixtlahuaca,20150,6664,7237,13901
2029,Oaxaca,20,San Francisco Teopan,20151,195,178,373
2029,Oaxaca,20,San Francisco Tlapancingo,20152,1070,1349,2419
2029,Oaxaca,20,San Francisco del Mar,20141,4220,4077,8297
2029,Oaxaca,20,San Gabriel Mixtepec,20153,2532,2681,5213
2029,Oaxaca,20,San Ildefonso Amatlán,20154,1256,1433,2689
2029,Oaxaca,20,San Ildefonso Sola,20155,523,514,1037
2029,Oaxaca,20,San Ildefonso Villa Alta,20156,1830,1949,3779
2029,Oaxaca,20,San Jacinto Amilpas,20157,8798,9752,18550
2029,Oaxaca,20,San Jacinto Tlacotepec,20158,1125,1177,2302
2029,Oaxaca,20,San Jerónimo Coatlán,20159,2693,2854,5547
2029,Oaxaca,20,San Jerónimo Silacayoapilla,20160,754,774,1528
2029,Oaxaca,20,San Jerónimo Sosola,20161,1377,1564,2941
2029,Oaxaca,20,San Jerónimo Taviche,20162,973,1048,2021
2029,Oaxaca,20,San Jerónimo Tecóatl,20163,829,944,1773
2029,Oaxaca,20,San Jerónimo Tlacochahuaya,20550,2877,3229,6106
2029,Oaxaca,20,San Jorge Nuchita,20164,1413,1713,3126
2029,Oaxaca,20,San José Ayuquila,20165,781,897,1678
2029,Oaxaca,20,San José Chiltepec,20166,6443,6731,13174
2029,Oaxaca,20,San José Estancia Grande,20168,562,576,1138
2029,Oaxaca,20,San José Independencia,20169,1927,2066,3993
2029,Oaxaca,20,San José Lachiguiri,20170,1669,2076,3745
2029,Oaxaca,20,San José Tenango,20171,9414,10270,19684
2029,Oaxaca,20,San José del Peñasco,20167,1108,1161,2269
2029,Oaxaca,20,San José del Progreso,20072,3520,3729,7249
2029,Oaxaca,20,San Juan Achiutla,20172,235,253,488
2029,Oaxaca,20,San Juan Atepec,20173,804,898,1702
2029,Oaxaca,20,San Juan Bautista Atatlahuca,20175,853,902,1755
2029,Oaxaca,20,San Juan Bautista Coixtlahuaca,20176,1418,1587,3005
2029,Oaxaca,20,San Juan Bautista Cuicatlán,20177,5326,5678,11004
2029,Oaxaca,20,San Juan Bautista Guelache,20178,3866,4340,8206
2029,Oaxaca,20,San Juan Bautista Jayacatlán,20179,843,831,1674
2029,Oaxaca,20,San Juan Bautista Lo de Soto,20180,1419,1446,2865
2029,Oaxaca,20,San Juan Bautista Suchitepec,20181,239,278,517
2029,Oaxaca,20,San Juan Bautista Tlachichilco,20183,700,806,1506
2029,Oaxaca,20,San Juan Bautista Tlacoatzintepec,20182,1104,1211,2315
2029,Oaxaca,20,San Juan Bautista Tuxtepec,20184,84788,91846,176634
2029,Oaxaca,20,San Juan Bautista Valle Nacional,20559,11887,12669,24556
2029,Oaxaca,20,San Juan Cacahuatepec,20185,4701,4961,9662
2029,Oaxaca,20,San Juan Chicomezúchil,20191,177,209,386
2029,Oaxaca,20,San Juan Chilateca,20192,791,923,1714
2029,Oaxaca,20,San Juan Cieneguilla,20186,317,351,668
2029,Oaxaca,20,San Juan Coatzóspam,20187,1146,1138,2284
2029,Oaxaca,20,San Juan Colorado,20188,5144,5495,10639
2029,Oaxaca,20,San Juan Comaltepec,20189,1473,1528,3001
2029,Oaxaca,20,San Juan Cotzocón,20190,12530,13162,25692
2029,Oaxaca,20,San Juan Diuxi,20195,611,646,1257
2029,Oaxaca,20,San Juan Evangelista Analco,20196,232,258,490
2029,Oaxaca,20,San Juan Guelavía,20197,1768,1901,3669
2029,Oaxaca,20,San Juan Guichicovi,20198,15420,17322,32742
2029,Oaxaca,20,San Juan Ihualtepec,20199,333,383,716
2029,Oaxaca,20,San Juan Juquila Mixes,20200,1981,2221,4202
2029,Oaxaca,20,San Juan Juquila Vijanos,20201,998,1101,2099
2029,Oaxaca,20,San Juan Lachao,20202,2453,2613,5066
2029,Oaxaca,20,San Juan Lachigalla,20203,1679,1835,3514
2029,Oaxaca,20,San Juan Lajarcia,20204,335,407,742
2029,Oaxaca,20,San Juan Lalana,20205,8828,9257,18085
2029,Oaxaca,20,San Juan Mazatlán,20207,9898,9899,19797
2029,Oaxaca,20,San Juan Mixtepec Distrito 08,20208,3686,4242,7928
2029,Oaxaca,20,San Juan Mixtepec Distrito 26,20209,309,454,763
2029,Oaxaca,20,San Juan Ozolotepec,20211,1413,1409,2822
2029,Oaxaca,20,San Juan Petlapa,20212,1490,1592,3082
2029,Oaxaca,20,San Juan Quiahije,20213,1928,2203,4131
2029,Oaxaca,20,San Juan Quiotepec,20214,1115,1174,2289
2029,Oaxaca,20,San Juan Sayultepec,20215,414,487,901
2029,Oaxaca,20,San Juan Tabaá,20216,699,772,1471
2029,Oaxaca,20,San Juan Tamazola,20217,1578,1676,3254
2029,Oaxaca,20,San Juan Teita,20218,340,361,701
2029,Oaxaca,20,San Juan Teitipac,20219,1415,1554,2969
2029,Oaxaca,20,San Juan Tepeuxila,20220,1499,1423,2922
2029,Oaxaca,20,San Juan Teposcolula,20221,675,722,1397
2029,Oaxaca,20,San Juan Yaeé,20222,783,891,1674
2029,Oaxaca,20,San Juan Yatzona,20223,224,285,509
2029,Oaxaca,20,San Juan Yucuita,20224,314,365,679
2029,Oaxaca,20,San Juan de los Cués,20206,1319,1337,2656
2029,Oaxaca,20,San Juan del Estado,20193,1412,1546,2958
2029,Oaxaca,20,San Juan del Río,20194,668,794,1462
2029,Oaxaca,20,San Juan Ñumí,20210,3000,3428,6428
2029,Oaxaca,20,San Lorenzo,20225,3148,3396,6544
2029,Oaxaca,20,San Lorenzo Albarradas,20226,1562,1511,3073
2029,Oaxaca,20,San Lorenzo Cacaotepec,20227,8251,8963,17214
2029,Oaxaca,20,San Lorenzo Cuaunecuiltitla,20228,452,421,873
2029,Oaxaca,20,San Lorenzo Texmelúcan,20229,3922,4590,8512
2029,Oaxaca,20,San Lorenzo Victoria,20230,543,582,1125
2029,Oaxaca,20,San Lucas Camotlán,20231,1548,1648,3196
2029,Oaxaca,20,San Lucas Ojitlán,20232,10426,11111,21537
2029,Oaxaca,20,San Lucas Quiaviní,20233,819,1144,1963
2029,Oaxaca,20,San Lucas Zoquiápam,20234,3877,4133,8010
2029,Oaxaca,20,San Luis Amatlán,20235,1836,2191,4027
2029,Oaxaca,20,San Marcial Ozolotepec,20236,780,843,1623
2029,Oaxaca,20,San Marcos Arteaga,20237,698,800,1498
2029,Oaxaca,20,San Martín Huamelúlpam,20239,541,639,1180
2029,Oaxaca,20,San Martín Itunyoso,20240,1027,1308,2335
2029,Oaxaca,20,San Martín Lachilá,20241,547,672,1219
2029,Oaxaca,20,San Martín Peras,20242,5957,6443,12400
2029,Oaxaca,20,San Martín Tilcajete,20243,914,1088,2002
2029,Oaxaca,20,San Martín Toxpalan,20244,1998,2106,4104
2029,Oaxaca,20,San Martín Zacatepec,20245,697,738,1435
2029,Oaxaca,20,San Martín de los Cansecos,20238,466,480,946
2029,Oaxaca,20,San Mateo Cajonos,20246,317,388,705
2029,Oaxaca,20,San Mateo Etlatongo,20250,607,653,1260
2029,Oaxaca,20,San Mateo Nejápam,20251,582,650,1232
2029,Oaxaca,20,San Mateo Peñasco,20252,1080,1238,2318
2029,Oaxaca,20,San Mateo Piñas,20253,1120,1114,2234
2029,Oaxaca,20,San Mateo Río Hondo,20254,1693,1782,3475
2029,Oaxaca,20,San Mateo Sindihui,20255,1047,1167,2214
2029,Oaxaca,20,San Mateo Tlapiltepec,20256,117,135,252
2029,Oaxaca,20,San Mateo Yoloxochitlán,20249,1842,2027,3869
2029,Oaxaca,20,San Mateo Yucutindoo,20566,1625,1668,3293
2029,Oaxaca,20,San Mateo del Mar,20248,8213,7901,16114
2029,Oaxaca,20,San Melchor Betaza,20257,538,627,1165
2029,Oaxaca,20,San Miguel Achiutla,20258,413,462,875
2029,Oaxaca,20,San Miguel Ahuehuetitlán,20259,1232,1366,2598
2029,Oaxaca,20,San Miguel Aloápam,20260,1128,1269,2397
2029,Oaxaca,20,San Miguel Amatitlán,20261,3804,4276,8080
2029,Oaxaca,20,San Miguel Amatlán,20262,534,564,1098
2029,Oaxaca,20,San Miguel Chicahua,20264,1059,1310,2369
2029,Oaxaca,20,San Miguel Chimalapa,20265,3817,3630,7447
2029,Oaxaca,20,San Miguel Coatlán,20263,1611,1862,3473
2029,Oaxaca,20,San Miguel Ejutla,20268,503,588,1091
2029,Oaxaca,20,San Miguel Huautla,20270,585,679,1264
2029,Oaxaca,20,San Miguel Mixtepec,20271,1660,1713,3373
2029,Oaxaca,20,San Miguel Panixtlahuaca,20272,3009,3713,6722
2029,Oaxaca,20,San Miguel Peras,20273,1730,1846,3576
2029,Oaxaca,20,San Miguel Piedras,20274,678,736,1414
2029,Oaxaca,20,San Miguel Quetzaltepec,20275,4428,4363,8791
2029,Oaxaca,20,San Miguel Santa Flor,20276,407,403,810
2029,Oaxaca,20,San Miguel Soyaltepec,20278,20328,21624,41952
2029,Oaxaca,20,San Miguel Suchixtepec,20279,1409,1544,2953
2029,Oaxaca,20,San Miguel Tecomatlán,20281,183,168,351
2029,Oaxaca,20,San Miguel Tenango,20282,411,396,807
2029,Oaxaca,20,San Miguel Tequixtepec,20283,547,596,1143
2029,Oaxaca,20,San Miguel Tilquiápam,20284,1479,1866,3345
2029,Oaxaca,20,San Miguel Tlacamama,20285,1934,1989,3923
2029,Oaxaca,20,San Miguel Tlacotepec,20286,1605,1861,3466
2029,Oaxaca,20,San Miguel Tulancingo,20287,145,231,376
2029,Oaxaca,20,San Miguel Yotao,20288,302,341,643
2029,Oaxaca,20,San Miguel del Puerto,20266,4446,4494,8940
2029,Oaxaca,20,San Miguel del Río,20267,150,152,302
2029,Oaxaca,20,San Miguel el Grande,20269,2201,2534,4735
2029,Oaxaca,20,San Nicolás,20289,588,714,1302
2029,Oaxaca,20,San Nicolás Hidalgo,20290,516,593,1109
2029,Oaxaca,20,San Pablo Coatlán,20291,2214,2322,4536
2029,Oaxaca,20,San Pablo Cuatro Venados,20292,706,796,1502
2029,Oaxaca,20,San Pablo Etla,20293,9268,10281,19549
2029,Oaxaca,20,San Pablo Huitzo,20294,3683,4183,7866
2029,Oaxaca,20,San Pablo Huixtepec,20295,4929,5430,10359
2029,Oaxaca,20,San Pablo Macuiltianguis,20296,513,533,1046
2029,Oaxaca,20,San Pablo Tijaltepec,20297,1165,1381,2546
2029,Oaxaca,20,San Pablo Villa de Mitla,20298,6639,7277,13916
2029,Oaxaca,20,San Pablo Yaganiza,20299,550,627,1177
2029,Oaxaca,20,San Pedro Amuzgos,20300,3387,3858,7245
2029,Oaxaca,20,San Pedro Apóstol,20301,797,942,1739
2029,Oaxaca,20,San Pedro Atoyac,20302,2216,2494,4710
2029,Oaxaca,20,San Pedro Cajonos,20303,554,697,1251
2029,Oaxaca,20,San Pedro Comitancillo,20305,2273,2486,4759
2029,Oaxaca,20,San Pedro Coxcaltepec Cántaros,20304,406,456,862
2029,Oaxaca,20,San Pedro Huamelula,20307,5369,5389,10758
2029,Oaxaca,20,San Pedro Huilotepec,20308,1702,1714,3416
2029,Oaxaca,20,San Pedro Ixcatlán,20309,5941,6286,12227
2029,Oaxaca,20,San Pedro Ixtlahuaca,20310,4632,4900,9532
2029,Oaxaca,20,San Pedro Jaltepetongo,20311,301,342,643
2029,Oaxaca,20,San Pedro Jicayán,20312,6245,6857,13102
2029,Oaxaca,20,San Pedro Jocotipac,20313,411,491,902
2029,Oaxaca,20,San Pedro Juchatengo,20314,837,919,1756
2029,Oaxaca,20,San Pedro Mixtepec Distrito 22,20318,25541,26747,52288
2029,Oaxaca,20,San Pedro Mixtepec Distrito 26,20319,575,621,1196
2029,Oaxaca,20,San Pedro Molinos,20320,355,401,756
2029,Oaxaca,20,San Pedro Mártir,20315,818,1014,1832
2029,Oaxaca,20,San Pedro Mártir Quiechapa,20316,366,412,778
2029,Oaxaca,20,San Pedro Mártir Yucuxaco,20317,644,751,1395
2029,Oaxaca,20,San Pedro Nopala,20321,384,428,812
2029,Oaxaca,20,San Pedro Ocopetatillo,20322,415,489,904
2029,Oaxaca,20,San Pedro Ocotepec,20323,1093,1165,2258
2029,Oaxaca,20,San Pedro Pochutla,20324,24858,25600,50458
2029,Oaxaca,20,San Pedro Quiatoni,20325,5679,6009,11688
2029,Oaxaca,20,San Pedro Sochiápam,20326,2632,2725,5357
2029,Oaxaca,20,San Pedro Tapanatepec,20327,7958,8095,16053
2029,Oaxaca,20,San Pedro Taviche,20328,634,639,1273
2029,Oaxaca,20,San Pedro Teozacoalco,20329,661,707,1368
2029,Oaxaca,20,San Pedro Teutila,20330,2249,2329,4578
2029,Oaxaca,20,San Pedro Tidaá,20331,477,561,1038
2029,Oaxaca,20,San Pedro Topiltepec,20332,198,227,425
2029,Oaxaca,20,San Pedro Totolápam,20333,1403,1561,2964
2029,Oaxaca,20,San Pedro Yaneri,20335,480,514,994
2029,Oaxaca,20,San Pedro Yucunama,20341,112,142,254
2029,Oaxaca,20,San Pedro Yólox,20336,895,968,1863
2029,Oaxaca,20,San Pedro el Alto,20306,1858,1948,3806
2029,Oaxaca,20,San Pedro y San Pablo Ayutla,20337,2609,3129,5738
2029,Oaxaca,20,San Pedro y San Pablo Teposcolula,20339,2157,2412,4569
2029,Oaxaca,20,San Pedro y San Pablo Tequixtepec,20340,908,1131,2039
2029,Oaxaca,20,San Raymundo Jalpan,20342,1757,2116,3873
2029,Oaxaca,20,San Sebastián Abasolo,20343,1041,1126,2167
2029,Oaxaca,20,San Sebastián Coatlán,20344,1402,1504,2906
2029,Oaxaca,20,San Sebastián Ixcapa,20345,2220,2263,4483
2029,Oaxaca,20,San Sebastián Nicananduta,20346,718,917,1635
2029,Oaxaca,20,San Sebastián Río Hondo,20347,1931,1958,3889
2029,Oaxaca,20,San Sebastián Tecomaxtlahuaca,20348,4284,4816,9100
2029,Oaxaca,20,San Sebastián Teitipac,20349,1006,1186,2192
2029,Oaxaca,20,San Sebastián Tutla,20350,8960,10498,19458
2029,Oaxaca,20,San Simón Almolongas,20351,1444,1643,3087
2029,Oaxaca,20,San Simón Zahuatlán,20352,2146,2176,4322
2029,Oaxaca,20,San Vicente Coatlán,20534,1922,2251,4173
2029,Oaxaca,20,San Vicente Lachixío,20535,1366,1573,2939
2029,Oaxaca,20,San Vicente Nuñú,20536,230,269,499
2029,Oaxaca,20,Santa Ana,20353,1147,1206,2353
2029,Oaxaca,20,Santa Ana Ateixtlahuaca,20354,280,287,567
2029,Oaxaca,20,Santa Ana Cuauhtémoc,20355,394,412,806
2029,Oaxaca,20,Santa Ana Tavela,20357,449,495,944
2029,Oaxaca,20,Santa Ana Tlapacoyan,20358,1114,1227,2341
2029,Oaxaca,20,Santa Ana Yareni,20359,486,542,1028
2029,Oaxaca,20,Santa Ana Zegache,20360,1961,2215,4176
2029,Oaxaca,20,Santa Ana del Valle,20356,1142,1190,2332
2029,Oaxaca,20,Santa Catalina Quierí,20361,447,565,1012
2029,Oaxaca,20,Santa Catarina Cuixtla,20362,749,939,1688
2029,Oaxaca,20,Santa Catarina Ixtepeji,20363,1395,1491,2886
2029,Oaxaca,20,Santa Catarina Juquila,20364,8050,8605,16655
2029,Oaxaca,20,Santa Catarina Lachatao,20365,606,656,1262
2029,Oaxaca,20,Santa Catarina Loxicha,20366,2019,2101,4120
2029,Oaxaca,20,Santa Catarina Mechoacán,20367,2378,2444,4822
2029,Oaxaca,20,Santa Catarina Minas,20368,1049,1083,2132
2029,Oaxaca,20,Santa Catarina Quiané,20369,1052,1094,2146
2029,Oaxaca,20,Santa Catarina Quioquitani,20074,283,306,589
2029,Oaxaca,20,Santa Catarina Tayata,20370,335,403,738
2029,Oaxaca,20,Santa Catarina Ticuá,20371,529,667,1196
2029,Oaxaca,20,Santa Catarina Yosonotú,20372,858,1057,1915
2029,Oaxaca,20,Santa Catarina Zapoquila,20373,210,231,441
2029,Oaxaca,20,Santa Cruz Acatepec,20374,794,876,1670
2029,Oaxaca,20,Santa Cruz Amilpas,20375,6473,7535,14008
2029,Oaxaca,20,Santa Cruz Itundujia,20377,5932,6462,12394
2029,Oaxaca,20,Santa Cruz Mixtepec,20378,1857,2014,3871
2029,Oaxaca,20,Santa Cruz Nundaco,20379,1457,1730,3187
2029,Oaxaca,20,Santa Cruz Papalutla,20380,1155,1216,2371
2029,Oaxaca,20,Santa Cruz Tacache de Mina,20381,1408,1558,2966
2029,Oaxaca,20,Santa Cruz Tacahua,20382,578,658,1236
2029,Oaxaca,20,Santa Cruz Tayata,20383,325,338,663
2029,Oaxaca,20,Santa Cruz Xitla,20384,2474,2689,5163
2029,Oaxaca,20,Santa Cruz Xoxocotlán,20385,47628,53663,101291
2029,Oaxaca,20,Santa Cruz Zenzontepec,20386,9348,9749,19097
2029,Oaxaca,20,Santa Cruz de Bravo,20376,199,220,419
2029,Oaxaca,20,Santa Gertrudis,20387,1555,1667,3222
2029,Oaxaca,20,Santa Inés Yatzeche,20389,448,588,1036
2029,Oaxaca,20,Santa Inés de Zaragoza,20569,862,986,1848
2029,Oaxaca,20,Santa Inés del Monte,20388,1239,1290,2529
2029,Oaxaca,20,Santa Lucía Miahuatlán,20391,1746,1845,3591
2029,Oaxaca,20,Santa Lucía Monteverde,20392,3359,3708,7067
2029,Oaxaca,20,Santa Lucía Ocotlán,20393,1907,2238,4145
2029,Oaxaca,20,Santa Lucía del Camino,20390,25588,28108,53696
2029,Oaxaca,20,Santa Magdalena Jicotlán,20047,47,63,110
2029,Oaxaca,20,Santa María Alotepec,20394,1514,1557,3071
2029,Oaxaca,20,Santa María Apazco,20395,881,1132,2013
2029,Oaxaca,20,Santa María Atzompa,20399,18177,19551,37728
2029,Oaxaca,20,Santa María Camotlán,20400,853,988,1841
2029,Oaxaca,20,Santa María Chachoápam,20404,394,448,842
2029,Oaxaca,20,Santa María Chilchotla,20406,10659,11078,21737
2029,Oaxaca,20,Santa María Chimalapa,20407,4863,4681,9544
2029,Oaxaca,20,Santa María Colotepec,20401,12730,12894,25624
2029,Oaxaca,20,Santa María Cortijo,20402,563,589,1152
2029,Oaxaca,20,Santa María Coyotepec,20403,1577,1752,3329
2029,Oaxaca,20,Santa María Ecatepec,20410,1842,1872,3714
2029,Oaxaca,20,Santa María Guelacé,20411,409,496,905
2029,Oaxaca,20,Santa María Guienagati,20412,1669,1667,3336
2029,Oaxaca,20,Santa María Huatulco,20413,23186,23885,47071
2029,Oaxaca,20,Santa María Huazolotitlán,20414,6161,6261,12422
2029,Oaxaca,20,Santa María Ipalapa,20415,2578,2803,5381
2029,Oaxaca,20,Santa María Ixcatlán,20416,267,303,570
2029,Oaxaca,20,Santa María Jacatepec,20417,4788,5260,10048
2029,Oaxaca,20,Santa María Jalapa del Marqués,20418,6996,7400,14396
2029,Oaxaca,20,Santa María Jaltianguis,20419,265,329,594
2029,Oaxaca,20,Santa María Lachixío,20420,938,1108,2046
2029,Oaxaca,20,Santa María Mixtequilla,20421,2484,2626,5110
2029,Oaxaca,20,Santa María Nativitas,20422,308,378,686
2029,Oaxaca,20,Santa María Nduayaco,20423,286,297,583
2029,Oaxaca,20,Santa María Ozolotepec,20424,1983,2106,4089
2029,Oaxaca,20,Santa María Petapa,20427,8579,9217,17796
2029,Oaxaca,20,Santa María Peñoles,20426,4349,4636,8985
2029,Oaxaca,20,Santa María Pápalo,20425,1137,1145,2282
2029,Oaxaca,20,Santa María Quiegolani,20428,1043,1023,2066
2029,Oaxaca,20,Santa María Sola,20429,795,846,1641
2029,Oaxaca,20,Santa María Tataltepec,20430,214,236,450
2029,Oaxaca,20,Santa María Tecomavaca,20431,891,953,1844
2029,Oaxaca,20,Santa María Temaxcalapa,20432,505,524,1029
2029,Oaxaca,20,Santa María Temaxcaltepec,20433,1241,1421,2662
2029,Oaxaca,20,Santa María Teopoxco,20434,2110,2425,4535
2029,Oaxaca,20,Santa María Tepantlali,20435,1959,2041,4000
2029,Oaxaca,20,Santa María Texcatitlán,20436,526,573,1099
2029,Oaxaca,20,Santa María Tlahuitoltepec,20437,4734,5170,9904
2029,Oaxaca,20,Santa María Tlalixtac,20438,892,930,1822
2029,Oaxaca,20,Santa María Tonameca,20439,13356,13433,26789
2029,Oaxaca,20,Santa María Totolapilla,20440,445,484,929
2029,Oaxaca,20,Santa María Xadani,20441,4671,4606,9277
2029,Oaxaca,20,Santa María Yalina,20442,143,173,316
2029,Oaxaca,20,Santa María Yavesía,20443,259,323,582
2029,Oaxaca,20,Santa María Yolotepec,20444,219,239,458
2029,Oaxaca,20,Santa María Yosoyúa,20445,879,878,1757
2029,Oaxaca,20,Santa María Yucuhiti,20446,3280,3627,6907
2029,Oaxaca,20,Santa María Zacatepec,20447,8159,9090,17249
2029,Oaxaca,20,Santa María Zaniza,20448,1101,1154,2255
2029,Oaxaca,20,Santa María Zoquitlán,20449,1684,1729,3413
2029,Oaxaca,20,Santa María del Rosario,20408,282,268,550
2029,Oaxaca,20,Santa María del Tule,20409,4580,5308,9888
2029,Oaxaca,20,Santa María la Asunción,20396,1564,2013,3577
2029,Oaxaca,20,Santiago Amoltepec,20450,6251,6696,12947
2029,Oaxaca,20,Santiago Apoala,20451,489,575,1064
2029,Oaxaca,20,Santiago Apóstol,20452,1972,2428,4400
2029,Oaxaca,20,Santiago Astata,20453,2140,2150,4290
2029,Oaxaca,20,Santiago Atitlán,20454,1623,1577,3200
2029,Oaxaca,20,Santiago Ayuquililla,20455,1389,1540,2929
2029,Oaxaca,20,Santiago Cacaloxtepec,20456,856,923,1779
2029,Oaxaca,20,Santiago Camotlán,20457,1686,1702,3388
2029,Oaxaca,20,Santiago Chazumba,20459,2255,2828,5083
2029,Oaxaca,20,Santiago Choápam,20460,2661,2851,5512
2029,Oaxaca,20,Santiago Comaltepec,20458,530,588,1118
2029,Oaxaca,20,Santiago Huajolotitlán,20462,2115,2496,4611
2029,Oaxaca,20,Santiago Huauclilla,20463,295,331,626
2029,Oaxaca,20,Santiago Ihuitlán Plumas,20464,180,233,413
2029,Oaxaca,20,Santiago Ixcuintepec,20465,844,869,1713
2029,Oaxaca,20,Santiago Ixtayutla,20466,6514,6833,13347
2029,Oaxaca,20,Santiago Jamiltepec,20467,9880,10725,20605
2029,Oaxaca,20,Santiago Jocotepec,20468,7284,7453,14737
2029,Oaxaca,20,Santiago Juxtlahuaca,20469,18256,20168,38424
2029,Oaxaca,20,Santiago Lachiguiri,20470,2579,2617,5196
2029,Oaxaca,20,Santiago Lalopa,20471,270,281,551
2029,Oaxaca,20,Santiago Laollaga,20472,1893,1910,3803
2029,Oaxaca,20,Santiago Laxopa,20473,689,777,1466
2029,Oaxaca,20,Santiago Llano Grande,20474,1785,1829,3614
2029,Oaxaca,20,Santiago Matatlán,20475,5026,5695,10721
2029,Oaxaca,20,Santiago Miltepec,20476,231,239,470
2029,Oaxaca,20,Santiago Minas,20477,751,757,1508
2029,Oaxaca,20,Santiago Nacaltepec,20478,981,1081,2062
2029,Oaxaca,20,Santiago Nejapilla,20479,130,118,248
2029,Oaxaca,20,Santiago Niltepec,20066,2989,3028,6017
2029,Oaxaca,20,Santiago Nundiche,20480,493,542,1035
2029,Oaxaca,20,Santiago Nuyoó,20481,935,1052,1987
2029,Oaxaca,20,Santiago Pinotepa Nacional,20482,27835,29240,57075
2029,Oaxaca,20,Santiago Suchilquitongo,20483,5483,5876,11359
2029,Oaxaca,20,Santiago Tamazola,20484,2269,2582,4851
2029,Oaxaca,20,Santiago Tapextla,20485,1697,1619,3316
2029,Oaxaca,20,Santiago Tenango,20487,1115,1116,2231
2029,Oaxaca,20,Santiago Tepetlapa,20488,63,79,142
2029,Oaxaca,20,Santiago Tetepec,20489,2621,2622,5243
2029,Oaxaca,20,Santiago Texcalcingo,20490,1570,1700,3270
2029,Oaxaca,20,Santiago Textitlán,20491,2271,2280,4551
2029,Oaxaca,20,Santiago Tilantongo,20492,1502,1781,3283
2029,Oaxaca,20,Santiago Tillo,20493,285,329,614
2029,Oaxaca,20,Santiago Tlazoyaltepec,20494,2332,2762,5094
2029,Oaxaca,20,Santiago Xanica,20495,1628,1610,3238
2029,Oaxaca,20,Santiago Xiacuí,20496,1103,1214,2317
2029,Oaxaca,20,Santiago Yaitepec,20497,2064,2455,4519
2029,Oaxaca,20,Santiago Yaveo,20498,3791,3728,7519
2029,Oaxaca,20,Santiago Yolomécatl,20499,1073,1261,2334
2029,Oaxaca,20,Santiago Yosondúa,20500,4359,4901,9260
2029,Oaxaca,20,Santiago Yucuyachi,20501,508,568,1076
2029,Oaxaca,20,Santiago Zacatepec,20502,2823,2919,5742
2029,Oaxaca,20,Santiago Zoochila,20503,208,227,435
2029,Oaxaca,20,Santiago del Río,20461,315,349,664
2029,Oaxaca,20,Santo Domingo Albarradas,20506,406,459,865
2029,Oaxaca,20,Santo Domingo Armenta,20507,1854,1837,3691
2029,Oaxaca,20,Santo Domingo Chihuitán,20508,838,869,1707
2029,Oaxaca,20,Santo Domingo Ingenio,20505,4454,4508,8962
2029,Oaxaca,20,Santo Domingo Ixcatlán,20510,295,366,661
2029,Oaxaca,20,Santo Domingo Nuxaá,20511,1684,1778,3462
2029,Oaxaca,20,Santo Domingo Ozolotepec,20512,420,449,869
2029,Oaxaca,20,Santo Domingo Petapa,20513,5027,4943,9970
2029,Oaxaca,20,Santo Domingo Roayaga,20514,527,569,1096
2029,Oaxaca,20,Santo Domingo Tehuantepec,20515,34503,36483,70986
2029,Oaxaca,20,Santo Domingo Teojomulco,20516,2619,2728,5347
2029,Oaxaca,20,Santo Domingo Tepuxtepec,20517,2839,3253,6092
2029,Oaxaca,20,Santo Domingo Tlatayápam,20518,73,85,158
2029,Oaxaca,20,Santo Domingo Tomaltepec,20519,1614,1660,3274
2029,Oaxaca,20,Santo Domingo Tonaltepec,20521,123,161,284
2029,Oaxaca,20,Santo Domingo Tonalá,20520,3575,4029,7604
2029,Oaxaca,20,Santo Domingo Xagacía,20522,607,688,1295
2029,Oaxaca,20,Santo Domingo Yanhuitlán,20523,824,940,1764
2029,Oaxaca,20,Santo Domingo Yodohino,20524,172,181,353
2029,Oaxaca,20,Santo Domingo Zanatepec,20525,6643,6709,13352
2029,Oaxaca,20,Santo Domingo de Morelos,20509,5488,6021,11509
2029,Oaxaca,20,Santo Tomás Jalieza,20530,1834,2008,3842
2029,Oaxaca,20,Santo Tomás Mazaltepec,20531,1400,1505,2905
2029,Oaxaca,20,Santo Tomás Ocotepec,20532,1946,2224,4170
2029,Oaxaca,20,Santo Tomás Tamazulapan,20533,1183,1263,2446
2029,Oaxaca,20,Santos Reyes Nopala,20526,9051,9638,18689
2029,Oaxaca,20,Santos Reyes Pápalo,20527,1339,1448,2787
2029,Oaxaca,20,Santos Reyes Tepejillo,20528,494,638,1132
2029,Oaxaca,20,Santos Reyes Yucuná,20529,668,678,1346
2029,Oaxaca,20,Silacayoápam,20537,3556,4102,7658
2029,Oaxaca,20,Sitio de Xitlapehua,20538,355,401,756
2029,Oaxaca,20,Soledad Etla,20539,3015,3169,6184
2029,Oaxaca,20,Tamazulápam del Espíritu Santo,20031,3614,4419,8033
2029,Oaxaca,20,Tanetze de Zaragoza,20541,889,961,1850
2029,Oaxaca,20,Taniche,20542,421,502,923
2029,Oaxaca,20,Tataltepec de Valdés,20543,2987,3159,6146
2029,Oaxaca,20,Teococuilco de Marcos Pérez,20544,501,580,1081
2029,Oaxaca,20,Teotitlán de Flores Magón,20545,5049,5687,10736
2029,Oaxaca,20,Teotitlán del Valle,20546,3087,3406,6493
2029,Oaxaca,20,Teotongo,20547,500,595,1095
2029,Oaxaca,20,Tepelmeme Villa de Morelos,20548,826,987,1813
2029,Oaxaca,20,Tlacolula de Matamoros,20551,11746,13366,25112
2029,Oaxaca,20,Tlacotepec Plumas,20552,243,268,511
2029,Oaxaca,20,Tlalixtac de Cabrera,20553,5358,5943,11301
2029,Oaxaca,20,Totontepec Villa de Morelos,20554,2808,3050,5858
2029,Oaxaca,20,Trinidad Zaachila,20555,1557,1744,3301
2029,Oaxaca,20,Unión Hidalgo,20557,8335,8809,17144
2029,Oaxaca,20,Valerio Trujano,20558,717,862,1579
2029,Oaxaca,20,Villa Díaz Ordaz,20560,3446,4059,7505
2029,Oaxaca,20,Villa Hidalgo,20038,1028,1149,2177
2029,Oaxaca,20,Villa Sola de Vega,20277,6520,6690,13210
2029,Oaxaca,20,Villa Talea de Castro,20280,1226,1349,2575
2029,Oaxaca,20,Villa Tejúpam de la Unión,20486,1303,1416,2719
2029,Oaxaca,20,Villa Tezoatlán de Segura y Luna,20549,5611,6642,12253
2029,Oaxaca,20,Villa de Chilapa de Díaz,20405,1054,1340,2394
2029,Oaxaca,20,Villa de Etla,20338,5635,6259,11894
2029,Oaxaca,20,Villa de Tamazulápam del Progreso,20540,3902,4489,8391
2029,Oaxaca,20,Villa de Tututepec de Melchor Ocampo,20334,24040,24891,48931
2029,Oaxaca,20,Villa de Zaachila,20565,22741,25054,47795
2029,Oaxaca,20,Yaxe,20561,1461,1575,3036
2029,Oaxaca,20,Yogana,20563,661,770,1431
2029,Oaxaca,20,Yutanduchi de Guerrero,20564,610,684,1294
2029,Oaxaca,20,Zapotitlán Lagunas,20567,1629,1835,3464
2029,Oaxaca,20,Zapotitlán Palmas,20568,736,873,1609
2029,Oaxaca,20,Zimatlán de Álvarez,20570,10216,11600,21816
2029,Oaxaca,20,Ánimas Trujano,20174,2071,2312,4383
2029,Puebla,21,Acajete,21001,35343,37708,73051
2029,Puebla,21,Acateno,21002,5428,5320,10748
2029,Puebla,21,Acatlán,21003,19094,22140,41234
2029,Puebla,21,Acatzingo,21004,32185,33242,65427
2029,Puebla,21,Acteopan,21005,1652,1808,3460
2029,Puebla,21,Ahuacatlán,21006,8516,9501,18017
2029,Puebla,21,Ahuatlán,21007,1806,1955,3761
2029,Puebla,21,Ahuazotepec,21008,6393,6585,12978
2029,Puebla,21,Ahuehuetitla,21009,1007,1155,2162
2029,Puebla,21,Ajalpan,21010,35684,37563,73247
2029,Puebla,21,Albino Zertuche,21011,974,1135,2109
2029,Puebla,21,Aljojuca,21012,3696,4010,7706
2029,Puebla,21,Altepexi,21013,11720,12312,24032
2029,Puebla,21,Amixtlán,21014,2719,2979,5698
2029,Puebla,21,Amozoc,21015,64533,67087,131620
2029,Puebla,21,Aquixtla,21016,5001,5050,10051
2029,Puebla,21,Atempan,21017,14691,16569,31260
2029,Puebla,21,Atexcal,21018,2117,2276,4393
2029,Puebla,21,Atlequizayan,21080,1462,1617,3079
2029,Puebla,21,Atlixco,21019,73965,82505,156470
2029,Puebla,21,Atoyatempan,21020,3827,4033,7860
2029,Puebla,21,Atzala,21021,728,788,1516
2029,Puebla,21,Atzitzihuacán,21022,6688,7507,14195
2029,Puebla,21,Atzitzintla,21023,5165,5196,10361
2029,Puebla,21,Axutla,21024,542,629,1171
2029,Puebla,21,Ayotoxco de Guerrero,21025,4859,4949,9808
2029,Puebla,21,Calpan,21026,8028,8799,16827
2029,Puebla,21,Caltepec,21027,2185,2533,4718
2029,Puebla,21,Camocuautla,21028,1479,1504,2983
2029,Puebla,21,Caxhuacan,21029,2062,2251,4313
2029,Puebla,21,Cañada Morelos,21099,10633,11247,21880
2029,Puebla,21,Chalchicomula de Sesma,21045,26123,28239,54362
2029,Puebla,21,Chapulco,21046,4186,4482,8668
2029,Puebla,21,Chiautla,21047,11312,12023,23335
2029,Puebla,21,Chiautzingo,21048,11108,12127,23235
2029,Puebla,21,Chichiquila,21050,13830,14780,28610
2029,Puebla,21,Chiconcuautla,21049,9047,9477,18524
2029,Puebla,21,Chietla,21051,19584,20887,40471
2029,Puebla,21,Chigmecatitlán,21052,651,781,1432
2029,Puebla,21,Chignahuapan,21053,35092,36015,71107
2029,Puebla,21,Chignautla,21054,18267,19248,37515
2029,Puebla,21,Chila,21055,2557,2844,5401
2029,Puebla,21,Chila de la Sal,21056,853,930,1783
2029,Puebla,21,Chilchotla,21058,11131,11087,22218
2029,Puebla,21,Chinantla,21059,1254,1432,2686
2029,Puebla,21,Coatepec,21030,431,473,904
2029,Puebla,21,Coatzingo,21031,1641,1824,3465
2029,Puebla,21,Cohetzala,21032,825,820,1645
2029,Puebla,21,Cohuecan,21033,2709,2899,5608
2029,Puebla,21,Coronango,21034,22597,23268,45865
2029,Puebla,21,Coxcatlán,21035,11232,12340,23572
2029,Puebla,21,Coyomeapan,21036,7439,8202,15641
2029,Puebla,21,Coyotepec,21037,1293,1528,2821
2029,Puebla,21,Cuapiaxtla de Madero,21038,5590,5611,11201
2029,Puebla,21,Cuautempan,21039,5162,5529,10691
2029,Puebla,21,Cuautinchán,21040,5707,5728,11435
2029,Puebla,21,Cuautlancingo,21041,65668,68961,134629
2029,Puebla,21,Cuayuca de Andrade,21042,1815,1953,3768
2029,Puebla,21,Cuetzalan del Progreso,21043,26767,28121,54888
2029,Puebla,21,Cuyoaco,21044,8646,9315,17961
2029,Puebla,21,Domingo Arenas,21060,4022,4425,8447
2029,Puebla,21,Eloxochitlán,21061,6837,7289,14126
2029,Puebla,21,Epatlán,21062,2726,2885,5611
2029,Puebla,21,Esperanza,21063,8271,8744,17015
2029,Puebla,21,Francisco Z. Mena,21064,10076,9904,19980
2029,Puebla,21,General Felipe Ángeles,21065,11120,12113,23233
2029,Puebla,21,Guadalupe,21066,3195,3729,6924
2029,Puebla,21,Guadalupe Victoria,21067,9400,9904,19304
2029,Puebla,21,Hermenegildo Galeana,21068,4420,4491,8911
2029,Puebla,21,Honey,21057,4388,4687,9075
2029,Puebla,21,Huaquechula,21069,13595,15341,28936
2029,Puebla,21,Huatlatlauca,21070,3525,4294,7819
2029,Puebla,21,Huauchinango,21071,56504,62654,119158
2029,Puebla,21,Huehuetla,21072,10600,10897,21497
2029,Puebla,21,Huehuetlán el Chico,21073,4865,5075,9940
2029,Puebla,21,Huehuetlán el Grande,21150,4092,4340,8432
2029,Puebla,21,Huejotzingo,21074,40940,42636,83576
2029,Puebla,21,Hueyapan,21075,6873,7295,14168
2029,Puebla,21,Hueytamalco,21076,14957,15219,30176
2029,Puebla,21,Hueytlalpan,21077,3061,3176,6237
2029,Puebla,21,Huitzilan de Serdán,21078,8450,8283,16733
2029,Puebla,21,Huitziltepec,21079,3028,3215,6243
2029,Puebla,21,Ixcamilpa de Guerrero,21081,2037,2231,4268
2029,Puebla,21,Ixcaquixtla,21082,4852,5330,10182
2029,Puebla,21,Ixtacamaxtitlán,21083,14139,14281,28420
2029,Puebla,21,Ixtepec,21084,3905,4121,8026
2029,Puebla,21,Izúcar de Matamoros,21085,42423,47245,89668
2029,Puebla,21,Jalpan,21086,6747,7149,13896
2029,Puebla,21,Jolalpan,21087,7270,7757,15027
2029,Puebla,21,Jonotla,21088,2623,2713,5336
2029,Puebla,21,Jopala,21089,7360,7617,14977
2029,Puebla,21,Juan C. Bonilla,21090,11616,12516,24132
2029,Puebla,21,Juan Galindo,21091,5742,6605,12347
2029,Puebla,21,Juan N. Méndez,21092,3016,3075,6091
2029,Puebla,21,La Magdalena Tlatlauquitepec,21095,332,329,661
2029,Puebla,21,Lafragua,21093,4670,4783,9453
2029,Puebla,21,Libres,21094,18634,19558,38192
2029,Puebla,21,Los Reyes de Juárez,21118,15062,15417,30479
2029,Puebla,21,Mazapiltepec de Juárez,21096,1623,1637,3260
2029,Puebla,21,Mixtla,21097,1273,1430,2703
2029,Puebla,21,Molcaxac,21098,3335,3728,7063
2029,Puebla,21,Naupan,21100,5399,5941,11340
2029,Puebla,21,Nauzontla,21101,1932,2147,4079
2029,Puebla,21,Nealtican,21102,6693,7277,13970
2029,Puebla,21,Nicolás Bravo,21103,3441,3660,7101
2029,Puebla,21,Nopalucan,21104,17054,17407,34461
2029,Puebla,21,Ocotepec,21105,2699,2890,5589
2029,Puebla,21,Ocoyucan,21106,14989,16694,31683
2029,Puebla,21,Olintla,21107,6576,6892,13468
2029,Puebla,21,Oriental,21108,10031,10629,20660
2029,Puebla,21,Pahuatlán,21109,12033,13148,25181
2029,Puebla,21,Palmar de Bravo,21110,25525,25838,51363
2029,Puebla,21,Pantepec,21111,10493,11041,21534
2029,Puebla,21,Petlalcingo,21112,5320,6059,11379
2029,Puebla,21,Piaxtla,21113,2570,2810,5380
2029,Puebla,21,Puebla,21114,877301,959412,1836713
2029,Puebla,21,Quecholac,21115,27860,28724,56584
2029,Puebla,21,Quimixtlán,21116,12218,12510,24728
2029,Puebla,21,Rafael Lara Grajales,21117,7605,8116,15721
2029,Puebla,21,San Andrés Cholula,21119,81431,82850,164281
2029,Puebla,21,San Antonio Cañada,21120,2898,3273,6171
2029,Puebla,21,San Diego la Mesa Tochimiltzingo,21121,698,692,1390
2029,Puebla,21,San Felipe Teotlalcingo,21122,5806,6154,11960
2029,Puebla,21,San Felipe Tepatlán,21123,2258,2309,4567
2029,Puebla,21,San Gabriel Chilac,21124,8503,9442,17945
2029,Puebla,21,San Gregorio Atzompa,21125,5091,5324,10415
2029,Puebla,21,San Jerónimo Tecuanipan,21126,3404,3704,7108
2029,Puebla,21,San Jerónimo Xayacatlán,21127,1935,2239,4174
2029,Puebla,21,San José Chiapa,21128,4931,4995,9926
2029,Puebla,21,San José Miahuatlán,21129,7344,7923,15267
2029,Puebla,21,San Juan Atenco,21130,1843,2100,3943
2029,Puebla,21,San Juan Atzompa,21131,520,484,1004
2029,Puebla,21,San Martín Texmelucan,21132,83955,89733,173688
2029,Puebla,21,San Martín Totoltepec,21133,350,381,731
2029,Puebla,21,San Matías Tlalancaleca,21134,11483,11798,23281
2029,Puebla,21,San Miguel Ixitlán,21135,308,334,642
2029,Puebla,21,San Miguel Xoxtla,21136,6910,7269,14179
2029,Puebla,21,San Nicolás Buenos Aires,21137,5517,5719,11236
2029,Puebla,21,San Nicolás de los Ranchos,21138,6725,6917,13642
2029,Puebla,21,San Pablo Anicano,21139,1986,2168,4154
2029,Puebla,21,San Pedro Cholula,21140,71858,77922,149780
2029,Puebla,21,San Pedro Yeloixtlahuaca,21141,1877,2041,3918
2029,Puebla,21,San Salvador Huixcolotla,21144,8256,8356,16612
2029,Puebla,21,San Salvador el Seco,21142,16867,17704,34571
2029,Puebla,21,San Salvador el Verde,21143,17603,18027,35630
2029,Puebla,21,San Sebastián Tlacotepec,21145,7743,7881,15624
2029,Puebla,21,Santa Catarina Tlaltempan,21146,480,493,973
2029,Puebla,21,Santa Inés Ahuatempan,21147,3522,3893,7415
2029,Puebla,21,Santa Isabel Cholula,21148,4806,5210,10016
2029,Puebla,21,Santiago Miahuatlán,21149,13821,14587,28408
2029,Puebla,21,Santo Tomás Hueyotlipan,21151,4705,5056,9761
2029,Puebla,21,Soltepec,21152,7004,7266,14270
2029,Puebla,21,Tecali de Herrera,21153,12302,12840,25142
2029,Puebla,21,Tecamachalco,21154,41932,44263,86195
2029,Puebla,21,Tecomatlán,21155,3241,3383,6624
2029,Puebla,21,Tehuacán,21156,170151,189136,359287
2029,Puebla,21,Tehuitzingo,21157,6290,7052,13342
2029,Puebla,21,Tenampulco,21158,4182,4328,8510
2029,Puebla,21,Teopantlán,21159,2041,2534,4575
2029,Puebla,21,Teotlalco,21160,1821,1883,3704
2029,Puebla,21,Tepanco de López,21161,11024,12149,23173
2029,Puebla,21,Tepango de Rodríguez,21162,2239,2459,4698
2029,Puebla,21,Tepatlaxco de Hidalgo,21163,9581,10090,19671
2029,Puebla,21,Tepeaca,21164,43353,47001,90354
2029,Puebla,21,Tepemaxalco,21165,609,628,1237
2029,Puebla,21,Tepeojuma,21166,4648,5370,10018
2029,Puebla,21,Tepetzintla,21167,6231,6676,12907
2029,Puebla,21,Tepexco,21168,3755,3922,7677
2029,Puebla,21,Tepexi de Rodríguez,21169,12069,12291,24360
2029,Puebla,21,Tepeyahualco,21170,9643,9767,19410
2029,Puebla,21,Tepeyahualco de Cuauhtémoc,21171,1967,2115,4082
2029,Puebla,21,Tetela de Ocampo,21172,15746,16813,32559
2029,Puebla,21,Teteles de Ávila Castillo,21173,3051,3628,6679
2029,Puebla,21,Teziutlán,21174,53046,59182,112228
2029,Puebla,21,Tianguismanalco,21175,7007,7523,14530
2029,Puebla,21,Tilapa,21176,4771,5097,9868
2029,Puebla,21,Tlachichuca,21179,16449,16940,33389
2029,Puebla,21,Tlacotepec de Benito Juárez,21177,27807,30049,57856
2029,Puebla,21,Tlacuilotepec,21178,9536,9779,19315
2029,Puebla,21,Tlahuapan,21180,22592,22646,45238
2029,Puebla,21,Tlaltenango,21181,3952,4018,7970
2029,Puebla,21,Tlanepantla,21182,2665,2896,5561
2029,Puebla,21,Tlaola,21183,10939,11596,22535
2029,Puebla,21,Tlapacoya,21184,3641,3758,7399
2029,Puebla,21,Tlapanalá,21185,4676,5043,9719
2029,Puebla,21,Tlatlauquitepec,21186,29406,32474,61880
2029,Puebla,21,Tlaxco,21187,3155,3143,6298
2029,Puebla,21,Tochimilco,21188,9947,10841,20788
2029,Puebla,21,Tochtepec,21189,11564,12315,23879
2029,Puebla,21,Totoltepec de Guerrero,21190,666,805,1471
2029,Puebla,21,Tulcingo,21191,5098,5856,10954
2029,Puebla,21,Tuzamapan de Galeana,21192,3692,3838,7530
2029,Puebla,21,Tzicatlacoyan,21193,4011,4103,8114
2029,Puebla,21,Venustiano Carranza,21194,16398,17470,33868
2029,Puebla,21,Vicente Guerrero,21195,13253,14126,27379
2029,Puebla,21,Xayacatlán de Bravo,21196,856,1031,1887
2029,Puebla,21,Xicotepec,21197,44452,47750,92202
2029,Puebla,21,Xicotlán,21198,670,742,1412
2029,Puebla,21,Xiutetelco,21199,21516,23120,44636
2029,Puebla,21,Xochiapulco,21200,1915,2115,4030
2029,Puebla,21,Xochiltepec,21201,1756,2087,3843
2029,Puebla,21,Xochitlán Todos Santos,21203,3474,3846,7320
2029,Puebla,21,Xochitlán de Vicente Suárez,21202,6950,7487,14437
2029,Puebla,21,Yaonáhuac,21204,4331,4742,9073
2029,Puebla,21,Yehualtepec,21205,13605,14164,27769
2029,Puebla,21,Zacapala,21206,2453,2730,5183
2029,Puebla,21,Zacapoaxtla,21207,29949,32920,62869
2029,Puebla,21,Zacatlán,21208,44827,49483,94310
2029,Puebla,21,Zapotitlán,21209,4544,5343,9887
2029,Puebla,21,Zapotitlán de Méndez,21210,3237,3254,6491
2029,Puebla,21,Zaragoza,21211,8571,9951,18522
2029,Puebla,21,Zautla,21212,10209,11680,21889
2029,Puebla,21,Zihuateutla,21213,7416,7740,15156
2029,Puebla,21,Zinacatepec,21214,9289,10108,19397
2029,Puebla,21,Zongozotla,21215,2816,2878,5694
2029,Puebla,21,Zoquiapan,21216,1347,1519,2866
2029,Puebla,21,Zoquitlán,21217,10141,10838,20979
2029,Querétaro,22,Amealco de Bonfil,22001,38037,40249,78286
2029,Querétaro,22,Arroyo Seco,22003,8684,9150,17834
2029,Querétaro,22,Cadereyta de Montes,22004,42502,45691,88193
2029,Querétaro,22,Colón,22005,39393,38575,77968
2029,Querétaro,22,Corregidora,22006,116760,123302,240062
2029,Querétaro,22,El Marqués,22011,102720,100051,202771
2029,Querétaro,22,Ezequiel Montes,22007,25196,26911,52107
2029,Querétaro,22,Huimilpan,22008,23056,24834,47890
2029,Querétaro,22,Jalpan de Serra,22009,16482,17958,34440
2029,Querétaro,22,Landa de Matamoros,22010,11576,12332,23908
2029,Querétaro,22,Pedro Escobedo,22012,43184,43672,86856
2029,Querétaro,22,Peñamiller,22013,12769,12991,25760
2029,Querétaro,22,Pinal de Amoles,22002,15950,16780,32730
2029,Querétaro,22,Querétaro,22014,555216,565703,1120919
2029,Querétaro,22,San Joaquín,22015,5607,6271,11878
2029,Querétaro,22,San Juan del Río,22016,169179,175629,344808
2029,Querétaro,22,Tequisquiapan,22017,44510,46218,90728
2029,Querétaro,22,Tolimán,22018,17590,18301,35891
2029,Quintana Roo,23,Bacalar,23010,27628,27311,54939
2029,Quintana Roo,23,Benito Juárez,23005,496016,489989,986005
2029,Quintana Roo,23,Cozumel,23001,61681,61663,123344
2029,Quintana Roo,23,Felipe Carrillo Puerto,23002,57361,56978,114339
2029,Quintana Roo,23,Isla Mujeres,23003,15087,13821,28908
2029,Quintana Roo,23,José María Morelos,23006,27321,25561,52882
2029,Quintana Roo,23,Lázaro Cárdenas,23007,19820,18869,38689
2029,Quintana Roo,23,Othón P. Blanco,23004,162327,168872,331199
2029,Quintana Roo,23,Solidaridad,23008,142032,128112,270144
2029,Quintana Roo,23,Tulum,23009,22653,20311,42964
2029,San Luis Potosí,24,Ahualulco,24001,9486,10619,20105
2029,San Luis Potosí,24,Alaquines,24002,4665,4767,9432
2029,San Luis Potosí,24,Aquismón,24003,26573,25966,52539
2029,San Luis Potosí,24,Armadillo de los Infante,24004,2379,2435,4814
2029,San Luis Potosí,24,Axtla de Terrazas,24053,20347,20931,41278
2029,San Luis Potosí,24,Catorce,24006,5657,5464,11121
2029,San Luis Potosí,24,Cedral,24007,10369,10819,21188
2029,San Luis Potosí,24,Cerritos,24008,11878,12804,24682
2029,San Luis Potosí,24,Cerro de San Pedro,24009,2526,2459,4985
2029,San Luis Potosí,24,Charcas,24015,11532,11930,23462
2029,San Luis Potosí,24,Ciudad Fernández,24011,24325,25651,49976
2029,San Luis Potosí,24,Ciudad Valles,24013,96018,103013,199031
2029,San Luis Potosí,24,Ciudad del Maíz,24010,19614,19683,39297
2029,San Luis Potosí,24,Coxcatlán,24014,8711,8625,17336
2029,San Luis Potosí,24,Cárdenas,24005,10197,11137,21334
2029,San Luis Potosí,24,Ebano,24016,23928,24746,48674
2029,San Luis Potosí,24,El Naranjo,24058,12261,12137,24398
2029,San Luis Potosí,24,Guadalcázar,24017,15104,14832,29936
2029,San Luis Potosí,24,Huehuetlán,24018,8616,8923,17539
2029,San Luis Potosí,24,Lagunillas,24019,3203,3296,6499
2029,San Luis Potosí,24,Matehuala,24020,53109,56442,109551
2029,San Luis Potosí,24,Matlapa,24057,16704,16865,33569
2029,San Luis Potosí,24,Mexquitic de Carmona,24021,29858,32280,62138
2029,San Luis Potosí,24,Moctezuma,24022,10389,11240,21629
2029,San Luis Potosí,24,Rayón,24023,8724,9157,17881
2029,San Luis Potosí,24,Rioverde,24024,51332,54377,105709
2029,San Luis Potosí,24,Salinas,24025,16641,17879,34520
2029,San Luis Potosí,24,San Antonio,24026,5172,5034,10206
2029,San Luis Potosí,24,San Ciro de Acosta,24027,5718,6086,11804
2029,San Luis Potosí,24,San Luis Potosí,24028,438304,473881,912185
2029,San Luis Potosí,24,San Martín Chalchicuautla,24029,11858,12030,23888
2029,San Luis Potosí,24,San Nicolás Tolentino,24030,2912,3202,6114
2029,San Luis Potosí,24,San Vicente Tancuayalab,24034,8223,8203,16426
2029,San Luis Potosí,24,Santa Catarina,24031,6234,6547,12781
2029,San Luis Potosí,24,Santa María del Río,24032,21035,23002,44037
2029,San Luis Potosí,24,Santo Domingo,24033,6792,6777,13569
2029,San Luis Potosí,24,Soledad de Graciano Sánchez,24035,165973,174810,340783
2029,San Luis Potosí,24,Tamasopo,24036,17038,16640,33678
2029,San Luis Potosí,24,Tamazunchale,24037,52593,53739,106332
2029,San Luis Potosí,24,Tampacán,24038,8779,8597,17376
2029,San Luis Potosí,24,Tampamolón Corona,24039,8384,8580,16964
2029,San Luis Potosí,24,Tamuín,24040,21357,21858,43215
2029,San Luis Potosí,24,Tancanhuitz,24012,11229,11623,22852
2029,San Luis Potosí,24,Tanlajás,24041,10855,10634,21489
2029,San Luis Potosí,24,Tanquián de Escobedo,24042,8270,8683,16953
2029,San Luis Potosí,24,Tierra Nueva,24043,4773,5469,10242
2029,San Luis Potosí,24,Vanegas,24044,4321,4225,8546
2029,San Luis Potosí,24,Venado,24045,8061,8335,16396
2029,San Luis Potosí,24,Villa Hidalgo,24051,8369,8471,16840
2029,San Luis Potosí,24,Villa Juárez,24052,5801,5942,11743
2029,San Luis Potosí,24,Villa de Arista,24056,8336,8347,16683
2029,San Luis Potosí,24,Villa de Arriaga,24046,9680,9798,19478
2029,San Luis Potosí,24,Villa de Guadalupe,24047,5617,5589,11206
2029,San Luis Potosí,24,Villa de Ramos,24049,19865,20712,40577
2029,San Luis Potosí,24,Villa de Reyes,24050,26581,26739,53320
2029,San Luis Potosí,24,Villa de la Paz,24048,3006,2988,5994
2029,San Luis Potosí,24,Xilitla,24054,27974,28862,56836
2029,San Luis Potosí,24,Zaragoza,24055,13890,14236,28126
2029,Sinaloa,25,Ahome,25001,249847,259768,509615
2029,Sinaloa,25,Angostura,25002,27907,27800,55707
2029,Sinaloa,25,Badiraguato,25003,17989,16599,34588
2029,Sinaloa,25,Choix,25007,18942,17879,36821
2029,Sinaloa,25,Concordia,25004,16101,15676,31777
2029,Sinaloa,25,Cosalá,25005,9332,8873,18205
2029,Sinaloa,25,Culiacán,25006,495063,516351,1011414
2029,Sinaloa,25,El Fuerte,25010,58878,57830,116708
2029,Sinaloa,25,Elota,25008,31561,29243,60804
2029,Sinaloa,25,Escuinapa,25009,33876,32918,66794
2029,Sinaloa,25,Guasave,25011,168149,171342,339491
2029,Sinaloa,25,Mazatlán,25012,279861,288281,568142
2029,Sinaloa,25,Mocorito,25013,27468,25974,53442
2029,Sinaloa,25,Navolato,25018,86898,83098,169996
2029,Sinaloa,25,Rosario,25014,31430,30376,61806
2029,Sinaloa,25,Salvador Alvarado,25015,45291,47553,92844
2029,Sinaloa,25,San Ignacio,25016,12637,11607,24244
2029,Sinaloa,25,Sinaloa,25017,51973,50566,102539
2029,Sonora,26,Aconchi,26001,1797,1647,3444
2029,Sonora,26,Agua Prieta,26002,47483,46891,94374
2029,Sonora,26,Alamos,26003,16422,15376,31798
2029,Sonora,26,Altar,26004,5631,5576,11207
2029,Sonora,26,Arivechi,26005,783,750,1533
2029,Sonora,26,Arizpe,26006,1792,1698,3490
2029,Sonora,26,Atil,26007,382,367,749
2029,Sonora,26,Bacadéhuachi,26008,751,685,1436
2029,Sonora,26,Bacanora,26009,572,504,1076
2029,Sonora,26,Bacerac,26010,915,867,1782
2029,Sonora,26,Bacoachi,26011,1022,1011,2033
2029,Sonora,26,Banámichi,26013,1059,1033,2092
2029,Sonora,26,Bavispe,26015,1007,890,1897
2029,Sonora,26,Baviácora,26014,2209,2084,4293
2029,Sonora,26,Benito Juárez,26071,13302,13313,26615
2029,Sonora,26,Benjamín Hill,26016,3119,3259,6378
2029,Sonora,26,Bácum,26012,14046,13845,27891
2029,Sonora,26,Caborca,26017,50845,50040,100885
2029,Sonora,26,Cajeme,26018,253641,267094,520735
2029,Sonora,26,Cananea,26019,20747,21319,42066
2029,Sonora,26,Carbó,26020,3069,2817,5886
2029,Sonora,26,Cucurpe,26022,692,550,1242
2029,Sonora,26,Cumpas,26023,3945,3894,7839
2029,Sonora,26,Divisaderos,26024,491,476,967
2029,Sonora,26,Empalme,26025,33598,33904,67502
2029,Sonora,26,Etchojoa,26026,38942,37689,76631
2029,Sonora,26,Fronteras,26027,5158,4977,10135
2029,Sonora,26,General Plutarco Elías Calles,26070,10114,9942,20056
2029,Sonora,26,Granados,26028,696,681,1377
2029,Sonora,26,Guaymas,26029,95023,96538,191561
2029,Sonora,26,Hermosillo,26030,506997,522689,1029686
2029,Sonora,26,Huachinera,26031,847,793,1640
2029,Sonora,26,Huatabampo,26033,48811,48862,97673
2029,Sonora,26,Huásabas,26032,621,550,1171
2029,Sonora,26,Huépac,26034,659,640,1299
2029,Sonora,26,Imuris,26035,7594,7501,15095
2029,Sonora,26,La Colorada,26021,1418,1122,2540
2029,Sonora,26,Magdalena,26036,18527,18849,37376
2029,Sonora,26,Mazatán,26037,844,720,1564
2029,Sonora,26,Moctezuma,26038,2984,3076,6060
2029,Sonora,26,Naco,26039,3666,3653,7319
2029,Sonora,26,Nacozari de García,26041,7918,7762,15680
2029,Sonora,26,Navojoa,26042,96148,100857,197005
2029,Sonora,26,Nogales,26043,134925,135409,270334
2029,Sonora,26,Nácori Chico,26040,1339,1208,2547
2029,Sonora,26,Onavas,26044,312,270,582
2029,Sonora,26,Opodepe,26045,1831,1610,3441
2029,Sonora,26,Oquitoa,26046,241,268,509
2029,Sonora,26,Pitiquito,26047,5794,5441,11235
2029,Sonora,26,Puerto Peñasco,26048,39577,38460,78037
2029,Sonora,26,Quiriego,26049,1929,1658,3587
2029,Sonora,26,Rayón,26050,1042,948,1990
2029,Sonora,26,Rosario,26051,3335,3047,6382
2029,Sonora,26,Sahuaripa,26052,3713,3433,7146
2029,Sonora,26,San Felipe de Jesús,26053,275,262,537
2029,Sonora,26,San Ignacio Río Muerto,26072,8968,8471,17439
2029,Sonora,26,San Javier,26054,440,327,767
2029,Sonora,26,San Luis Río Colorado,26055,113317,112227,225544
2029,Sonora,26,San Miguel de Horcasitas,26056,5730,4829,10559
2029,Sonora,26,San Pedro de la Cueva,26057,1071,920,1991
2029,Sonora,26,Santa Ana,26058,9770,10082,19852
2029,Sonora,26,Santa Cruz,26059,1094,1124,2218
2029,Sonora,26,Soyopa,26061,988,817,1805
2029,Sonora,26,Suaqui Grande,26062,770,646,1416
2029,Sonora,26,Sáric,26060,923,878,1801
2029,Sonora,26,Tepache,26063,1017,932,1949
2029,Sonora,26,Trincheras,26064,1130,918,2048
2029,Sonora,26,Tubutama,26065,726,679,1405
2029,Sonora,26,Ures,26066,5763,5501,11264
2029,Sonora,26,Villa Hidalgo,26067,1049,948,1997
2029,Sonora,26,Villa Pesqueira,26068,815,688,1503
2029,Sonora,26,Yécora,26069,3597,3497,7094
2029,Tabasco,27,Balancán,27001,35716,35693,71409
2029,Tabasco,27,Centla,27003,63566,64029,127595
2029,Tabasco,27,Centro,27004,392153,413998,806151
2029,Tabasco,27,Comalcalco,27005,116727,120926,237653
2029,Tabasco,27,Cunduacán,27006,79052,81621,160673
2029,Tabasco,27,Cárdenas,27002,146763,152545,299308
2029,Tabasco,27,Emiliano Zapata,27007,17338,19158,36496
2029,Tabasco,27,Huimanguillo,27008,107578,109969,217547
2029,Tabasco,27,Jalapa,27009,22883,22868,45751
2029,Tabasco,27,Jalpa de Méndez,27010,50896,51499,102395
2029,Tabasco,27,Jonuta,27011,18035,17989,36024
2029,Tabasco,27,Macuspana,27012,94265,98548,192813
2029,Tabasco,27,Nacajuca,27013,78279,81679,159958
2029,Tabasco,27,Paraíso,27014,55161,55860,111021
2029,Tabasco,27,Tacotalpa,27015,28539,28200,56739
2029,Tabasco,27,Teapa,27016,33285,34643,67928
2029,Tabasco,27,Tenosique,27017,34152,36148,70300
2029,Tamaulipas,28,Abasolo,28001,7227,7140,14367
2029,Tamaulipas,28,Aldama,28002,17103,16559,33662
2029,Tamaulipas,28,Altamira,28003,132848,134250,267098
2029,Tamaulipas,28,Antiguo Morelos,28004,5866,5774,11640
2029,Tamaulipas,28,Burgos,28005,2846,2625,5471
2029,Tamaulipas,28,Bustamante,28006,4896,4480,9376
2029,Tamaulipas,28,Camargo,28007,8905,8715,17620
2029,Tamaulipas,28,Casas,28008,2583,2292,4875
2029,Tamaulipas,28,Ciudad Madero,28009,115554,128304,243858
2029,Tamaulipas,28,Cruillas,28010,1125,1087,2212
2029,Tamaulipas,28,El Mante,28021,67378,71665,139043
2029,Tamaulipas,28,González,28012,25295,25326,50621
2029,Tamaulipas,28,Guerrero,28014,2751,2532,5283
2029,Tamaulipas,28,Gustavo Díaz Ordaz,28015,9349,9216,18565
2029,Tamaulipas,28,Gómez Farías,28011,5537,5253,10790
2029,Tamaulipas,28,Güémez,28013,9513,8735,18248
2029,Tamaulipas,28,Hidalgo,28016,14267,13482,27749
2029,Tamaulipas,28,Jaumave,28017,9127,8778,17905
2029,Tamaulipas,28,Jiménez,28018,4679,4664,9343
2029,Tamaulipas,28,Llera,28019,10468,9911,20379
2029,Tamaulipas,28,Mainero,28020,1604,1528,3132
2029,Tamaulipas,28,Matamoros,28022,280992,292596,573588
2029,Tamaulipas,28,Mier,28024,2411,2462,4873
2029,Tamaulipas,28,Miguel Alemán,28025,15537,15674,31211
2029,Tamaulipas,28,Miquihuana,28026,2222,2024,4246
2029,Tamaulipas,28,Méndez,28023,2336,2132,4468
2029,Tamaulipas,28,Nuevo Laredo,28027,219260,221085,440345
2029,Tamaulipas,28,Nuevo Morelos,28028,2153,1948,4101
2029,Tamaulipas,28,Ocampo,28029,8466,7950,16416
2029,Tamaulipas,28,Padilla,28030,8313,8158,16471
2029,Tamaulipas,28,Palmillas,28031,1077,1011,2088
2029,Tamaulipas,28,Reynosa,28032,354539,357740,712279
2029,Tamaulipas,28,Río Bravo,28033,71322,71488,142810
2029,Tamaulipas,28,San Carlos,28034,5618,5085,10703
2029,Tamaulipas,28,San Fernando,28035,32214,31885,64099
2029,Tamaulipas,28,San Nicolás,28036,639,562,1201
2029,Tamaulipas,28,Soto la Marina,28037,14751,13863,28614
2029,Tamaulipas,28,Tampico,28038,174807,192907,367714
2029,Tamaulipas,28,Tula,28039,17064,17066,34130
2029,Tamaulipas,28,Valle Hermoso,28040,35783,37080,72863
2029,Tamaulipas,28,Victoria,28041,190577,200748,391325
2029,Tamaulipas,28,Villagrán,28042,3880,3632,7512
2029,Tamaulipas,28,Xicoténcatl,28043,13954,13951,27905
2029,Tlaxcala,29,Acuamanala de Miguel Hidalgo,29022,3920,3877,7797
2029,Tlaxcala,29,Altzayanca,29004,10215,10125,20340
2029,Tlaxcala,29,Amaxac de Guerrero,29001,6494,6699,13193
2029,Tlaxcala,29,Apetatitlán de Antonio Carvajal,29002,8613,9220,17833
2029,Tlaxcala,29,Apizaco,29005,44090,48522,92612
2029,Tlaxcala,29,Atlangatepec,29003,3766,3878,7644
2029,Tlaxcala,29,Benito Juárez,29045,3462,3527,6989
2029,Tlaxcala,29,Calpulalpan,29006,27490,28815,56305
2029,Tlaxcala,29,Chiautempan,29010,41413,44588,86001
2029,Tlaxcala,29,Contla de Juan Cuamatzi,29018,22121,22656,44777
2029,Tlaxcala,29,Cuapiaxtla,29008,8793,8779,17572
2029,Tlaxcala,29,Cuaxomulco,29009,3105,3154,6259
2029,Tlaxcala,29,El Carmen Tequexquitla,29007,9700,9898,19598
2029,Tlaxcala,29,Emiliano Zapata,29046,2574,2654,5228
2029,Tlaxcala,29,Españita,29012,5123,5196,10319
2029,Tlaxcala,29,Huamantla,29013,52763,55006,107769
2029,Tlaxcala,29,Hueyotlipan,29014,8500,8620,17120
2029,Tlaxcala,29,Ixtacuixtla de Mariano Matamoros,29015,22723,23779,46502
2029,Tlaxcala,29,Ixtenco,29016,4157,4530,8687
2029,Tlaxcala,29,La Magdalena Tlaltelulco,29048,10351,11184,21535
2029,Tlaxcala,29,Lázaro Cárdenas,29047,1777,1787,3564
2029,Tlaxcala,29,Mazatecochco de José María Morelos,29017,6240,6319,12559
2029,Tlaxcala,29,Muñoz de Domingo Arenas,29011,2659,2646,5305
2029,Tlaxcala,29,Nanacamilpa de Mariano Arista,29021,10456,10878,21334
2029,Tlaxcala,29,Natívitas,29023,14650,15605,30255
2029,Tlaxcala,29,Panotla,29024,15438,16553,31991
2029,Tlaxcala,29,Papalotla de Xicohténcatl,29041,17128,18266,35394
2029,Tlaxcala,29,San Damián Texóloc,29049,3360,3392,6752
2029,Tlaxcala,29,San Francisco Tetlanohcan,29050,6209,6461,12670
2029,Tlaxcala,29,San Jerónimo Zacualpan,29051,2198,2432,4630
2029,Tlaxcala,29,San José Teacalco,29052,3455,3638,7093
2029,Tlaxcala,29,San Juan Huactzinco,29053,4226,4629,8855
2029,Tlaxcala,29,San Lorenzo Axocomanitla,29054,3226,3465,6691
2029,Tlaxcala,29,San Lucas Tecopilco,29055,1821,1918,3739
2029,Tlaxcala,29,San Pablo del Monte,29025,43888,43925,87813
2029,Tlaxcala,29,Sanctórum de Lázaro Cárdenas,29020,5933,6055,11988
2029,Tlaxcala,29,Santa Ana Nopalucan,29056,4515,4671,9186
2029,Tlaxcala,29,Santa Apolonia Teacalco,29057,2603,2891,5494
2029,Tlaxcala,29,Santa Catarina Ayometla,29058,5076,5505,10581
2029,Tlaxcala,29,Santa Cruz Quilehtla,29059,4147,4163,8310
2029,Tlaxcala,29,Santa Cruz Tlaxcala,29026,11825,12238,24063
2029,Tlaxcala,29,Santa Isabel Xiloxoxtla,29060,2840,2992,5832
2029,Tlaxcala,29,Tenancingo,29027,7606,7846,15452
2029,Tlaxcala,29,Teolocholco,29028,13696,14450,28146
2029,Tlaxcala,29,Tepetitla de Lardizábal,29019,11891,12761,24652
2029,Tlaxcala,29,Tepeyanco,29029,8001,8823,16824
2029,Tlaxcala,29,Terrenate,29030,9087,8920,18007
2029,Tlaxcala,29,Tetla de la Solidaridad,29031,18539,18963,37502
2029,Tlaxcala,29,Tetlatlahuca,29032,8510,8991,17501
2029,Tlaxcala,29,Tlaxcala,29033,53532,59074,112606
2029,Tlaxcala,29,Tlaxco,29034,24351,25165,49516
2029,Tlaxcala,29,Tocatlán,29035,3381,3447,6828
2029,Tlaxcala,29,Totolac,29036,12690,13902,26592
2029,Tlaxcala,29,Tzompantepec,29038,9858,10526,20384
2029,Tlaxcala,29,Xaloztoc,29039,13959,13825,27784
2029,Tlaxcala,29,Xaltocan,29040,6331,6767,13098
2029,Tlaxcala,29,Xicohtzinco,29042,7746,8589,16335
2029,Tlaxcala,29,Yauhquemehcan,29043,21850,23078,44928
2029,Tlaxcala,29,Zacatelco,29044,25178,27539,52717
2029,Tlaxcala,29,Ziltlaltépec de Trinidad Sánchez Santos,29037,5014,5466,10480
2029,Veracruz,30,Acajete,30001,4731,4580,9311
2029,Veracruz,30,Acatlán,30002,1699,1748,3447
2029,Veracruz,30,Acayucan,30003,45382,48857,94239
2029,Veracruz,30,Actopan,30004,24268,24900,49168
2029,Veracruz,30,Acula,30005,3041,3012,6053
2029,Veracruz,30,Acultzingo,30006,11897,12304,24201
2029,Veracruz,30,Agua Dulce,30204,25839,27465,53304
2029,Veracruz,30,Alpatláhuac,30008,5367,5408,10775
2029,Veracruz,30,Alto Lucero de Gutiérrez Barrios,30009,16573,16362,32935
2029,Veracruz,30,Altotonga,30010,33391,35879,69270
2029,Veracruz,30,Alvarado,30011,29658,30655,60313
2029,Veracruz,30,Amatitlán,30012,4438,4665,9103
2029,Veracruz,30,Amatlán de los Reyes,30014,23976,25946,49922
2029,Veracruz,30,Angel R. Cabada,30015,18568,19775,38343
2029,Veracruz,30,Apazapan,30017,2282,2309,4591
2029,Veracruz,30,Aquila,30018,973,1025,1998
2029,Veracruz,30,Astacinga,30019,3161,3555,6716
2029,Veracruz,30,Atlahuilco,30020,5522,5770,11292
2029,Veracruz,30,Atoyac,30021,12859,13537,26396
2029,Veracruz,30,Atzacan,30022,11215,11525,22740
2029,Veracruz,30,Atzalan,30023,27458,27469,54927
2029,Veracruz,30,Ayahualulco,30025,14035,14222,28257
2029,Veracruz,30,Banderilla,30026,12291,13711,26002
2029,Veracruz,30,Benito Juárez,30027,9307,9955,19262
2029,Veracruz,30,Boca del Río,30028,75917,87087,163004
2029,Veracruz,30,Calcahualco,30029,6705,6775,13480
2029,Veracruz,30,Camarón de Tejeda,30007,3611,3580,7191
2029,Veracruz,30,Camerino Z. Mendoza,30030,21866,24964,46830
2029,Veracruz,30,Carlos A. Carrillo,30208,13444,14789,28233
2029,Veracruz,30,Carrillo Puerto,30031,9076,9186,18262
2029,Veracruz,30,Castillo de Teayo,30157,11095,10832,21927
2029,Veracruz,30,Catemaco,30032,26026,27781,53807
2029,Veracruz,30,Cazones de Herrera,30033,12731,13522,26253
2029,Veracruz,30,Cerro Azul,30034,14351,16359,30710
2029,Veracruz,30,Chacaltianguis,30054,6875,7226,14101
2029,Veracruz,30,Chalma,30055,7393,7697,15090
2029,Veracruz,30,Chiconamel,30056,3528,3803,7331
2029,Veracruz,30,Chiconquiaco,30057,7527,7567,15094
2029,Veracruz,30,Chicontepec,30058,30604,32525,63129
2029,Veracruz,30,Chinameca,30059,8703,9072,17775
2029,Veracruz,30,Chinampa de Gorostiza,30060,9022,9314,18336
2029,Veracruz,30,Chocamán,30062,11251,11216,22467
2029,Veracruz,30,Chontla,30063,8032,8182,16214
2029,Veracruz,30,Chumatlán,30064,2039,2176,4215
2029,Veracruz,30,Citlaltépetl,30035,6455,6790,13245
2029,Veracruz,30,Coacoatzintla,30036,5398,5621,11019
2029,Veracruz,30,Coahuitlán,30037,4416,4565,8981
2029,Veracruz,30,Coatepec,30038,48557,53027,101584
2029,Veracruz,30,Coatzacoalcos,30039,169544,181187,350731
2029,Veracruz,30,Coatzintla,30040,30132,32002,62134
2029,Veracruz,30,Coetzala,30041,1205,1244,2449
2029,Veracruz,30,Colipa,30042,3059,3159,6218
2029,Veracruz,30,Comapa,30043,11173,10627,21800
2029,Veracruz,30,Cosamaloapan de Carpio,30045,31144,34218,65362
2029,Veracruz,30,Cosautlán de Carvajal,30046,8809,8877,17686
2029,Veracruz,30,Coscomatepec,30047,30106,30996,61102
2029,Veracruz,30,Cosoleacaque,30048,70978,75684,146662
2029,Veracruz,30,Cotaxtla,30049,11487,11419,22906
2029,Veracruz,30,Coxquihui,30050,8894,9312,18206
2029,Veracruz,30,Coyutla,30051,11707,12617,24324
2029,Veracruz,30,Cuichapa,30052,6392,6977,13369
2029,Veracruz,30,Cuitláhuac,30053,14711,16068,30779
2029,Veracruz,30,Córdoba,30044,111048,126257,237305
2029,Veracruz,30,El Higo,30205,10922,11067,21989
2029,Veracruz,30,Emiliano Zapata,30065,41994,45090,87084
2029,Veracruz,30,Espinal,30066,14557,15206,29763
2029,Veracruz,30,Filomeno Mata,30067,9568,9602,19170
2029,Veracruz,30,Fortín,30068,34290,38456,72746
2029,Veracruz,30,Gutiérrez Zamora,30069,13073,14810,27883
2029,Veracruz,30,Hidalgotitlán,30070,10737,10253,20990
2029,Veracruz,30,Huatusco,30071,31242,33714,64956
2029,Veracruz,30,Huayacocotla,30072,11299,12092,23391
2029,Veracruz,30,Hueyapan de Ocampo,30073,23147,24343,47490
2029,Veracruz,30,Huiloapan de Cuauhtémoc,30074,3798,4105,7903
2029,Veracruz,30,Ignacio de la Llave,30075,9352,10303,19655
2029,Veracruz,30,Ilamatlán,30076,7010,7778,14788
2029,Veracruz,30,Isla,30077,22896,23828,46724
2029,Veracruz,30,Ixcatepec,30078,7485,7580,15065
2029,Veracruz,30,Ixhuacán de los Reyes,30079,6173,6105,12278
2029,Veracruz,30,Ixhuatlancillo,30081,13187,14439,27626
2029,Veracruz,30,Ixhuatlán de Madero,30083,28912,30642,59554
2029,Veracruz,30,Ixhuatlán del Café,30080,12267,12283,24550
2029,Veracruz,30,Ixhuatlán del Sureste,30082,8557,8407,16964
2029,Veracruz,30,Ixmatlahuacan,30084,3222,3260,6482
2029,Veracruz,30,Ixtaczoquitlán,30085,35938,38177,74115
2029,Veracruz,30,Jalacingo,30086,22628,23806,46434
2029,Veracruz,30,Jalcomulco,30088,2869,2850,5719
2029,Veracruz,30,Jamapa,30090,6145,6452,12597
2029,Veracruz,30,Jesús Carranza,30091,15945,15946,31891
2029,Veracruz,30,Jilotepec,30093,8865,9307,18172
2029,Veracruz,30,José Azueta,30169,12515,12866,25381
2029,Veracruz,30,Juan Rodríguez Clara,30094,21315,21694,43009
2029,Veracruz,30,Juchique de Ferrer,30095,8866,8855,17721
2029,Veracruz,30,Jáltipan,30089,22081,24212,46293
2029,Veracruz,30,La Antigua,30016,14303,15482,29785
2029,Veracruz,30,La Perla,30127,14017,14485,28502
2029,Veracruz,30,Landero y Coss,30096,878,936,1814
2029,Veracruz,30,Las Choapas,30061,43192,44687,87879
2029,Veracruz,30,Las Minas,30107,1606,1561,3167
2029,Veracruz,30,Las Vigas de Ramírez,30132,10385,10542,20927
2029,Veracruz,30,Lerdo de Tejada,30097,10483,12149,22632
2029,Veracruz,30,Los Reyes,30137,3082,3122,6204
2029,Veracruz,30,Magdalena,30098,1602,1634,3236
2029,Veracruz,30,Maltrata,30099,9313,9906,19219
2029,Veracruz,30,Manlio Fabio Altamirano,30100,12856,13330,26186
2029,Veracruz,30,Mariano Escobedo,30101,18552,20027,38579
2029,Veracruz,30,Martínez de la Torre,30102,55497,60567,116064
2029,Veracruz,30,Mecatlán,30103,6417,6638,13055
2029,Veracruz,30,Mecayapan,30104,8986,9270,18256
2029,Veracruz,30,Medellín,30105,41138,44732,85870
2029,Veracruz,30,Miahuatlán,30106,2472,2559,5031
2029,Veracruz,30,Minatitlán,30108,84909,90648,175557
2029,Veracruz,30,Misantla,30109,34752,36436,71188
2029,Veracruz,30,Mixtla de Altamirano,30110,6165,6063,12228
2029,Veracruz,30,Moloacán,30111,9228,9733,18961
2029,Veracruz,30,Nanchital de Lázaro Cárdenas del Rio,30206,15840,16752,32592
2029,Veracruz,30,Naolinco,30112,11643,12152,23795
2029,Veracruz,30,Naranjal,30113,2378,2549,4927
2029,Veracruz,30,Naranjos Amatlán,30013,15089,16969,32058
2029,Veracruz,30,Nautla,30114,6084,6312,12396
2029,Veracruz,30,Nogales,30115,19663,21778,41441
2029,Veracruz,30,Oluta,30116,8594,9290,17884
2029,Veracruz,30,Omealca,30117,12752,13553,26305
2029,Veracruz,30,Orizaba,30118,65288,78302,143590
2029,Veracruz,30,Otatitlán,30119,3019,3310,6329
2029,Veracruz,30,Oteapan,30120,8594,8899,17493
2029,Veracruz,30,Ozuluama de Mascareñas,30121,13376,12830,26206
2029,Veracruz,30,Pajapan,30122,9313,9193,18506
2029,Veracruz,30,Papantla,30124,86330,88147,174477
2029,Veracruz,30,Paso de Ovejas,30126,18627,18812,37439
2029,Veracruz,30,Paso del Macho,30125,17060,17317,34377
2029,Veracruz,30,Perote,30128,38494,39222,77716
2029,Veracruz,30,Platón Sánchez,30129,9922,10358,20280
2029,Veracruz,30,Playa Vicente,30130,20396,21768,42164
2029,Veracruz,30,Poza Rica de Hidalgo,30131,107570,121332,228902
2029,Veracruz,30,Pueblo Viejo,30133,31380,31623,63003
2029,Veracruz,30,Puente Nacional,30134,12358,12704,25062
2029,Veracruz,30,Pánuco,30123,55145,55614,110759
2029,Veracruz,30,Rafael Delgado,30135,11992,12510,24502
2029,Veracruz,30,Rafael Lucio,30136,4175,4436,8611
2029,Veracruz,30,Río Blanco,30138,21978,25179,47157
2029,Veracruz,30,Saltabarranca,30139,3394,3639,7033
2029,Veracruz,30,San Andrés Tenejapan,30140,1507,1589,3096
2029,Veracruz,30,San Andrés Tuxtla,30141,86006,92746,178752
2029,Veracruz,30,San Juan Evangelista,30142,18412,18965,37377
2029,Veracruz,30,San Rafael,30211,16113,16870,32983
2029,Veracruz,30,Santiago Sochiapan,30212,6931,7439,14370
2029,Veracruz,30,Santiago Tuxtla,30143,30587,32864,63451
2029,Veracruz,30,Sayula de Alemán,30144,17510,17911,35421
2029,Veracruz,30,Sochiapa,30146,1933,1946,3879
2029,Veracruz,30,Soconusco,30145,8555,8964,17519
2029,Veracruz,30,Soledad Atzompa,30147,11969,12110,24079
2029,Veracruz,30,Soledad de Doblado,30148,15216,15513,30729
2029,Veracruz,30,Soteapan,30149,17797,18337,36134
2029,Veracruz,30,Tamalín,30150,6455,6437,12892
2029,Veracruz,30,Tamiahua,30151,13334,13322,26656
2029,Veracruz,30,Tampico Alto,30152,7333,6863,14196
2029,Veracruz,30,Tancoco,30153,3167,3388,6555
2029,Veracruz,30,Tantima,30154,7462,7252,14714
2029,Veracruz,30,Tantoyuca,30155,55297,57171,112468
2029,Veracruz,30,Tatahuicapan de Juárez,30209,8434,8660,17094
2029,Veracruz,30,Tatatila,30156,3255,3016,6271
2029,Veracruz,30,Tecolutla,30158,13251,13573,26824
2029,Veracruz,30,Tehuipango,30159,13050,13828,26878
2029,Veracruz,30,Tempoal,30161,19532,20131,39663
2029,Veracruz,30,Tenampa,30162,3604,3687,7291
2029,Veracruz,30,Tenochtitlán,30163,2767,2890,5657
2029,Veracruz,30,Teocelo,30164,8852,9407,18259
2029,Veracruz,30,Tepatlaxco,30165,4714,4406,9120
2029,Veracruz,30,Tepetlán,30166,5400,5186,10586
2029,Veracruz,30,Tepetzintla,30167,7983,8246,16229
2029,Veracruz,30,Tequila,30168,7869,8145,16014
2029,Veracruz,30,Texcatepec,30170,5716,5904,11620
2029,Veracruz,30,Texhuacán,30171,2732,2981,5713
2029,Veracruz,30,Texistepec,30172,11443,11339,22782
2029,Veracruz,30,Tezonapa,30173,30623,31285,61908
2029,Veracruz,30,Tierra Blanca,30174,56331,60645,116976
2029,Veracruz,30,Tihuatlán,30175,51354,53556,104910
2029,Veracruz,30,Tlachichilco,30180,6262,6408,12670
2029,Veracruz,30,Tlacojalpan,30176,2708,2801,5509
2029,Veracruz,30,Tlacolulan,30177,6034,5846,11880
2029,Veracruz,30,Tlacotalpan,30178,7274,8032,15306
2029,Veracruz,30,Tlacotepec de Mejía,30179,2135,2175,4310
2029,Veracruz,30,Tlalixcoyan,30181,20949,21682,42631
2029,Veracruz,30,Tlalnelhuayocan,30182,9706,10054,19760
2029,Veracruz,30,Tlaltetela,30024,8489,8222,16711
2029,Veracruz,30,Tlapacoyan,30183,32486,34448,66934
2029,Veracruz,30,Tlaquilpa,30184,3776,4284,8060
2029,Veracruz,30,Tlilapan,30185,2728,2884,5612
2029,Veracruz,30,Tomatlán,30186,3765,3864,7629
2029,Veracruz,30,Tonayán,30187,2928,3109,6037
2029,Veracruz,30,Totutla,30188,9431,9469,18900
2029,Veracruz,30,Tres Valles,30207,24938,26148,51086
2029,Veracruz,30,Tuxpan,30189,85970,91332,177302
2029,Veracruz,30,Tuxtilla,30190,1265,1306,2571
2029,Veracruz,30,Ursulo Galván,30191,16853,17895,34748
2029,Veracruz,30,Uxpanapa,30210,15941,15316,31257
2029,Veracruz,30,Vega de Alatorre,30192,10970,11643,22613
2029,Veracruz,30,Veracruz,30193,308847,340710,649557
2029,Veracruz,30,Villa Aldama,30194,6087,6280,12367
2029,Veracruz,30,Xalapa,30087,247041,281980,529021
2029,Veracruz,30,Xico,30092,20297,21047,41344
2029,Veracruz,30,Xoxocotla,30195,2917,2821,5738
2029,Veracruz,30,Yanga,30196,9440,10682,20122
2029,Veracruz,30,Yecuatla,30197,6646,6786,13432
2029,Veracruz,30,Zacualpan,30198,3851,4118,7969
2029,Veracruz,30,Zaragoza,30199,5846,6059,11905
2029,Veracruz,30,Zentla,30200,7449,7274,14723
2029,Veracruz,30,Zongolica,30201,23150,23600,46750
2029,Veracruz,30,Zontecomatlán de López y Fuentes,30202,7608,7891,15499
2029,Veracruz,30,Zozocolco de Hidalgo,30203,7990,8329,16319
2029,Veracruz,30,Álamo Temapache,30160,57678,58417,116095
2029,Yucatán,31,Abalá,31001,3921,3726,7647
2029,Yucatán,31,Acanceh,31002,9464,9452,18916
2029,Yucatán,31,Akil,31003,6231,6469,12700
2029,Yucatán,31,Baca,31004,3542,3642,7184
2029,Yucatán,31,Bokobá,31005,1334,1290,2624
2029,Yucatán,31,Buctzotz,31006,5292,5270,10562
2029,Yucatán,31,Cacalchén,31007,4407,4181,8588
2029,Yucatán,31,Calotmul,31008,2435,2427,4862
2029,Yucatán,31,Cansahcab,31009,2796,2885,5681
2029,Yucatán,31,Cantamayec,31010,1509,1385,2894
2029,Yucatán,31,Celestún,31011,4566,4307,8873
2029,Yucatán,31,Cenotillo,31012,2316,2456,4772
2029,Yucatán,31,Chacsinkín,31016,1728,1683,3411
2029,Yucatán,31,Chankom,31017,2716,2616,5332
2029,Yucatán,31,Chapab,31018,1891,1863,3754
2029,Yucatán,31,Chemax,31019,20569,20224,40793
2029,Yucatán,31,Chichimilá,31021,4799,4743,9542
2029,Yucatán,31,Chicxulub Pueblo,31020,2701,2574,5275
2029,Yucatán,31,Chikindzonot,31022,2396,2323,4719
2029,Yucatán,31,Chocholá,31023,2846,2768,5614
2029,Yucatán,31,Chumayel,31024,1908,1934,3842
2029,Yucatán,31,Conkal,31013,6546,6541,13087
2029,Yucatán,31,Cuncunul,31014,959,923,1882
2029,Yucatán,31,Cuzamá,31015,3042,2956,5998
2029,Yucatán,31,Dzemul,31026,2259,2255,4514
2029,Yucatán,31,Dzidzantún,31027,5052,4917,9969
2029,Yucatán,31,Dzilam González,31029,3757,3552,7309
2029,Yucatán,31,Dzilam de Bravo,31028,1655,1543,3198
2029,Yucatán,31,Dzitás,31030,2292,2194,4486
2029,Yucatán,31,Dzoncauich,31031,1585,1617,3202
2029,Yucatán,31,Dzán,31025,3037,3142,6179
2029,Yucatán,31,Espita,31032,9447,9230,18677
2029,Yucatán,31,Halachó,31033,11945,11678,23623
2029,Yucatán,31,Hocabá,31034,3651,3638,7289
2029,Yucatán,31,Hoctún,31035,3492,3577,7069
2029,Yucatán,31,Homún,31036,4562,4380,8942
2029,Yucatán,31,Huhí,31037,3133,3011,6144
2029,Yucatán,31,Hunucmá,31038,18778,18875,37653
2029,Yucatán,31,Ixil,31039,2414,2348,4762
2029,Yucatán,31,Izamal,31040,15768,16145,31913
2029,Yucatán,31,Kanasín,31041,57196,58126,115322
2029,Yucatán,31,Kantunil,31042,3127,3270,6397
2029,Yucatán,31,Kaua,31043,1788,1726,3514
2029,Yucatán,31,Kinchil,31044,4194,4097,8291
2029,Yucatán,31,Kopomá,31045,1560,1477,3037
2029,Yucatán,31,Mama,31046,1785,1914,3699
2029,Yucatán,31,Maní,31047,3215,3354,6569
2029,Yucatán,31,Maxcanú,31048,13333,13117,26450
2029,Yucatán,31,Mayapán,31049,2122,1975,4097
2029,Yucatán,31,Mocochá,31051,1970,1937,3907
2029,Yucatán,31,Motul,31052,21249,21659,42908
2029,Yucatán,31,Muna,31053,7382,7597,14979
2029,Yucatán,31,Muxupip,31054,1675,1744,3419
2029,Yucatán,31,Mérida,31050,507996,553844,1061840
2029,Yucatán,31,Opichén,31055,3994,3845,7839
2029,Yucatán,31,Oxkutzcab,31056,17183,18585,35768
2029,Yucatán,31,Panabá,31057,4563,4599,9162
2029,Yucatán,31,Peto,31058,14521,14713,29234
2029,Yucatán,31,Progreso,31059,34206,34729,68935
2029,Yucatán,31,Quintana Roo,31060,583,581,1164
2029,Yucatán,31,Río Lagartos,31061,2164,2029,4193
2029,Yucatán,31,Sacalum,31062,2870,2739,5609
2029,Yucatán,31,Samahil,31063,3033,2998,6031
2029,Yucatán,31,San Felipe,31065,1184,1102,2286
2029,Yucatán,31,Sanahcat,31064,1026,1014,2040
2029,Yucatán,31,Santa Elena,31066,2265,2348,4613
2029,Yucatán,31,Seyé,31067,5770,5493,11263
2029,Yucatán,31,Sinanché,31068,1998,1845,3843
2029,Yucatán,31,Sotuta,31069,5290,5104,10394
2029,Yucatán,31,Sucilá,31070,2388,2294,4682
2029,Yucatán,31,Sudzal,31071,1051,954,2005
2029,Yucatán,31,Suma,31072,1146,1121,2267
2029,Yucatán,31,Tahdziú,31073,2873,2719,5592
2029,Yucatán,31,Tahmek,31074,2310,2238,4548
2029,Yucatán,31,Teabo,31075,3794,3787,7581
2029,Yucatán,31,Tecoh,31076,10272,10223,20495
2029,Yucatán,31,Tekal de Venegas,31077,1601,1552,3153
2029,Yucatán,31,Tekantó,31078,2283,2311,4594
2029,Yucatán,31,Tekax,31079,24159,24874,49033
2029,Yucatán,31,Tekit,31080,5980,5817,11797
2029,Yucatán,31,Tekom,31081,1841,1890,3731
2029,Yucatán,31,Telchac Pueblo,31082,2331,2314,4645
2029,Yucatán,31,Telchac Puerto,31083,1098,1001,2099
2029,Yucatán,31,Temax,31084,4346,4325,8671
2029,Yucatán,31,Temozón,31085,9011,8785,17796
2029,Yucatán,31,Tepakán,31086,1386,1333,2719
2029,Yucatán,31,Tetiz,31087,2935,2920,5855
2029,Yucatán,31,Teya,31088,1185,1187,2372
2029,Yucatán,31,Ticul,31089,22941,23658,46599
2029,Yucatán,31,Timucuy,31090,4337,4173,8510
2029,Yucatán,31,Tinum,31091,6969,6760,13729
2029,Yucatán,31,Tixcacalcupul,31092,4081,4023,8104
2029,Yucatán,31,Tixkokob,31093,10603,10831,21434
2029,Yucatán,31,Tixmehuac,31094,2807,2806,5613
2029,Yucatán,31,Tixpéhual,31095,3238,3354,6592
2029,Yucatán,31,Tizimín,31096,44234,45548,89782
2029,Yucatán,31,Tunkás,31097,2160,2070,4230
2029,Yucatán,31,Tzucacab,31098,8557,8408,16965
2029,Yucatán,31,Uayma,31099,2402,2307,4709
2029,Yucatán,31,Ucú,31100,2184,2144,4328
2029,Yucatán,31,Umán,31101,31223,31215,62438
2029,Yucatán,31,Valladolid,31102,45499,46433,91932
2029,Yucatán,31,Xocchel,31103,2092,2012,4104
2029,Yucatán,31,Yaxcabá,31104,9060,8530,17590
2029,Yucatán,31,Yaxkukul,31105,1851,1864,3715
2029,Yucatán,31,Yobaín,31106,1402,1347,2749
2029,Zacatecas,32,Apozol,32001,3326,3574,6900
2029,Zacatecas,32,Apulco,32002,2582,2844,5426
2029,Zacatecas,32,Atolinga,32003,1421,1550,2971
2029,Zacatecas,32,Benito Juárez,32004,2315,2290,4605
2029,Zacatecas,32,Calera,32005,24252,24207,48459
2029,Zacatecas,32,Cañitas de Felipe Pescador,32006,4591,4696,9287
2029,Zacatecas,32,Chalchihuites,32009,6311,6646,12957
2029,Zacatecas,32,Concepción del Oro,32007,7566,7478,15044
2029,Zacatecas,32,Cuauhtémoc,32008,6737,7098,13835
2029,Zacatecas,32,El Plateado de Joaquín Amaro,32015,683,723,1406
2029,Zacatecas,32,El Salvador,32041,1398,1369,2767
2029,Zacatecas,32,Fresnillo,32010,125102,128993,254095
2029,Zacatecas,32,Genaro Codina,32012,4424,4586,9010
2029,Zacatecas,32,General Enrique Estrada,32013,3445,3497,6942
2029,Zacatecas,32,General Francisco R. Murguía,32014,11984,12595,24579
2029,Zacatecas,32,General Pánfilo Natera,32016,12532,13040,25572
2029,Zacatecas,32,Guadalupe,32017,100718,105791,206509
2029,Zacatecas,32,Huanusco,32018,2291,2441,4732
2029,Zacatecas,32,Jalpa,32019,13267,13959,27226
2029,Zacatecas,32,Jerez,32020,32865,35257,68122
2029,Zacatecas,32,Jiménez del Teul,32021,2326,2399,4725
2029,Zacatecas,32,Juan Aldama,32022,11752,12429,24181
2029,Zacatecas,32,Juchipila,32023,6844,7730,14574
2029,Zacatecas,32,Loreto,32024,29148,29587,58735
2029,Zacatecas,32,Luis Moya,32025,7330,7423,14753
2029,Zacatecas,32,Mazapil,32026,10450,9575,20025
2029,Zacatecas,32,Melchor Ocampo,32027,1813,1577,3390
2029,Zacatecas,32,Mezquital del Oro,32028,1371,1485,2856
2029,Zacatecas,32,Miguel Auza,32029,12753,13292,26045
2029,Zacatecas,32,Momax,32030,1343,1469,2812
2029,Zacatecas,32,Monte Escobedo,32031,5250,5473,10723
2029,Zacatecas,32,Morelos,32032,6847,6907,13754
2029,Zacatecas,32,Moyahua de Estrada,32033,2197,2548,4745
2029,Zacatecas,32,Nochistlán de Mejía,32034,15092,16811,31903
2029,Zacatecas,32,Noria de Ángeles,32035,9138,9364,18502
2029,Zacatecas,32,Ojocaliente,32036,23094,24011,47105
2029,Zacatecas,32,Pinos,32038,39446,41180,80626
2029,Zacatecas,32,Pánuco,32037,9810,9764,19574
2029,Zacatecas,32,Río Grande,32039,34772,36899,71671
2029,Zacatecas,32,Sain Alto,32040,12017,12624,24641
2029,Zacatecas,32,Santa María de la Paz,32058,1477,1526,3003
2029,Zacatecas,32,Sombrerete,32042,34239,35269,69508
2029,Zacatecas,32,Susticacán,32043,753,827,1580
2029,Zacatecas,32,Tabasco,32044,8462,8969,17431
2029,Zacatecas,32,Tepechitlán,32045,4753,5228,9981
2029,Zacatecas,32,Tepetongo,32046,4070,4404,8474
2029,Zacatecas,32,Teúl de González Ortega,32047,2789,2964,5753
2029,Zacatecas,32,Tlaltenango de Sánchez Román,32048,14528,15297,29825
2029,Zacatecas,32,Trancoso,32057,10484,10741,21225
2029,Zacatecas,32,Trinidad García de la Cadena,32011,1621,1710,3331
2029,Zacatecas,32,Valparaíso,32049,18566,19379,37945
2029,Zacatecas,32,Vetagrande,32050,5424,5534,10958
2029,Zacatecas,32,Villa García,32052,10422,10523,20945
2029,Zacatecas,32,Villa González Ortega,32053,7140,7549,14689
2029,Zacatecas,32,Villa Hidalgo,32054,10439,10573,21012
2029,Zacatecas,32,Villa de Cos,32051,19759,19416,39175
2029,Zacatecas,32,Villanueva,32055,16822,17677,34499
2029,Zacatecas,32,Zacatecas,32056,79117,84551,163668
2030,Aguascalientes,01,Aguascalientes,01001,529384,552782,1082166
2030,Aguascalientes,01,Asientos,01002,28324,28374,56698
2030,Aguascalientes,01,Calvillo,01003,34521,35544,70065
2030,Aguascalientes,01,Cosío,01004,9327,9529,18856
2030,Aguascalientes,01,El Llano,01010,12404,12103,24507
2030,Aguascalientes,01,Jesús María,01005,71212,70045,141257
2030,Aguascalientes,01,Pabellón de Arteaga,01006,26997,28161,55158
2030,Aguascalientes,01,Rincón de Romos,01007,32014,32186,64200
2030,Aguascalientes,01,San Francisco de los Romo,01011,27346,27344,54690
2030,Aguascalientes,01,San José de Gracia,01008,5327,5561,10888
2030,Aguascalientes,01,Tepezalá,01009,12717,12881,25598
2030,Baja California,02,Ensenada,02001,305218,307913,613131
2030,Baja California,02,Mexicali,02002,626814,636042,1262856
2030,Baja California,02,Playas de Rosarito,02005,61247,60752,121999
2030,Baja California,02,Tecate,02003,65787,63516,129303
2030,Baja California,02,Tijuana,02004,1000094,1010966,2011060
2030,Baja California Sur,03,Comondú,03001,52573,51528,104101
2030,Baja California Sur,03,La Paz,03003,180981,184553,365534
2030,Baja California Sur,03,Loreto,03009,13648,12637,26285
2030,Baja California Sur,03,Los Cabos,03008,195175,184226,379401
2030,Baja California Sur,03,Mulegé,03002,41690,39194,80884
2030,Campeche,04,Calakmul,04010,18160,17276,35436
2030,Campeche,04,Calkiní,04001,36079,37535,73614
2030,Campeche,04,Campeche,04002,177295,191886,369181
2030,Campeche,04,Candelaria,04011,28455,27394,55849
2030,Campeche,04,Carmen,04003,157013,157805,314818
2030,Campeche,04,Champotón,04004,58946,57797,116743
2030,Campeche,04,Escárcega,04009,36571,36734,73305
2030,Campeche,04,Hecelchakán,04005,19856,20045,39901
2030,Campeche,04,Hopelchén,04006,26424,25097,51521
2030,Campeche,04,Palizada,04007,5873,5739,11612
2030,Campeche,04,Tenabo,04008,7029,6715,13744
2030,Chiapas,07,Acacoyagua,07001,11410,11207,22617
2030,Chiapas,07,Acala,07002,19643,20195,39838
2030,Chiapas,07,Acapetahua,07003,18191,18120,36311
2030,Chiapas,07,Aldama,07113,3858,4215,8073
2030,Chiapas,07,Altamirano,07004,19997,19922,39919
2030,Chiapas,07,Amatenango de la Frontera,07006,18974,19850,38824
2030,Chiapas,07,Amatenango del Valle,07007,5748,6300,12048
2030,Chiapas,07,Amatán,07005,12434,12042,24476
2030,Chiapas,07,Angel Albino Corzo,07008,17546,17616,35162
2030,Chiapas,07,Arriaga,07009,25219,27238,52457
2030,Chiapas,07,Bejucal de Ocampo,07010,4765,4743,9508
2030,Chiapas,07,Bella Vista,07011,12695,12721,25416
2030,Chiapas,07,Benemérito de las Américas,07114,12718,12428,25146
2030,Chiapas,07,Berriozábal,07012,31713,32275,63988
2030,Chiapas,07,Bochil,07013,20755,21315,42070
2030,Chiapas,07,Cacahoatán,07015,28458,29870,58328
2030,Chiapas,07,Catazajá,07016,11315,11229,22544
2030,Chiapas,07,Chalchihuitán,07022,9732,9890,19622
2030,Chiapas,07,Chamula,07023,48757,57385,106142
2030,Chiapas,07,Chanal,07024,7327,7393,14720
2030,Chiapas,07,Chapultenango,07025,4722,4710,9432
2030,Chiapas,07,Chenalhó,07026,23983,24529,48512
2030,Chiapas,07,Chiapa de Corzo,07027,61819,64646,126465
2030,Chiapas,07,Chiapilla,07028,3773,3672,7445
2030,Chiapas,07,Chicoasén,07029,3187,3198,6385
2030,Chiapas,07,Chicomuselo,07030,21801,21979,43780
2030,Chiapas,07,Chilón,07031,76222,77988,154210
2030,Chiapas,07,Cintalapa,07017,53287,54843,108130
2030,Chiapas,07,Coapilla,07018,5605,5756,11361
2030,Chiapas,07,Comitán de Domínguez,07019,91838,101781,193619
2030,Chiapas,07,Copainalá,07021,13506,14142,27648
2030,Chiapas,07,El Bosque,07014,13161,14055,27216
2030,Chiapas,07,El Porvenir,07070,8743,8882,17625
2030,Chiapas,07,Escuintla,07032,19749,20256,40005
2030,Chiapas,07,Francisco León,07033,4675,4488,9163
2030,Chiapas,07,Frontera Comalapa,07034,45004,47114,92118
2030,Chiapas,07,Frontera Hidalgo,07035,8819,9335,18154
2030,Chiapas,07,Huehuetán,07037,21678,22770,44448
2030,Chiapas,07,Huitiupán,07039,14183,14031,28214
2030,Chiapas,07,Huixtla,07040,33251,35857,69108
2030,Chiapas,07,Huixtán,07038,14315,14941,29256
2030,Chiapas,07,Ixhuatán,07042,6904,7033,13937
2030,Chiapas,07,Ixtacomitán,07043,6640,6785,13425
2030,Chiapas,07,Ixtapa,07044,16451,16779,33230
2030,Chiapas,07,Ixtapangajoya,07045,3472,3409,6881
2030,Chiapas,07,Jiquipilas,07046,25233,26186,51419
2030,Chiapas,07,Jitotol,07047,12547,12318,24865
2030,Chiapas,07,Juárez,07048,13658,14075,27733
2030,Chiapas,07,La Concordia,07020,29255,28678,57933
2030,Chiapas,07,La Grandeza,07036,4386,4520,8906
2030,Chiapas,07,La Independencia,07041,27565,28670,56235
2030,Chiapas,07,La Libertad,07050,3185,3299,6484
2030,Chiapas,07,La Trinitaria,07099,48405,50523,98928
2030,Chiapas,07,Larráinzar,07049,13986,14525,28511
2030,Chiapas,07,Las Margaritas,07052,75360,76855,152215
2030,Chiapas,07,Las Rosas,07075,17206,17777,34983
2030,Chiapas,07,Mapastepec,07051,29661,30485,60146
2030,Chiapas,07,Maravilla Tenejapa,07115,7974,7765,15739
2030,Chiapas,07,Marqués de Comillas,07116,7304,7087,14391
2030,Chiapas,07,Mazapa de Madero,07053,4906,5117,10023
2030,Chiapas,07,Mazatán,07054,18274,18916,37190
2030,Chiapas,07,Metapa,07055,3439,3750,7189
2030,Chiapas,07,Mitontic,07056,7148,7250,14398
2030,Chiapas,07,Montecristo de Guerrero,07117,4618,4547,9165
2030,Chiapas,07,Motozintla,07057,44575,46138,90713
2030,Chiapas,07,Nicolás Ruíz,07058,2716,2568,5284
2030,Chiapas,07,Ocosingo,07059,131724,132758,264482
2030,Chiapas,07,Ocotepec,07060,7381,7779,15160
2030,Chiapas,07,Ocozocoautla de Espinosa,07061,55631,57420,113051
2030,Chiapas,07,Ostuacán,07062,11576,11410,22986
2030,Chiapas,07,Osumacinta,07063,2332,2331,4663
2030,Chiapas,07,Oxchuc,07064,28926,28863,57789
2030,Chiapas,07,Palenque,07065,72639,74675,147314
2030,Chiapas,07,Pantelhó,07066,13111,13347,26458
2030,Chiapas,07,Pantepec,07067,7399,7561,14960
2030,Chiapas,07,Pichucalco,07068,19707,20311,40018
2030,Chiapas,07,Pijijiapan,07069,33702,34609,68311
2030,Chiapas,07,Pueblo Nuevo Solistahuacán,07072,18482,20182,38664
2030,Chiapas,07,Rayón,07073,5828,5968,11796
2030,Chiapas,07,Reforma,07074,28121,28550,56671
2030,Chiapas,07,Sabanilla,07076,16506,16383,32889
2030,Chiapas,07,Salto de Agua,07077,38594,39110,77704
2030,Chiapas,07,San Andrés Duraznal,07118,3352,3546,6898
2030,Chiapas,07,San Cristóbal de las Casas,07078,121676,136933,258609
2030,Chiapas,07,San Fernando,07079,24668,24134,48802
2030,Chiapas,07,San Juan Cancuc,07112,20456,21363,41819
2030,Chiapas,07,San Lucas,07110,4432,4459,8891
2030,Chiapas,07,Santiago el Pinar,07119,2179,2132,4311
2030,Chiapas,07,Siltepec,07080,22723,21926,44649
2030,Chiapas,07,Simojovel,07081,26420,27005,53425
2030,Chiapas,07,Sitalá,07082,8435,8580,17015
2030,Chiapas,07,Socoltenango,07083,11503,11521,23024
2030,Chiapas,07,Solosuchiapa,07084,5040,4977,10017
2030,Chiapas,07,Soyaló,07085,6644,6618,13262
2030,Chiapas,07,Suchiapa,07086,14973,15081,30054
2030,Chiapas,07,Suchiate,07087,23451,24631,48082
2030,Chiapas,07,Sunuapa,07088,1496,1493,2989
2030,Chiapas,07,Tapachula,07089,210658,232714,443372
2030,Chiapas,07,Tapalapa,07090,2427,2578,5005
2030,Chiapas,07,Tapilula,07091,7876,8340,16216
2030,Chiapas,07,Tecpatán,07092,26054,26325,52379
2030,Chiapas,07,Tenejapa,07093,25510,27119,52629
2030,Chiapas,07,Teopisca,07094,25317,26892,52209
2030,Chiapas,07,Tila,07096,48029,48184,96213
2030,Chiapas,07,Tonalá,07097,56091,58121,114212
2030,Chiapas,07,Totolapa,07098,4458,4416,8874
2030,Chiapas,07,Tumbalá,07100,20506,21718,42224
2030,Chiapas,07,Tuxtla Chico,07102,25909,27718,53627
2030,Chiapas,07,Tuxtla Gutiérrez,07101,356767,399083,755850
2030,Chiapas,07,Tuzantán,07103,19908,20456,40364
2030,Chiapas,07,Tzimol,07104,9506,9956,19462
2030,Chiapas,07,Unión Juárez,07105,9648,10139,19787
2030,Chiapas,07,Venustiano Carranza,07106,40384,40864,81248
2030,Chiapas,07,Villa Comaltitlán,07071,18152,18436,36588
2030,Chiapas,07,Villa Corzo,07107,48576,50105,98681
2030,Chiapas,07,Villaflores,07108,65217,68511,133728
2030,Chiapas,07,Yajalón,07109,22842,24045,46887
2030,Chiapas,07,Zinacantán,07111,23175,26593,49768
2030,Chihuahua,08,Ahumada,08001,7194,7006,14200
2030,Chihuahua,08,Aldama,08002,14244,14337,28581
2030,Chihuahua,08,Allende,08003,5613,5487,11100
2030,Chihuahua,08,Aquiles Serdán,08004,9720,9663,19383
2030,Chihuahua,08,Ascensión,08005,14225,13882,28107
2030,Chihuahua,08,Bachíniva,08006,4110,3955,8065
2030,Chihuahua,08,Balleza,08007,9803,9470,19273
2030,Chihuahua,08,Batopilas,08008,6832,6775,13607
2030,Chihuahua,08,Bocoyna,08009,15781,16427,32208
2030,Chihuahua,08,Buenaventura,08010,13743,13359,27102
2030,Chihuahua,08,Camargo,08011,30180,31327,61507
2030,Chihuahua,08,Carichí,08012,5809,5574,11383
2030,Chihuahua,08,Casas Grandes,08013,7022,6639,13661
2030,Chihuahua,08,Chihuahua,08019,497334,530800,1028134
2030,Chihuahua,08,Chínipas,08020,4842,4390,9232
2030,Chihuahua,08,Coronado,08014,1473,1353,2826
2030,Chihuahua,08,Coyame del Sotol,08015,1201,980,2181
2030,Chihuahua,08,Cuauhtémoc,08017,94663,101298,195961
2030,Chihuahua,08,Cusihuiriachi,08018,3139,2892,6031
2030,Chihuahua,08,Delicias,08021,85094,90195,175289
2030,Chihuahua,08,Dr. Belisario Domínguez,08022,1911,1825,3736
2030,Chihuahua,08,El Tule,08064,1148,1093,2241
2030,Chihuahua,08,Galeana,08023,3674,3686,7360
2030,Chihuahua,08,Gran Morelos,08026,1843,1785,3628
2030,Chihuahua,08,Guachochi,08027,25809,26936,52745
2030,Chihuahua,08,Guadalupe,08028,2560,2533,5093
2030,Chihuahua,08,Guadalupe y Calvo,08029,30793,30119,60912
2030,Chihuahua,08,Guazapares,08030,4895,4690,9585
2030,Chihuahua,08,Guerrero,08031,24285,23810,48095
2030,Chihuahua,08,Gómez Farías,08025,5617,5558,11175
2030,Chihuahua,08,Hidalgo del Parral,08032,62430,67072,129502
2030,Chihuahua,08,Huejotitán,08033,662,662,1324
2030,Chihuahua,08,Ignacio Zaragoza,08034,4494,4367,8861
2030,Chihuahua,08,Janos,08035,6799,6220,13019
2030,Chihuahua,08,Jiménez,08036,24932,25456,50388
2030,Chihuahua,08,Julimes,08038,2919,2829,5748
2030,Chihuahua,08,Juárez,08037,769403,775569,1544972
2030,Chihuahua,08,La Cruz,08016,2469,2346,4815
2030,Chihuahua,08,López,08039,2661,2449,5110
2030,Chihuahua,08,Madera,08040,17751,17473,35224
2030,Chihuahua,08,Maguarichi,08041,980,916,1896
2030,Chihuahua,08,Manuel Benavides,08042,1058,894,1952
2030,Chihuahua,08,Matachí,08043,1978,1972,3950
2030,Chihuahua,08,Matamoros,08044,2876,2751,5627
2030,Chihuahua,08,Meoqui,08045,26298,26891,53189
2030,Chihuahua,08,Morelos,08046,4448,4374,8822
2030,Chihuahua,08,Moris,08047,3168,2967,6135
2030,Chihuahua,08,Namiquipa,08048,15403,14750,30153
2030,Chihuahua,08,Nonoava,08049,1711,1605,3316
2030,Chihuahua,08,Nuevo Casas Grandes,08050,35861,37617,73478
2030,Chihuahua,08,Ocampo,08051,4497,4186,8683
2030,Chihuahua,08,Ojinaga,08052,16750,16514,33264
2030,Chihuahua,08,Praxedis G. Guerrero,08053,3073,2968,6041
2030,Chihuahua,08,Riva Palacio,08054,4761,4550,9311
2030,Chihuahua,08,Rosales,08055,10322,10168,20490
2030,Chihuahua,08,Rosario,08056,1386,1308,2694
2030,Chihuahua,08,San Francisco de Borja,08057,1572,1477,3049
2030,Chihuahua,08,San Francisco de Conchos,08058,1712,1622,3334
2030,Chihuahua,08,San Francisco del Oro,08059,3362,3364,6726
2030,Chihuahua,08,Santa Bárbara,08060,6684,6858,13542
2030,Chihuahua,08,Santa Isabel,08024,2548,2577,5125
2030,Chihuahua,08,Satevó,08061,2246,2094,4340
2030,Chihuahua,08,Saucillo,08062,19265,19174,38439
2030,Chihuahua,08,Temósachic,08063,4255,4062,8317
2030,Chihuahua,08,Urique,08065,12289,11863,24152
2030,Chihuahua,08,Uruachi,08066,3409,3206,6615
2030,Chihuahua,08,Valle de Zaragoza,08067,3486,3307,6793
2030,Ciudad de México,09,Azcapotzalco,09002,192482,218508,410990
2030,Ciudad de México,09,Benito Juárez,09014,200299,240423,440722
2030,Ciudad de México,09,Coyoacán,09003,291314,333194,624508
2030,Ciudad de México,09,Cuajimalpa de Morelos,09004,89395,95154,184549
2030,Ciudad de México,09,Cuauhtémoc,09015,257048,289137,546185
2030,Ciudad de México,09,Gustavo A. Madero,09005,556795,607472,1164267
2030,Ciudad de México,09,Iztacalco,09006,185109,206728,391837
2030,Ciudad de México,09,Iztapalapa,09007,836196,887511,1723707
2030,Ciudad de México,09,La Magdalena Contreras,09008,112563,121472,234035
2030,Ciudad de México,09,Miguel Hidalgo,09016,174803,205987,380790
2030,Ciudad de México,09,Milpa Alta,09009,62025,64312,126337
2030,Ciudad de México,09,Tlalpan,09012,311017,339570,650587
2030,Ciudad de México,09,Tláhuac,09011,163464,174864,338328
2030,Ciudad de México,09,Venustiano Carranza,09017,203588,231633,435221
2030,Ciudad de México,09,Xochimilco,09013,190949,200666,391615
2030,Ciudad de México,09,Álvaro Obregón,09010,347824,381918,729742
2030,Coahuila,05,Abasolo,05001,705,688,1393
2030,Coahuila,05,Acuña,05002,88681,87597,176278
2030,Coahuila,05,Allende,05003,13866,14176,28042
2030,Coahuila,05,Arteaga,05004,14925,14156,29081
2030,Coahuila,05,Candela,05005,1208,1105,2313
2030,Coahuila,05,Castaños,05006,17349,17236,34585
2030,Coahuila,05,Cuatro Ciénegas,05007,8512,8311,16823
2030,Coahuila,05,Escobedo,05008,1992,1895,3887
2030,Coahuila,05,Francisco I. Madero,05009,36719,36735,73454
2030,Coahuila,05,Frontera,05010,49766,49360,99126
2030,Coahuila,05,General Cepeda,05011,8270,7510,15780
2030,Coahuila,05,Guerrero,05012,1239,1089,2328
2030,Coahuila,05,Hidalgo,05013,1063,1009,2072
2030,Coahuila,05,Jiménez,05014,6395,6113,12508
2030,Coahuila,05,Juárez,05015,1054,954,2008
2030,Coahuila,05,Lamadrid,05016,1225,1157,2382
2030,Coahuila,05,Matamoros,05017,67461,67075,134536
2030,Coahuila,05,Monclova,05018,141529,144317,285846
2030,Coahuila,05,Morelos,05019,5435,5317,10752
2030,Coahuila,05,Múzquiz,05020,43964,43153,87117
2030,Coahuila,05,Nadadores,05021,4182,4074,8256
2030,Coahuila,05,Nava,05022,18761,17722,36483
2030,Coahuila,05,Ocampo,05023,6856,6239,13095
2030,Coahuila,05,Parras,05024,28426,27170,55596
2030,Coahuila,05,Piedras Negras,05025,98400,97927,196327
2030,Coahuila,05,Progreso,05026,2229,2069,4298
2030,Coahuila,05,Ramos Arizpe,05027,57444,54898,112342
2030,Coahuila,05,Sabinas,05028,39543,39504,79047
2030,Coahuila,05,Sacramento,05029,1529,1468,2997
2030,Coahuila,05,Saltillo,05030,481386,485790,967176
2030,Coahuila,05,San Buenaventura,05031,14869,14866,29735
2030,Coahuila,05,San Juan de Sabinas,05032,26928,28325,55253
2030,Coahuila,05,San Pedro,05033,67399,67467,134866
2030,Coahuila,05,Sierra Mojada,05034,4765,4320,9085
2030,Coahuila,05,Torreón,05035,409612,431901,841513
2030,Coahuila,05,Viesca,05036,13997,13373,27370
2030,Coahuila,05,Villa Unión,05037,4051,3834,7885
2030,Coahuila,05,Zaragoza,05038,8166,8066,16232
2030,Colima,06,Armería,06001,19250,18741,37991
2030,Colima,06,Colima,06002,96378,102027,198405
2030,Colima,06,Comala,06003,13963,13765,27728
2030,Colima,06,Coquimatlán,06004,13083,12676,25759
2030,Colima,06,Cuauhtémoc,06005,19546,19148,38694
2030,Colima,06,Ixtlahuacán,06006,3675,3554,7229
2030,Colima,06,Manzanillo,06007,116192,112526,228718
2030,Colima,06,Minatitlán,06008,5955,5382,11337
2030,Colima,06,Tecomán,06009,77498,75440,152938
2030,Colima,06,Villa de Álvarez,06010,81767,85304,167071
2030,Durango,10,Canatlán,10001,19066,19539,38605
2030,Durango,10,Canelas,10002,2680,2478,5158
2030,Durango,10,Coneto de Comonfort,10003,2574,2554,5128
2030,Durango,10,Cuencamé,10004,20679,20328,41007
2030,Durango,10,Durango,10005,357366,384551,741917
2030,Durango,10,El Oro,10018,6993,7139,14132
2030,Durango,10,General Simón Bolívar,10006,6023,6029,12052
2030,Durango,10,Guadalupe Victoria,10008,20394,20847,41241
2030,Durango,10,Guanaceví,10009,6018,5641,11659
2030,Durango,10,Gómez Palacio,10007,194732,200148,394880
2030,Durango,10,Hidalgo,10010,2431,2368,4799
2030,Durango,10,Indé,10011,3216,3154,6370
2030,Durango,10,Lerdo,10012,87039,88187,175226
2030,Durango,10,Mapimí,10013,15285,15201,30486
2030,Durango,10,Mezquital,10014,20317,21064,41381
2030,Durango,10,Nazas,10015,7746,7705,15451
2030,Durango,10,Nombre de Dios,10016,11547,11553,23100
2030,Durango,10,Nuevo Ideal,10039,15691,15896,31587
2030,Durango,10,Ocampo,10017,6063,5835,11898
2030,Durango,10,Otáez,10019,3036,2793,5829
2030,Durango,10,Peñón Blanco,10021,6447,6314,12761
2030,Durango,10,Poanas,10022,14777,14993,29770
2030,Durango,10,Pueblo Nuevo,10023,27563,27747,55310
2030,Durango,10,Pánuco de Coronado,10020,7207,7355,14562
2030,Durango,10,Rodeo,10024,8056,8004,16060
2030,Durango,10,San Bernardo,10025,2197,1945,4142
2030,Durango,10,San Dimas,10026,11205,10532,21737
2030,Durango,10,San Juan de Guadalupe,10027,3280,3401,6681
2030,Durango,10,San Juan del Río,10028,7415,7457,14872
2030,Durango,10,San Luis del Cordero,10029,1286,1255,2541
2030,Durango,10,San Pedro del Gallo,10030,988,904,1892
2030,Durango,10,Santa Clara,10031,4189,4185,8374
2030,Durango,10,Santiago Papasquiaro,10032,27645,27705,55350
2030,Durango,10,Súchil,10033,3624,3891,7515
2030,Durango,10,Tamazula,10034,15010,13607,28617
2030,Durango,10,Tepehuanes,10035,6450,6578,13028
2030,Durango,10,Tlahualilo,10036,13909,13795,27704
2030,Durango,10,Topia,10037,5513,5102,10615
2030,Durango,10,Vicente Guerrero,10038,12288,12989,25277
2030,Estado de México,15,Acambay de Ruíz Castañeda,15001,36885,38786,75671
2030,Estado de México,15,Acolman,15002,97445,97683,195128
2030,Estado de México,15,Aculco,15003,27936,28281,56217
2030,Estado de México,15,Almoloya de Alquisiras,15004,8269,8846,17115
2030,Estado de México,15,Almoloya de Juárez,15005,97520,99558,197078
2030,Estado de México,15,Almoloya del Río,15006,6351,6821,13172
2030,Estado de México,15,Amanalco,15007,13640,14007,27647
2030,Estado de México,15,Amatepec,15008,16098,16730,32828
2030,Estado de México,15,Amecameca,15009,28876,30899,59775
2030,Estado de México,15,Apaxco,15010,16876,17224,34100
2030,Estado de México,15,Atenco,15011,36325,37249,73574
2030,Estado de México,15,Atizapán,15012,6404,6738,13142
2030,Estado de México,15,Atizapán de Zaragoza,15013,295623,314087,609710
2030,Estado de México,15,Atlacomulco,15014,54333,59299,113632
2030,Estado de México,15,Atlautla,15015,17532,18094,35626
2030,Estado de México,15,Axapusco,15016,16300,16291,32591
2030,Estado de México,15,Ayapango,15017,5808,6014,11822
2030,Estado de México,15,Calimaya,15018,31369,32769,64138
2030,Estado de México,15,Capulhuac,15019,19916,21140,41056
2030,Estado de México,15,Chalco,15025,211618,218441,430059
2030,Estado de México,15,Chapa de Mota,15026,15898,16531,32429
2030,Estado de México,15,Chapultepec,15027,6771,6929,13700
2030,Estado de México,15,Chiautla,15028,16831,17448,34279
2030,Estado de México,15,Chicoloapan,15029,114112,121073,235185
2030,Estado de México,15,Chiconcuac,15030,14591,15000,29591
2030,Estado de México,15,Chimalhuacán,15031,367025,378226,745251
2030,Estado de México,15,Coacalco de Berriozábal,15020,162252,175802,338054
2030,Estado de México,15,Coatepec Harinas,15021,21675,23065,44740
2030,Estado de México,15,Cocotitlán,15022,8175,8559,16734
2030,Estado de México,15,Coyotepec,15023,23223,23644,46867
2030,Estado de México,15,Cuautitlán,15024,90444,92457,182901
2030,Estado de México,15,Cuautitlán Izcalli,15121,307475,324114,631589
2030,Estado de México,15,Donato Guerra,15032,18621,19247,37868
2030,Estado de México,15,Ecatepec de Morelos,15033,930671,956273,1886944
2030,Estado de México,15,Ecatzingo,15034,5304,5404,10708
2030,Estado de México,15,El Oro,15064,20648,22226,42874
2030,Estado de México,15,Huehuetoca,15035,74403,76007,150410
2030,Estado de México,15,Hueypoxtla,15036,25536,24893,50429
2030,Estado de México,15,Huixquilucan,15037,151298,162646,313944
2030,Estado de México,15,Isidro Fabela,15038,6607,6641,13248
2030,Estado de México,15,Ixtapaluca,15039,279883,288644,568527
2030,Estado de México,15,Ixtapan de la Sal,15040,19967,21442,41409
2030,Estado de México,15,Ixtapan del Oro,15041,4045,3931,7976
2030,Estado de México,15,Ixtlahuaca,15042,83953,90141,174094
2030,Estado de México,15,Jaltenco,15044,15566,16527,32093
2030,Estado de México,15,Jilotepec,15045,50524,51803,102327
2030,Estado de México,15,Jilotzingo,15046,10761,11327,22088
2030,Estado de México,15,Jiquipilco,15047,41029,43608,84637
2030,Estado de México,15,Jocotitlán,15048,36813,39191,76004
2030,Estado de México,15,Joquicingo,15049,7770,8009,15779
2030,Estado de México,15,Juchitepec,15050,14386,14765,29151
2030,Estado de México,15,La Paz,15070,162027,165656,327683
2030,Estado de México,15,Lerma,15051,83997,86161,170158
2030,Estado de México,15,Luvianos,15123,16271,16558,32829
2030,Estado de México,15,Malinalco,15052,15913,16224,32137
2030,Estado de México,15,Melchor Ocampo,15053,31969,33236,65205
2030,Estado de México,15,Metepec,15054,130713,139494,270207
2030,Estado de México,15,Mexicaltzingo,15055,7149,7613,14762
2030,Estado de México,15,Morelos,15056,16776,18140,34916
2030,Estado de México,15,Naucalpan de Juárez,15057,500183,533552,1033735
2030,Estado de México,15,Nextlalpan,15059,22304,22790,45094
2030,Estado de México,15,Nezahualcóyotl,15058,634153,684683,1318836
2030,Estado de México,15,Nicolás Romero,15060,229411,238608,468019
2030,Estado de México,15,Nopaltepec,15061,5296,5284,10580
2030,Estado de México,15,Ocoyoacac,15062,37959,39264,77223
2030,Estado de México,15,Ocuilan,15063,19177,19720,38897
2030,Estado de México,15,Otumba,15065,20791,20508,41299
2030,Estado de México,15,Otzoloapan,15066,2388,2313,4701
2030,Estado de México,15,Otzolotepec,15067,46863,48036,94899
2030,Estado de México,15,Ozumba,15068,16267,17476,33743
2030,Estado de México,15,Papalotla,15069,2297,2426,4723
2030,Estado de México,15,Polotitlán,15071,8188,8436,16624
2030,Estado de México,15,Rayón,15072,7728,7931,15659
2030,Estado de México,15,San Antonio la Isla,15073,16247,16531,32778
2030,Estado de México,15,San Felipe del Progreso,15074,71996,79980,151976
2030,Estado de México,15,San José del Rincón,15124,49912,51210,101122
2030,Estado de México,15,San Martín de las Pirámides,15075,15570,15809,31379
2030,Estado de México,15,San Mateo Atenco,15076,42221,43575,85796
2030,Estado de México,15,San Simón de Guerrero,15077,3448,3626,7074
2030,Estado de México,15,Santo Tomás,15078,5574,5661,11235
2030,Estado de México,15,Soyaniquilpan de Juárez,15079,7772,7818,15590
2030,Estado de México,15,Sultepec,15080,14957,16343,31300
2030,Estado de México,15,Tecámac,15081,255282,266842,522124
2030,Estado de México,15,Tejupilco,15082,42986,45859,88845
2030,Estado de México,15,Temamatla,15083,7109,7333,14442
2030,Estado de México,15,Temascalapa,15084,22366,22312,44678
2030,Estado de México,15,Temascalcingo,15085,35649,38388,74037
2030,Estado de México,15,Temascaltepec,15086,18402,18956,37358
2030,Estado de México,15,Temoaya,15087,55289,58529,113818
2030,Estado de México,15,Tenancingo,15088,55062,57963,113025
2030,Estado de México,15,Tenango del Aire,15089,7128,7293,14421
2030,Estado de México,15,Tenango del Valle,15090,48049,49964,98013
2030,Estado de México,15,Teoloyucan,15091,36564,37377,73941
2030,Estado de México,15,Teotihuacán,15092,32277,33181,65458
2030,Estado de México,15,Tepetlaoxtoc,15093,17752,17897,35649
2030,Estado de México,15,Tepetlixpa,15094,11422,11677,23099
2030,Estado de México,15,Tepotzotlán,15095,54621,56503,111124
2030,Estado de México,15,Tequixquiac,15096,21290,21423,42713
2030,Estado de México,15,Texcaltitlán,15097,10537,11071,21608
2030,Estado de México,15,Texcalyacac,15098,3025,3123,6148
2030,Estado de México,15,Texcoco,15099,137972,146465,284437
2030,Estado de México,15,Tezoyuca,15100,24322,24493,48815
2030,Estado de México,15,Tianguistenco,15101,42849,45117,87966
2030,Estado de México,15,Timilpan,15102,8979,9666,18645
2030,Estado de México,15,Tlalmanalco,15103,27405,29399,56804
2030,Estado de México,15,Tlalnepantla de Baz,15104,422809,453975,876784
2030,Estado de México,15,Tlatlaya,15105,21196,21959,43155
2030,Estado de México,15,Toluca,15106,491012,528002,1019014
2030,Estado de México,15,Tonanitla,15125,5415,5537,10952
2030,Estado de México,15,Tonatico,15107,7403,7944,15347
2030,Estado de México,15,Tultepec,15108,82490,85298,167788
2030,Estado de México,15,Tultitlán,15109,291561,303042,594603
2030,Estado de México,15,Valle de Bravo,15110,36758,38114,74872
2030,Estado de México,15,Valle de Chalco Solidaridad,15122,219381,225754,445135
2030,Estado de México,15,Villa Guerrero,15113,37521,38448,75969
2030,Estado de México,15,Villa Victoria,15114,57175,57931,115106
2030,Estado de México,15,Villa de Allende,15111,28116,29414,57530
2030,Estado de México,15,Villa del Carbón,15112,27040,26706,53746
2030,Estado de México,15,Xalatlaco,15043,16543,17384,33927
2030,Estado de México,15,Xonacatlán,15115,29206,28985,58191
2030,Estado de México,15,Zacazonapan,15116,2352,2289,4641
2030,Estado de México,15,Zacualpan,15117,8638,9475,18113
2030,Estado de México,15,Zinacantepec,15118,104932,107424,212356
2030,Estado de México,15,Zumpahuacán,15119,9215,10021,19236
2030,Estado de México,15,Zumpango,15120,110194,117432,227626
2030,Guanajuato,11,Abasolo,11001,50275,52985,103260
2030,Guanajuato,11,Acámbaro,11002,64301,69570,133871
2030,Guanajuato,11,Apaseo el Alto,11004,37712,39388,77100
2030,Guanajuato,11,Apaseo el Grande,11005,51030,54041,105071
2030,Guanajuato,11,Atarjea,11006,3058,3129,6187
2030,Guanajuato,11,Celaya,11007,275143,292069,567212
2030,Guanajuato,11,Comonfort,11009,43930,48529,92459
2030,Guanajuato,11,Coroneo,11010,6721,7474,14195
2030,Guanajuato,11,Cortazar,11011,53390,56658,110048
2030,Guanajuato,11,Cuerámaro,11012,15747,16962,32709
2030,Guanajuato,11,Doctor Mora,11013,13013,13989,27002
2030,Guanajuato,11,Dolores Hidalgo Cuna de la Independencia Nacional,11014,80382,89233,169615
2030,Guanajuato,11,Guanajuato,11015,103447,108233,211680
2030,Guanajuato,11,Huanímaro,11016,11865,12983,24848
2030,Guanajuato,11,Irapuato,11017,317174,334394,651568
2030,Guanajuato,11,Jaral del Progreso,11018,22243,22776,45019
2030,Guanajuato,11,Jerécuaro,11019,26753,30105,56858
2030,Guanajuato,11,León,11020,876593,894754,1771347
2030,Guanajuato,11,Manuel Doblado,11008,21626,23218,44844
2030,Guanajuato,11,Moroleón,11021,29009,32152,61161
2030,Guanajuato,11,Ocampo,11022,12922,13666,26588
2030,Guanajuato,11,Pueblo Nuevo,11024,6685,7326,14011
2030,Guanajuato,11,Purísima del Rincón,11025,44514,44198,88712
2030,Guanajuato,11,Pénjamo,11023,83921,91279,175200
2030,Guanajuato,11,Romita,11026,32943,34227,67170
2030,Guanajuato,11,Salamanca,11027,155560,164189,319749
2030,Guanajuato,11,Salvatierra,11028,57230,62996,120226
2030,Guanajuato,11,San Diego de la Unión,11029,20824,23721,44545
2030,Guanajuato,11,San Felipe,11030,61590,64812,126402
2030,Guanajuato,11,San Francisco del Rincón,11031,65295,68567,133862
2030,Guanajuato,11,San José Iturbide,11032,42543,44861,87404
2030,Guanajuato,11,San Luis de la Paz,11033,64033,70131,134164
2030,Guanajuato,11,San Miguel de Allende,11003,94177,101078,195255
2030,Guanajuato,11,Santa Catarina,11034,2880,3167,6047
2030,Guanajuato,11,Santa Cruz de Juventino Rosas,11035,45709,48490,94199
2030,Guanajuato,11,Santiago Maravatío,11036,4074,4505,8579
2030,Guanajuato,11,Silao de la Victoria,11037,104701,106959,211660
2030,Guanajuato,11,Tarandacuao,11038,6953,7679,14632
2030,Guanajuato,11,Tarimoro,11039,20035,21048,41083
2030,Guanajuato,11,Tierra Blanca,11040,10248,11099,21347
2030,Guanajuato,11,Uriangato,11041,35436,37867,73303
2030,Guanajuato,11,Valle de Santiago,11042,80435,88453,168888
2030,Guanajuato,11,Victoria,11043,11009,12333,23342
2030,Guanajuato,11,Villagrán,11044,32676,34133,66809
2030,Guanajuato,11,Xichú,11045,6465,7061,13526
2030,Guanajuato,11,Yuriria,11046,39849,43439,83288
2030,Guerrero,12,Acapulco de Juárez,12001,415116,451506,866622
2030,Guerrero,12,Acatepec,12076,17687,18749,36436
2030,Guerrero,12,Ahuacuotzingo,12002,12821,14476,27297
2030,Guerrero,12,Ajuchitlán del Progreso,12003,19433,20646,40079
2030,Guerrero,12,Alcozauca de Guerrero,12004,9381,10621,20002
2030,Guerrero,12,Alpoyeca,12005,3348,3733,7081
2030,Guerrero,12,Apaxtla,12006,6014,6491,12505
2030,Guerrero,12,Arcelia,12007,16528,17561,34089
2030,Guerrero,12,Atenango del Río,12008,4498,4854,9352
2030,Guerrero,12,Atlamajalcingo del Monte,12009,2558,2805,5363
2030,Guerrero,12,Atlixtac,12010,13265,14145,27410
2030,Guerrero,12,Atoyac de Álvarez,12011,32148,33409,65557
2030,Guerrero,12,Ayutla de los Libres,12012,33817,35049,68866
2030,Guerrero,12,Azoyú,12013,7532,7905,15437
2030,Guerrero,12,Benito Juárez,12014,8398,8829,17227
2030,Guerrero,12,Buenavista de Cuéllar,12015,7007,7413,14420
2030,Guerrero,12,Chilapa de Álvarez,12028,62845,70085,132930
2030,Guerrero,12,Chilpancingo de los Bravo,12029,135999,147990,283989
2030,Guerrero,12,Coahuayutla de José María Izazaga,12016,6770,6435,13205
2030,Guerrero,12,Cochoapa el Grande,12078,8506,9438,17944
2030,Guerrero,12,Cocula,12017,7312,7805,15117
2030,Guerrero,12,Copala,12018,7431,7689,15120
2030,Guerrero,12,Copalillo,12019,7276,7913,15189
2030,Guerrero,12,Copanatoyac,12020,9684,10688,20372
2030,Guerrero,12,Coyuca de Benítez,12021,39847,41417,81264
2030,Guerrero,12,Coyuca de Catalán,12022,21369,21301,42670
2030,Guerrero,12,Cuajinicuilapa,12023,14335,14278,28613
2030,Guerrero,12,Cualác,12024,3848,4048,7896
2030,Guerrero,12,Cuautepec,12025,8429,8386,16815
2030,Guerrero,12,Cuetzala del Progreso,12026,4676,4935,9611
2030,Guerrero,12,Cutzamala de Pinzón,12027,10974,11477,22451
2030,Guerrero,12,Eduardo Neri,12075,26193,27321,53514
2030,Guerrero,12,Florencio Villarreal,12030,10806,11035,21841
2030,Guerrero,12,General Canuto A. Neri,12031,3115,3409,6524
2030,Guerrero,12,General Heliodoro Castillo,12032,18794,18711,37505
2030,Guerrero,12,Huamuxtitlán,12033,7680,8632,16312
2030,Guerrero,12,Huitzuco de los Figueroa,12034,19689,21289,40978
2030,Guerrero,12,Iguala de la Independencia,12035,77731,84203,161934
2030,Guerrero,12,Igualapa,12036,5714,5859,11573
2030,Guerrero,12,Iliatenco,12081,5349,5965,11314
2030,Guerrero,12,Ixcateopan de Cuauhtémoc,12037,3276,3675,6951
2030,Guerrero,12,José Joaquín de Herrera,12079,8731,8949,17680
2030,Guerrero,12,Juan R. Escudero,12039,12994,13565,26559
2030,Guerrero,12,Juchitán,12080,4005,3974,7979
2030,Guerrero,12,La Unión de Isidoro Montes de Oca,12068,14447,13771,28218
2030,Guerrero,12,Leonardo Bravo,12040,13388,13624,27012
2030,Guerrero,12,Malinaltepec,12041,13479,15078,28557
2030,Guerrero,12,Marquelia,12077,7149,7263,14412
2030,Guerrero,12,Metlatónoc,12043,9137,10449,19586
2030,Guerrero,12,Mochitlán,12044,6659,6944,13603
2030,Guerrero,12,Mártir de Cuilapan,12042,9287,10143,19430
2030,Guerrero,12,Olinalá,12045,12830,13648,26478
2030,Guerrero,12,Ometepec,12046,33734,35398,69132
2030,Guerrero,12,Pedro Ascencio Alquisiras,12047,3412,3962,7374
2030,Guerrero,12,Petatlán,12048,23355,23820,47175
2030,Guerrero,12,Pilcaya,12049,6671,7047,13718
2030,Guerrero,12,Pungarabato,12050,19066,20415,39481
2030,Guerrero,12,Quechultenango,12051,18321,18999,37320
2030,Guerrero,12,San Luis Acatlán,12052,21912,22436,44348
2030,Guerrero,12,San Marcos,12053,25883,26721,52604
2030,Guerrero,12,San Miguel Totolapan,12054,14043,14621,28664
2030,Guerrero,12,Taxco de Alarcón,12055,55720,61084,116804
2030,Guerrero,12,Tecoanapa,12056,23798,24434,48232
2030,Guerrero,12,Teloloapan,12058,29067,32759,61826
2030,Guerrero,12,Tepecoacuilco de Trujano,12059,16893,18463,35356
2030,Guerrero,12,Tetipac,12060,7539,7884,15423
2030,Guerrero,12,Tixtla de Guerrero,12061,21754,23631,45385
2030,Guerrero,12,Tlacoachistlahuaca,12062,11113,12449,23562
2030,Guerrero,12,Tlacoapa,12063,4956,5584,10540
2030,Guerrero,12,Tlalchapa,12064,6921,7004,13925
2030,Guerrero,12,Tlalixtaquilla de Maldonado,12065,3786,4079,7865
2030,Guerrero,12,Tlapa de Comonfort,12066,43276,48123,91399
2030,Guerrero,12,Tlapehuala,12067,11368,12266,23634
2030,Guerrero,12,Técpan de Galeana,12057,34884,35498,70382
2030,Guerrero,12,Xalpatláhuac,12069,5763,6670,12433
2030,Guerrero,12,Xochihuehuetlán,12070,3671,4177,7848
2030,Guerrero,12,Xochistlahuaca,12071,14474,15325,29799
2030,Guerrero,12,Zapotitlán Tablas,12072,6381,7011,13392
2030,Guerrero,12,Zihuatanejo de Azueta,12038,64613,66325,130938
2030,Guerrero,12,Zirándaro,12073,9860,9534,19394
2030,Guerrero,12,Zitlala,12074,11310,12635,23945
2030,Hidalgo,13,Acatlán,13001,11818,12548,24366
2030,Hidalgo,13,Acaxochitlán,13002,23893,25990,49883
2030,Hidalgo,13,Actopan,13003,32102,35769,67871
2030,Hidalgo,13,Agua Blanca de Iturbide,13004,5154,5683,10837
2030,Hidalgo,13,Ajacuba,13005,10916,11311,22227
2030,Hidalgo,13,Alfajayucan,13006,12255,12833,25088
2030,Hidalgo,13,Almoloya,13007,7238,7309,14547
2030,Hidalgo,13,Apan,13008,25651,27907,53558
2030,Hidalgo,13,Atitalaquia,13010,17491,17875,35366
2030,Hidalgo,13,Atlapexco,13011,11646,12697,24343
2030,Hidalgo,13,Atotonilco de Tula,13013,21715,22808,44523
2030,Hidalgo,13,Atotonilco el Grande,13012,15747,17461,33208
2030,Hidalgo,13,Calnali,13014,10260,11165,21425
2030,Hidalgo,13,Cardonal,13015,10911,11694,22605
2030,Hidalgo,13,Chapantongo,13017,8191,8545,16736
2030,Hidalgo,13,Chapulhuacán,13018,14274,14010,28284
2030,Hidalgo,13,Chilcuautla,13019,10778,10994,21772
2030,Hidalgo,13,Cuautepec de Hinojosa,13016,32683,35661,68344
2030,Hidalgo,13,El Arenal,13009,10621,11496,22117
2030,Hidalgo,13,Eloxochitlán,13020,1671,1884,3555
2030,Hidalgo,13,Emiliano Zapata,13021,8389,9305,17694
2030,Hidalgo,13,Epazoyucan,13022,8641,9156,17797
2030,Hidalgo,13,Francisco I. Madero,13023,20716,22501,43217
2030,Hidalgo,13,Huasca de Ocampo,13024,10147,11010,21157
2030,Hidalgo,13,Huautla,13025,12854,14355,27209
2030,Hidalgo,13,Huazalingo,13026,7980,8520,16500
2030,Hidalgo,13,Huehuetla,13027,14862,15750,30612
2030,Hidalgo,13,Huejutla de Reyes,13028,74686,78030,152716
2030,Hidalgo,13,Huichapan,13029,26710,28820,55530
2030,Hidalgo,13,Ixmiquilpan,13030,51907,58125,110032
2030,Hidalgo,13,Jacala de Ledezma,13031,7928,8788,16716
2030,Hidalgo,13,Jaltocán,13032,7016,7259,14275
2030,Hidalgo,13,Juárez Hidalgo,13033,1904,2071,3975
2030,Hidalgo,13,La Misión,13040,6247,6361,12608
2030,Hidalgo,13,Lolotla,13034,5623,5951,11574
2030,Hidalgo,13,Metepec,13035,6482,7265,13747
2030,Hidalgo,13,Metztitlán,13037,12184,13440,25624
2030,Hidalgo,13,Mineral de la Reforma,13051,93669,103512,197181
2030,Hidalgo,13,Mineral del Chico,13038,5234,5534,10768
2030,Hidalgo,13,Mineral del Monte,13039,8425,9302,17727
2030,Hidalgo,13,Mixquiahuala de Juárez,13041,26695,28557,55252
2030,Hidalgo,13,Molango de Escamilla,13042,6948,7269,14217
2030,Hidalgo,13,Nicolás Flores,13043,4021,4475,8496
2030,Hidalgo,13,Nopala de Villagrán,13044,10184,10468,20652
2030,Hidalgo,13,Omitlán de Juárez,13045,5606,6024,11630
2030,Hidalgo,13,Pachuca de Soto,13048,146874,163861,310735
2030,Hidalgo,13,Pacula,13047,2911,3307,6218
2030,Hidalgo,13,Pisaflores,13049,10407,10261,20668
2030,Hidalgo,13,Progreso de Obregón,13050,13409,14944,28353
2030,Hidalgo,13,San Agustín Metzquititlán,13036,5664,6176,11840
2030,Hidalgo,13,San Agustín Tlaxiaca,13052,21021,21915,42936
2030,Hidalgo,13,San Bartolo Tutotepec,13053,11100,11465,22565
2030,Hidalgo,13,San Felipe Orizatlán,13046,22852,23773,46625
2030,Hidalgo,13,San Salvador,13054,20399,21867,42266
2030,Hidalgo,13,Santiago Tulantepec de Lugo Guerrero,13056,20765,22719,43484
2030,Hidalgo,13,Santiago de Anaya,13055,10043,10462,20505
2030,Hidalgo,13,Singuilucan,13057,9574,9741,19315
2030,Hidalgo,13,Tasquillo,13058,9258,10672,19930
2030,Hidalgo,13,Tecozautla,13059,21693,23158,44851
2030,Hidalgo,13,Tenango de Doria,13060,10413,11414,21827
2030,Hidalgo,13,Tepeapulco,13061,32144,34239,66383
2030,Hidalgo,13,Tepehuacán de Guerrero,13062,18115,17577,35692
2030,Hidalgo,13,Tepeji del Río de Ocampo,13063,50420,51695,102115
2030,Hidalgo,13,Tepetitlán,13064,6473,6850,13323
2030,Hidalgo,13,Tetepango,13065,6856,6877,13733
2030,Hidalgo,13,Tezontepec de Aldama,13067,30755,31373,62128
2030,Hidalgo,13,Tianguistengo,13068,8836,9273,18109
2030,Hidalgo,13,Tizayuca,13069,71836,73902,145738
2030,Hidalgo,13,Tlahuelilpan,13070,11112,11544,22656
2030,Hidalgo,13,Tlahuiltepa,13071,6375,6326,12701
2030,Hidalgo,13,Tlanalapa,13072,6107,6492,12599
2030,Hidalgo,13,Tlanchinol,13073,22864,23201,46065
2030,Hidalgo,13,Tlaxcoapan,13074,16626,17017,33643
2030,Hidalgo,13,Tolcayuca,13075,9366,9947,19313
2030,Hidalgo,13,Tula de Allende,13076,63781,67797,131578
2030,Hidalgo,13,Tulancingo de Bravo,13077,87651,97869,185520
2030,Hidalgo,13,Villa de Tezontepec,13066,7145,7485,14630
2030,Hidalgo,13,Xochiatipan,13078,11211,12111,23322
2030,Hidalgo,13,Xochicoatlán,13079,4773,4929,9702
2030,Hidalgo,13,Yahualica,13080,14030,14818,28848
2030,Hidalgo,13,Zacualtipán de Ángeles,13081,19577,21422,40999
2030,Hidalgo,13,Zapotlán de Juárez,13082,10750,11670,22420
2030,Hidalgo,13,Zempoala,13083,26896,28498,55394
2030,Hidalgo,13,Zimapán,13084,22314,25551,47865
2030,Jalisco,14,Acatic,14001,12227,12728,24955
2030,Jalisco,14,Acatlán de Juárez,14002,12988,12940,25928
2030,Jalisco,14,Ahualulco de Mercado,14003,13431,13767,27198
2030,Jalisco,14,Amacueca,14004,3195,3325,6520
2030,Jalisco,14,Amatitán,14005,8801,8812,17613
2030,Jalisco,14,Ameca,14006,35808,37038,72846
2030,Jalisco,14,Arandas,14008,41716,45102,86818
2030,Jalisco,14,Atemajac de Brizuela,14010,3796,3840,7636
2030,Jalisco,14,Atengo,14011,3475,3252,6727
2030,Jalisco,14,Atenguillo,14012,2410,2519,4929
2030,Jalisco,14,Atotonilco el Alto,14013,34700,35757,70457
2030,Jalisco,14,Atoyac,14014,4807,5118,9925
2030,Jalisco,14,Autlán de Navarro,14015,35286,36472,71758
2030,Jalisco,14,Ayotlán,14016,21682,22513,44195
2030,Jalisco,14,Ayutla,14017,7637,7541,15178
2030,Jalisco,14,Bolaños,14019,4342,4321,8663
2030,Jalisco,14,Cabo Corrientes,14020,6419,5824,12243
2030,Jalisco,14,Casimiro Castillo,14021,13105,12958,26063
2030,Jalisco,14,Cañadas de Obregón,14117,2535,2670,5205
2030,Jalisco,14,Chapala,14030,29560,31126,60686
2030,Jalisco,14,Chimaltitán,14031,1954,1987,3941
2030,Jalisco,14,Chiquilistlán,14032,3565,3503,7068
2030,Jalisco,14,Cihuatlán,14022,24174,23422,47596
2030,Jalisco,14,Cocula,14024,15672,16383,32055
2030,Jalisco,14,Colotlán,14025,10334,11025,21359
2030,Jalisco,14,Concepción de Buenos Aires,14026,3739,3611,7350
2030,Jalisco,14,Cuautitlán de García Barragán,14027,10549,10198,20747
2030,Jalisco,14,Cuautla,14028,1308,1406,2714
2030,Jalisco,14,Cuquío,14029,10498,11230,21728
2030,Jalisco,14,Degollado,14033,12357,13035,25392
2030,Jalisco,14,Ejutla,14034,1249,1168,2417
2030,Jalisco,14,El Arenal,14009,11218,11207,22425
2030,Jalisco,14,El Grullo,14037,14159,14980,29139
2030,Jalisco,14,El Limón,14054,3492,3486,6978
2030,Jalisco,14,El Salto,14070,102758,102770,205528
2030,Jalisco,14,Encarnación de Díaz,14035,30249,32191,62440
2030,Jalisco,14,Etzatlán,14036,11417,11946,23363
2030,Jalisco,14,Guachinango,14038,2711,2588,5299
2030,Jalisco,14,Guadalajara,14039,828292,887175,1715467
2030,Jalisco,14,Gómez Farías,14079,8097,8666,16763
2030,Jalisco,14,Hostotipaquillo,14040,6465,5624,12089
2030,Jalisco,14,Huejuquilla el Alto,14042,5113,5539,10652
2030,Jalisco,14,Huejúcar,14041,3490,3809,7299
2030,Jalisco,14,Ixtlahuacán de los Membrillos,14044,31125,31456,62581
2030,Jalisco,14,Ixtlahuacán del Río,14045,11082,11685,22767
2030,Jalisco,14,Jalostotitlán,14046,19219,19766,38985
2030,Jalisco,14,Jamay,14047,14441,14349,28790
2030,Jalisco,14,Jesús María,14048,10549,12312,22861
2030,Jalisco,14,Jilotlán de los Dolores,14049,5792,5431,11223
2030,Jalisco,14,Jocotepec,14050,26481,26753,53234
2030,Jalisco,14,Juanacatlán,14051,10333,10208,20541
2030,Jalisco,14,Juchitlán,14052,3348,3518,6866
2030,Jalisco,14,La Barca,14018,37257,39424,76681
2030,Jalisco,14,La Huerta,14043,14841,14111,28952
2030,Jalisco,14,La Manzanilla de la Paz,14057,2214,2355,4569
2030,Jalisco,14,Lagos de Moreno,14053,92089,95692,187781
2030,Jalisco,14,Magdalena,14055,13039,13023,26062
2030,Jalisco,14,Mascota,14058,8774,8989,17763
2030,Jalisco,14,Mazamitla,14059,7830,8450,16280
2030,Jalisco,14,Mexticacán,14060,2924,3436,6360
2030,Jalisco,14,Mezquitic,14061,10586,11210,21796
2030,Jalisco,14,Mixtlán,14062,2171,2144,4315
2030,Jalisco,14,Ocotlán,14063,56483,58483,114966
2030,Jalisco,14,Ojuelos de Jalisco,14064,17764,18584,36348
2030,Jalisco,14,Pihuamo,14065,7085,7000,14085
2030,Jalisco,14,Poncitlán,14066,28865,29496,58361
2030,Jalisco,14,Puerto Vallarta,14067,159672,155602,315274
2030,Jalisco,14,Quitupan,14069,4966,5472,10438
2030,Jalisco,14,San Cristóbal de la Barranca,14071,1852,1825,3677
2030,Jalisco,14,San Diego de Alejandría,14072,4066,4347,8413
2030,Jalisco,14,San Gabriel,14113,9533,9842,19375
2030,Jalisco,14,San Ignacio Cerro Gordo,14125,10546,11143,21689
2030,Jalisco,14,San Juan de los Lagos,14073,39477,39947,79424
2030,Jalisco,14,San Juanito de Escobedo,14007,5626,5490,11116
2030,Jalisco,14,San Julián,14074,8894,9813,18707
2030,Jalisco,14,San Marcos,14075,2285,2215,4500
2030,Jalisco,14,San Martín Hidalgo,14077,16454,17099,33553
2030,Jalisco,14,San Martín de Bolaños,14076,1842,1834,3676
2030,Jalisco,14,San Miguel el Alto,14078,18576,19653,38229
2030,Jalisco,14,San Pedro Tlaquepaque,14098,373543,376453,749996
2030,Jalisco,14,San Sebastián del Oeste,14080,3660,3267,6927
2030,Jalisco,14,Santa María de los Ángeles,14081,1929,2114,4043
2030,Jalisco,14,Santa María del Oro,14056,1289,1276,2565
2030,Jalisco,14,Sayula,14082,20715,22151,42866
2030,Jalisco,14,Tala,14083,45771,46097,91868
2030,Jalisco,14,Talpa de Allende,14084,9015,8834,17849
2030,Jalisco,14,Tamazula de Gordiano,14085,22870,24046,46916
2030,Jalisco,14,Tapalpa,14086,10745,11102,21847
2030,Jalisco,14,Tecalitlán,14087,9795,10194,19989
2030,Jalisco,14,Techaluta de Montenegro,14089,2221,2258,4479
2030,Jalisco,14,Tecolotlán,14088,10377,10351,20728
2030,Jalisco,14,Tenamaxtlán,14090,4232,4270,8502
2030,Jalisco,14,Teocaltiche,14091,23423,25403,48826
2030,Jalisco,14,Teocuitatlán de Corona,14092,6369,6616,12985
2030,Jalisco,14,Tepatitlán de Morelos,14093,79602,82573,162175
2030,Jalisco,14,Tequila,14094,23754,24070,47824
2030,Jalisco,14,Teuchitlán,14095,5702,5857,11559
2030,Jalisco,14,Tizapán el Alto,14096,12284,12753,25037
2030,Jalisco,14,Tlajomulco de Zúñiga,14097,326909,330540,657449
2030,Jalisco,14,Tolimán,14099,6063,6080,12143
2030,Jalisco,14,Tomatlán,14100,21509,20086,41595
2030,Jalisco,14,Tonalá,14101,297845,299056,596901
2030,Jalisco,14,Tonaya,14102,3636,3766,7402
2030,Jalisco,14,Tonila,14103,4738,4762,9500
2030,Jalisco,14,Totatiche,14104,2796,2857,5653
2030,Jalisco,14,Tototlán,14105,13413,13681,27094
2030,Jalisco,14,Tuxcacuesco,14106,2690,2557,5247
2030,Jalisco,14,Tuxcueca,14107,3584,3793,7377
2030,Jalisco,14,Tuxpan,14108,20118,21325,41443
2030,Jalisco,14,Unión de San Antonio,14109,10181,10853,21034
2030,Jalisco,14,Unión de Tula,14110,7997,8460,16457
2030,Jalisco,14,Valle de Guadalupe,14111,4077,4138,8215
2030,Jalisco,14,Valle de Juárez,14112,3258,3458,6716
2030,Jalisco,14,Villa Corona,14114,10535,10808,21343
2030,Jalisco,14,Villa Guerrero,14115,3289,3431,6720
2030,Jalisco,14,Villa Hidalgo,14116,11346,12045,23391
2030,Jalisco,14,Villa Purificación,14068,6903,6397,13300
2030,Jalisco,14,Yahualica de González Gallo,14118,12870,14222,27092
2030,Jalisco,14,Zacoalco de Torres,14119,16784,17058,33842
2030,Jalisco,14,Zapopan,14120,753513,781594,1535107
2030,Jalisco,14,Zapotiltic,14121,17199,17812,35011
2030,Jalisco,14,Zapotitlán de Vadillo,14122,4184,4154,8338
2030,Jalisco,14,Zapotlanejo,14124,38367,39166,77533
2030,Jalisco,14,Zapotlán del Rey,14123,10589,10555,21144
2030,Jalisco,14,Zapotlán el Grande,14023,60278,63867,124145
2030,Michoacán,16,Acuitzio,16001,6150,6632,12782
2030,Michoacán,16,Aguililla,16002,8424,8208,16632
2030,Michoacán,16,Angamacutiro,16004,8417,9043,17460
2030,Michoacán,16,Angangueo,16005,6059,6437,12496
2030,Michoacán,16,Apatzingán,16006,69797,70681,140478
2030,Michoacán,16,Aporo,16007,1746,1861,3607
2030,Michoacán,16,Aquila,16008,13805,13457,27262
2030,Michoacán,16,Ario,16009,19853,20936,40789
2030,Michoacán,16,Arteaga,16010,12234,12287,24521
2030,Michoacán,16,Briseñas,16011,6233,6542,12775
2030,Michoacán,16,Buenavista,16012,26636,25227,51863
2030,Michoacán,16,Carácuaro,16013,5247,5179,10426
2030,Michoacán,16,Charapan,16021,6551,7316,13867
2030,Michoacán,16,Charo,16022,12424,12075,24499
2030,Michoacán,16,Chavinda,16023,5807,6152,11959
2030,Michoacán,16,Cherán,16024,10128,10860,20988
2030,Michoacán,16,Chilchota,16025,20699,22243,42942
2030,Michoacán,16,Chinicuila,16026,2922,2625,5547
2030,Michoacán,16,Chucándiro,16027,2536,2807,5343
2030,Michoacán,16,Churintzio,16028,2974,3410,6384
2030,Michoacán,16,Churumuco,16029,8522,8438,16960
2030,Michoacán,16,Coahuayana,16014,8445,7772,16217
2030,Michoacán,16,Coalcomán de Vázquez Pallares,16015,9938,9928,19866
2030,Michoacán,16,Coeneo,16016,11440,13127,24567
2030,Michoacán,16,Cojumatlán de Régules,16074,5798,6046,11844
2030,Michoacán,16,Contepec,16017,18524,19094,37618
2030,Michoacán,16,Copándaro,16018,4924,5327,10251
2030,Michoacán,16,Cotija,16019,10219,11145,21364
2030,Michoacán,16,Cuitzeo,16020,16007,17510,33517
2030,Michoacán,16,Ecuandureo,16030,6905,7997,14902
2030,Michoacán,16,Epitacio Huerta,16031,9278,9506,18784
2030,Michoacán,16,Erongarícuaro,16032,8328,8908,17236
2030,Michoacán,16,Gabriel Zamora,16033,12651,12612,25263
2030,Michoacán,16,Hidalgo,16034,65928,69144,135072
2030,Michoacán,16,Huandacareo,16036,6424,7412,13836
2030,Michoacán,16,Huaniqueo,16037,4563,5291,9854
2030,Michoacán,16,Huetamo,16038,22706,23948,46654
2030,Michoacán,16,Huiramba,16039,4724,4900,9624
2030,Michoacán,16,Indaparapeo,16040,9193,9501,18694
2030,Michoacán,16,Irimbo,16041,8003,8637,16640
2030,Michoacán,16,Ixtlán,16042,7368,7553,14921
2030,Michoacán,16,Jacona,16043,36772,38769,75541
2030,Michoacán,16,Jiménez,16044,7284,7886,15170
2030,Michoacán,16,Jiquilpan,16045,18185,20001,38186
2030,Michoacán,16,José Sixto Verduzco,16113,14560,15895,30455
2030,Michoacán,16,Jungapeo,16047,11689,11655,23344
2030,Michoacán,16,Juárez,16046,7913,8185,16098
2030,Michoacán,16,La Huacana,16035,19093,19202,38295
2030,Michoacán,16,La Piedad,16069,56108,61376,117484
2030,Michoacán,16,Lagunillas,16048,3106,3198,6304
2030,Michoacán,16,Los Reyes,16075,37556,39437,76993
2030,Michoacán,16,Lázaro Cárdenas,16052,100739,99461,200200
2030,Michoacán,16,Madero,16049,10019,9721,19740
2030,Michoacán,16,Maravatío,16050,47000,49796,96796
2030,Michoacán,16,Marcos Castellanos,16051,7512,8017,15529
2030,Michoacán,16,Morelia,16053,417335,451949,869284
2030,Michoacán,16,Morelos,16054,4186,4828,9014
2030,Michoacán,16,Múgica,16055,25055,25472,50527
2030,Michoacán,16,Nahuatzen,16056,15251,16034,31285
2030,Michoacán,16,Nocupétaro,16057,4543,4547,9090
2030,Michoacán,16,Nuevo Parangaricutiro,16058,10653,10946,21599
2030,Michoacán,16,Nuevo Urecho,16059,4625,4532,9157
2030,Michoacán,16,Numarán,16060,5347,5860,11207
2030,Michoacán,16,Ocampo,16061,12896,12899,25795
2030,Michoacán,16,Pajacuarán,16062,10545,11314,21859
2030,Michoacán,16,Panindícuaro,16063,8763,9732,18495
2030,Michoacán,16,Paracho,16065,19919,21633,41552
2030,Michoacán,16,Parácuaro,16064,14992,14415,29407
2030,Michoacán,16,Penjamillo,16067,9329,10733,20062
2030,Michoacán,16,Peribán,16068,15269,15075,30344
2030,Michoacán,16,Puruándiro,16071,36359,39919,76278
2030,Michoacán,16,Purépero,16070,8556,8977,17533
2030,Michoacán,16,Pátzcuaro,16066,49448,53696,103144
2030,Michoacán,16,Queréndaro,16072,7593,7804,15397
2030,Michoacán,16,Quiroga,16073,14869,16192,31061
2030,Michoacán,16,Sahuayo,16076,41763,43849,85612
2030,Michoacán,16,Salvador Escalante,16079,26222,27446,53668
2030,Michoacán,16,San Lucas,16077,10307,10480,20787
2030,Michoacán,16,Santa Ana Maya,16078,6809,7687,14496
2030,Michoacán,16,Senguio,16080,10261,10783,21044
2030,Michoacán,16,Susupuato,16081,4886,4834,9720
2030,Michoacán,16,Tacámbaro,16082,41542,43045,84587
2030,Michoacán,16,Tancítaro,16083,17172,16592,33764
2030,Michoacán,16,Tangamandapio,16084,15684,16561,32245
2030,Michoacán,16,Tangancícuaro,16085,18629,19763,38392
2030,Michoacán,16,Tanhuato,16086,8599,8963,17562
2030,Michoacán,16,Taretan,16087,8215,8309,16524
2030,Michoacán,16,Tarímbaro,16088,58334,62707,121041
2030,Michoacán,16,Tepalcatepec,16089,13676,13324,27000
2030,Michoacán,16,Tingambato,16090,8071,8503,16574
2030,Michoacán,16,Tingüindín,16091,7926,8574,16500
2030,Michoacán,16,Tiquicheo de Nicolás Romero,16092,7579,7704,15283
2030,Michoacán,16,Tlalpujahua,16093,15027,16664,31691
2030,Michoacán,16,Tlazazalca,16094,3768,4055,7823
2030,Michoacán,16,Tocumbo,16095,6864,6976,13840
2030,Michoacán,16,Tumbiscatío,16096,3897,3714,7611
2030,Michoacán,16,Turicato,16097,17189,17871,35060
2030,Michoacán,16,Tuxpan,16098,14513,15338,29851
2030,Michoacán,16,Tuzantla,16099,8668,8646,17314
2030,Michoacán,16,Tzintzuntzan,16100,7694,8434,16128
2030,Michoacán,16,Tzitzio,16101,4971,4810,9781
2030,Michoacán,16,Uruapan,16102,179484,191746,371230
2030,Michoacán,16,Venustiano Carranza,16103,13824,14490,28314
2030,Michoacán,16,Villamar,16104,9499,10036,19535
2030,Michoacán,16,Vista Hermosa,16105,11440,11887,23327
2030,Michoacán,16,Yurécuaro,16106,17125,17909,35034
2030,Michoacán,16,Zacapu,16107,41121,44483,85604
2030,Michoacán,16,Zamora,16108,106451,112864,219315
2030,Michoacán,16,Zinapécuaro,16110,25809,27719,53528
2030,Michoacán,16,Zináparo,16109,1811,2111,3922
2030,Michoacán,16,Ziracuaretiro,16111,9414,9519,18933
2030,Michoacán,16,Zitácuaro,16112,85849,93893,179742
2030,Michoacán,16,Álvaro Obregón,16003,11918,12572,24490
2030,Morelos,17,Amacuzac,17001,10228,10632,20860
2030,Morelos,17,Atlatlahucan,17002,12891,13157,26048
2030,Morelos,17,Axochiapan,17003,20743,20940,41683
2030,Morelos,17,Ayala,17004,48015,50811,98826
2030,Morelos,17,Coatlán del Río,17005,5904,6002,11906
2030,Morelos,17,Cuautla,17006,109887,117467,227354
2030,Morelos,17,Cuernavaca,17007,208987,236861,445848
2030,Morelos,17,Emiliano Zapata,17008,55664,56950,112614
2030,Morelos,17,Huitzilac,17009,10920,10942,21862
2030,Morelos,17,Jantetelco,17010,9844,10146,19990
2030,Morelos,17,Jiutepec,17011,118224,125326,243550
2030,Morelos,17,Jojutla,17012,33250,35400,68650
2030,Morelos,17,Jonacatepec,17013,8974,9528,18502
2030,Morelos,17,Mazatepec,17014,5814,5994,11808
2030,Morelos,17,Miacatlán,17015,15297,15754,31051
2030,Morelos,17,Ocuituco,17016,10638,10721,21359
2030,Morelos,17,Puente de Ixtla,17017,37770,39031,76801
2030,Morelos,17,Temixco,17018,65459,67831,133290
2030,Morelos,17,Temoac,17033,9009,9350,18359
2030,Morelos,17,Tepalcingo,17019,15806,16130,31936
2030,Morelos,17,Tepoztlán,17020,27594,28247,55841
2030,Morelos,17,Tetecala,17021,4646,4631,9277
2030,Morelos,17,Tetela del Volcán,17022,11639,12006,23645
2030,Morelos,17,Tlalnepantla,17023,4211,4078,8289
2030,Morelos,17,Tlaltizapán de Zapata,17024,29979,31103,61082
2030,Morelos,17,Tlaquiltenango,17025,19958,20417,40375
2030,Morelos,17,Tlayacapan,17026,10292,10351,20643
2030,Morelos,17,Totolapan,17027,6788,6879,13667
2030,Morelos,17,Xochitepec,17028,39731,39385,79116
2030,Morelos,17,Yautepec,17029,58252,61047,119299
2030,Morelos,17,Yecapixtla,17030,29843,30264,60107
2030,Morelos,17,Zacatepec,17031,21097,22785,43882
2030,Morelos,17,Zacualpan,17032,5567,5705,11272
2030,Nayarit,18,Acaponeta,18001,23354,23232,46586
2030,Nayarit,18,Ahuacatlán,18002,10147,9943,20090
2030,Nayarit,18,Amatlán de Cañas,18003,7716,7363,15079
2030,Nayarit,18,Bahía de Banderas,18020,96731,92340,189071
2030,Nayarit,18,Compostela,18004,46796,46327,93123
2030,Nayarit,18,Del Nayar,18009,24135,24032,48167
2030,Nayarit,18,Huajicori,18005,7614,7339,14953
2030,Nayarit,18,Ixtlán del Río,18006,17561,18698,36259
2030,Nayarit,18,Jala,18007,11207,11378,22585
2030,Nayarit,18,La Yesca,18019,8514,7976,16490
2030,Nayarit,18,Rosamorada,18010,22014,20932,42946
2030,Nayarit,18,Ruíz,18011,15521,14991,30512
2030,Nayarit,18,San Blas,18012,29434,26095,55529
2030,Nayarit,18,San Pedro Lagunillas,18013,4935,4769,9704
2030,Nayarit,18,Santa María del Oro,18014,14619,14306,28925
2030,Nayarit,18,Santiago Ixcuintla,18015,62869,60453,123322
2030,Nayarit,18,Tecuala,18016,25836,24994,50830
2030,Nayarit,18,Tepic,18017,243124,256125,499249
2030,Nayarit,18,Tuxpan,18018,19492,19585,39077
2030,Nayarit,18,Xalisco,18008,33646,34750,68396
2030,Nuevo León,19,Abasolo,19001,1616,1601,3217
2030,Nuevo León,19,Agualeguas,19002,1344,1279,2623
2030,Nuevo León,19,Allende,19004,21882,21628,43510
2030,Nuevo León,19,Anáhuac,19005,11560,11623,23183
2030,Nuevo León,19,Apodaca,19006,358105,350459,708564
2030,Nuevo León,19,Aramberri,19007,10800,10413,21213
2030,Nuevo León,19,Bustamante,19008,2574,2566,5140
2030,Nuevo León,19,Cadereyta Jiménez,19009,60195,57602,117797
2030,Nuevo León,19,Cerralvo,19011,5039,4736,9775
2030,Nuevo León,19,China,19013,7349,6976,14325
2030,Nuevo León,19,Ciénega de Flores,19012,27413,26278,53691
2030,Nuevo León,19,Doctor Arroyo,19014,22867,22015,44882
2030,Nuevo León,19,Doctor Coss,19015,1212,1187,2399
2030,Nuevo León,19,Doctor González,19016,1993,1870,3863
2030,Nuevo León,19,El Carmen,19010,25465,24883,50348
2030,Nuevo León,19,Galeana,19017,26999,26128,53127
2030,Nuevo León,19,García,19018,159692,156864,316556
2030,Nuevo León,19,General Bravo,19020,3801,3602,7403
2030,Nuevo León,19,General Escobedo,19021,249105,247706,496811
2030,Nuevo León,19,General Terán,19022,9934,9918,19852
2030,Nuevo León,19,General Treviño,19023,643,674,1317
2030,Nuevo León,19,General Zaragoza,19024,3985,3695,7680
2030,Nuevo León,19,General Zuazua,19025,48686,47593,96279
2030,Nuevo León,19,Guadalupe,19026,412060,406070,818130
2030,Nuevo León,19,Hidalgo,19047,9025,8960,17985
2030,Nuevo León,19,Higueras,19028,1021,952,1973
2030,Nuevo León,19,Hualahuises,19029,4582,4596,9178
2030,Nuevo León,19,Iturbide,19030,2439,2270,4709
2030,Nuevo León,19,Juárez,19031,212792,205679,418471
2030,Nuevo León,19,Lampazos de Naranjo,19032,3461,3349,6810
2030,Nuevo León,19,Linares,19033,50930,50873,101803
2030,Nuevo León,19,Los Aldamas,19003,1081,1066,2147
2030,Nuevo León,19,Los Herreras,19027,1320,1340,2660
2030,Nuevo León,19,Los Ramones,19042,2884,2828,5712
2030,Nuevo León,19,Marín,19034,3557,3338,6895
2030,Nuevo León,19,Melchor Ocampo,19035,699,672,1371
2030,Nuevo León,19,Mier y Noriega,19036,4513,4377,8890
2030,Nuevo León,19,Mina,19037,3436,3238,6674
2030,Nuevo León,19,Montemorelos,19038,39264,39047,78311
2030,Nuevo León,19,Monterrey,19039,653077,687187,1340264
2030,Nuevo León,19,Parás,19040,687,648,1335
2030,Nuevo León,19,Pesquería,19041,60283,59622,119905
2030,Nuevo León,19,Rayones,19043,1898,1744,3642
2030,Nuevo León,19,Sabinas Hidalgo,19044,22248,23151,45399
2030,Nuevo León,19,Salinas Victoria,19045,34230,32235,66465
2030,Nuevo León,19,San Nicolás de los Garza,19046,271597,283918,555515
2030,Nuevo León,19,San Pedro Garza García,19019,76498,85505,162003
2030,Nuevo León,19,Santa Catarina,19048,179178,177129,356307
2030,Nuevo León,19,Santiago,19049,27256,26990,54246
2030,Nuevo León,19,Vallecillo,19050,1302,1137,2439
2030,Nuevo León,19,Villaldama,19051,2776,2772,5548
2030,Oaxaca,20,Abejones,20001,473,626,1099
2030,Oaxaca,20,Acatlán de Pérez Figueroa,20002,24796,25705,50501
2030,Oaxaca,20,Asunción Cacalotepec,20003,1148,1252,2400
2030,Oaxaca,20,Asunción Cuyotepeji,20004,516,584,1100
2030,Oaxaca,20,Asunción Ixtaltepec,20005,8610,8768,17378
2030,Oaxaca,20,Asunción Nochixtlán,20006,9488,10780,20268
2030,Oaxaca,20,Asunción Ocotlán,20007,1278,1573,2851
2030,Oaxaca,20,Asunción Tlacolulita,20008,439,473,912
2030,Oaxaca,20,Ayoquezco de Aldama,20398,2345,2597,4942
2030,Oaxaca,20,Ayotzintepec,20009,3817,3841,7658
2030,Oaxaca,20,Calihualá,20011,620,660,1280
2030,Oaxaca,20,Candelaria Loxicha,20012,5460,5628,11088
2030,Oaxaca,20,Capulálpam de Méndez,20247,780,958,1738
2030,Oaxaca,20,Chahuites,20025,6285,6347,12632
2030,Oaxaca,20,Chalcatongo de Hidalgo,20026,4693,5388,10081
2030,Oaxaca,20,Chiquihuitlán de Benito Juárez,20027,1204,1483,2687
2030,Oaxaca,20,Ciudad Ixtepec,20014,15412,16909,32321
2030,Oaxaca,20,Ciénega de Zimatlán,20013,1625,1815,3440
2030,Oaxaca,20,Coatecas Altas,20015,2314,2654,4968
2030,Oaxaca,20,Coicoyán de las Flores,20016,4750,5404,10154
2030,Oaxaca,20,Concepción Buenavista,20018,446,478,924
2030,Oaxaca,20,Concepción Pápalo,20019,1675,1690,3365
2030,Oaxaca,20,Constancia del Rosario,20020,1920,2187,4107
2030,Oaxaca,20,Cosolapa,20021,8245,8889,17134
2030,Oaxaca,20,Cosoltepec,20022,424,511,935
2030,Oaxaca,20,Cuilápam de Guerrero,20023,11318,11989,23307
2030,Oaxaca,20,Cuyamecalco Villa de Zaragoza,20024,2070,2062,4132
2030,Oaxaca,20,El Barrio de la Soledad,20010,7696,8329,16025
2030,Oaxaca,20,El Espinal,20030,4814,5084,9898
2030,Oaxaca,20,Eloxochitlán de Flores Magón,20029,2183,2476,4659
2030,Oaxaca,20,Fresnillo de Trujano,20032,560,618,1178
2030,Oaxaca,20,Guadalupe Etla,20033,1397,1576,2973
2030,Oaxaca,20,Guadalupe de Ramírez,20034,717,739,1456
2030,Oaxaca,20,Guelatao de Juárez,20035,307,302,609
2030,Oaxaca,20,Guevea de Humboldt,20036,2831,2917,5748
2030,Oaxaca,20,Heroica Ciudad de Ejutla de Crespo,20028,11001,12399,23400
2030,Oaxaca,20,Heroica Ciudad de Huajuapan de León,20039,39184,44088,83272
2030,Oaxaca,20,Heroica Ciudad de Juchitán de Zaragoza,20043,52168,55445,107613
2030,Oaxaca,20,Heroica Ciudad de Tlaxiaco,20397,20322,23253,43575
2030,Oaxaca,20,Huautepec,20040,3081,3574,6655
2030,Oaxaca,20,Huautla de Jiménez,20041,15732,18364,34096
2030,Oaxaca,20,Ixpantepec Nieves,20065,619,785,1404
2030,Oaxaca,20,Ixtlán de Juárez,20042,4356,4520,8876
2030,Oaxaca,20,La Compañía,20017,1780,1963,3743
2030,Oaxaca,20,La Pe,20069,1343,1446,2789
2030,Oaxaca,20,La Reforma,20076,1672,1819,3491
2030,Oaxaca,20,La Trinidad Vista Hermosa,20556,135,160,295
2030,Oaxaca,20,Loma Bonita,20044,22742,24943,47685
2030,Oaxaca,20,Magdalena Apasco,20045,4504,5013,9517
2030,Oaxaca,20,Magdalena Jaltepec,20046,1724,2004,3728
2030,Oaxaca,20,Magdalena Mixtepec,20048,667,704,1371
2030,Oaxaca,20,Magdalena Ocotlán,20049,609,660,1269
2030,Oaxaca,20,Magdalena Peñasco,20050,1768,2035,3803
2030,Oaxaca,20,Magdalena Teitipac,20051,2365,2519,4884
2030,Oaxaca,20,Magdalena Tequisistlán,20052,3392,3533,6925
2030,Oaxaca,20,Magdalena Tlacotepec,20053,689,752,1441
2030,Oaxaca,20,Magdalena Yodocono de Porfirio Díaz,20562,821,878,1699
2030,Oaxaca,20,Magdalena Zahuatlán,20054,223,251,474
2030,Oaxaca,20,Mariscala de Juárez,20055,1917,2080,3997
2030,Oaxaca,20,Matías Romero Avendaño,20057,20972,22366,43338
2030,Oaxaca,20,Mazatlán Villa de Flores,20058,7088,7234,14322
2030,Oaxaca,20,Mesones Hidalgo,20037,2204,2567,4771
2030,Oaxaca,20,Miahuatlán de Porfirio Díaz,20059,22353,24735,47088
2030,Oaxaca,20,Mixistlán de la Reforma,20060,1352,1503,2855
2030,Oaxaca,20,Monjas,20061,1384,1618,3002
2030,Oaxaca,20,Mártires de Tacubaya,20056,763,832,1595
2030,Oaxaca,20,Natividad,20062,340,402,742
2030,Oaxaca,20,Nazareno Etla,20063,2146,2357,4503
2030,Oaxaca,20,Nejapa de Madero,20064,4125,4266,8391
2030,Oaxaca,20,Nuevo Zoquiápam,20504,863,917,1780
2030,Oaxaca,20,Oaxaca de Juárez,20067,126990,147921,274911
2030,Oaxaca,20,Ocotlán de Morelos,20068,11481,12551,24032
2030,Oaxaca,20,Pinotepa de Don Luis,20070,3713,3848,7561
2030,Oaxaca,20,Pluma Hidalgo,20071,1607,1647,3254
2030,Oaxaca,20,Putla Villa de Guerrero,20073,16927,19127,36054
2030,Oaxaca,20,Reforma de Pineda,20075,1557,1663,3220
2030,Oaxaca,20,Reyes Etla,20077,2075,2206,4281
2030,Oaxaca,20,Rojas de Cuauhtémoc,20078,596,675,1271
2030,Oaxaca,20,Salina Cruz,20079,46812,50861,97673
2030,Oaxaca,20,San Agustín Amatengo,20080,803,920,1723
2030,Oaxaca,20,San Agustín Atenango,20081,938,1098,2036
2030,Oaxaca,20,San Agustín Chayuco,20082,2087,2240,4327
2030,Oaxaca,20,San Agustín Etla,20084,2156,2384,4540
2030,Oaxaca,20,San Agustín Loxicha,20085,12802,13315,26117
2030,Oaxaca,20,San Agustín Tlacotepec,20086,455,620,1075
2030,Oaxaca,20,San Agustín Yatareni,20087,2226,2530,4756
2030,Oaxaca,20,San Agustín de las Juntas,20083,4965,5199,10164
2030,Oaxaca,20,San Andrés Cabecera Nueva,20088,1516,1564,3080
2030,Oaxaca,20,San Andrés Dinicuiti,20089,1149,1214,2363
2030,Oaxaca,20,San Andrés Huaxpaltepec,20090,3234,3429,6663
2030,Oaxaca,20,San Andrés Huayápam,20091,2768,3075,5843
2030,Oaxaca,20,San Andrés Ixtlahuaca,20092,850,966,1816
2030,Oaxaca,20,San Andrés Lagunas,20093,266,309,575
2030,Oaxaca,20,San Andrés Nuxiño,20094,933,1028,1961
2030,Oaxaca,20,San Andrés Paxtlán,20095,2304,2296,4600
2030,Oaxaca,20,San Andrés Sinaxtla,20096,389,459,848
2030,Oaxaca,20,San Andrés Solaga,20097,963,1035,1998
2030,Oaxaca,20,San Andrés Teotilálpam,20098,2297,2515,4812
2030,Oaxaca,20,San Andrés Tepetlapa,20099,260,298,558
2030,Oaxaca,20,San Andrés Yaá,20100,253,298,551
2030,Oaxaca,20,San Andrés Zabache,20101,368,458,826
2030,Oaxaca,20,San Andrés Zautla,20102,2422,2604,5026
2030,Oaxaca,20,San Antonino Castillo Velasco,20103,3173,3515,6688
2030,Oaxaca,20,San Antonino Monte Verde,20105,3540,4109,7649
2030,Oaxaca,20,San Antonino el Alto,20104,1425,1455,2880
2030,Oaxaca,20,San Antonio Acutla,20106,133,168,301
2030,Oaxaca,20,San Antonio Huitepec,20108,2218,2655,4873
2030,Oaxaca,20,San Antonio Nanahuatípam,20109,686,698,1384
2030,Oaxaca,20,San Antonio Sinicahua,20110,771,910,1681
2030,Oaxaca,20,San Antonio Tepetlapa,20111,2221,2373,4594
2030,Oaxaca,20,San Antonio de la Cal,20107,12139,13593,25732
2030,Oaxaca,20,San Baltazar Chichicápam,20112,1394,1569,2963
2030,Oaxaca,20,San Baltazar Loxicha,20113,1565,1628,3193
2030,Oaxaca,20,San Baltazar Yatzachi el Bajo,20114,367,421,788
2030,Oaxaca,20,San Bartolo Coyotepec,20115,4914,5527,10441
2030,Oaxaca,20,San Bartolo Soyaltepec,20121,350,429,779
2030,Oaxaca,20,San Bartolo Yautepec,20122,380,384,764
2030,Oaxaca,20,San Bartolomé Ayautla,20116,2310,2494,4804
2030,Oaxaca,20,San Bartolomé Loxicha,20117,1231,1289,2520
2030,Oaxaca,20,San Bartolomé Quialana,20118,1151,1587,2738
2030,Oaxaca,20,San Bartolomé Yucuañe,20119,184,269,453
2030,Oaxaca,20,San Bartolomé Zoogocho,20120,171,216,387
2030,Oaxaca,20,San Bernardo Mixtepec,20123,1448,1537,2985
2030,Oaxaca,20,San Blas Atempa,20124,9737,9805,19542
2030,Oaxaca,20,San Carlos Yautepec,20125,6663,6528,13191
2030,Oaxaca,20,San Cristóbal Amatlán,20126,2582,2963,5545
2030,Oaxaca,20,San Cristóbal Amoltepec,20127,554,658,1212
2030,Oaxaca,20,San Cristóbal Lachirioag,20128,712,765,1477
2030,Oaxaca,20,San Cristóbal Suchixtlahuaca,20129,199,215,414
2030,Oaxaca,20,San Dionisio Ocotepec,20131,5529,6131,11660
2030,Oaxaca,20,San Dionisio Ocotlán,20132,640,659,1299
2030,Oaxaca,20,San Dionisio del Mar,20130,2873,2759,5632
2030,Oaxaca,20,San Esteban Atatlahuca,20133,2007,2130,4137
2030,Oaxaca,20,San Felipe Jalapa de Díaz,20134,14096,15106,29202
2030,Oaxaca,20,San Felipe Tejalápam,20135,4084,4444,8528
2030,Oaxaca,20,San Felipe Usila,20136,6038,6551,12589
2030,Oaxaca,20,San Francisco Cahuacuá,20137,1802,1849,3651
2030,Oaxaca,20,San Francisco Cajonos,20138,257,284,541
2030,Oaxaca,20,San Francisco Chapulapa,20139,1073,1150,2223
2030,Oaxaca,20,San Francisco Chindúa,20140,437,464,901
2030,Oaxaca,20,San Francisco Huehuetlán,20142,564,706,1270
2030,Oaxaca,20,San Francisco Ixhuatán,20143,4993,5010,10003
2030,Oaxaca,20,San Francisco Jaltepetongo,20144,564,606,1170
2030,Oaxaca,20,San Francisco Lachigoló,20145,2290,2362,4652
2030,Oaxaca,20,San Francisco Logueche,20146,1396,1639,3035
2030,Oaxaca,20,San Francisco Nuxaño,20147,220,211,431
2030,Oaxaca,20,San Francisco Ozolotepec,20148,987,1041,2028
2030,Oaxaca,20,San Francisco Sola,20149,869,961,1830
2030,Oaxaca,20,San Francisco Telixtlahuaca,20150,6637,7226,13863
2030,Oaxaca,20,San Francisco Teopan,20151,201,184,385
2030,Oaxaca,20,San Francisco Tlapancingo,20152,1067,1346,2413
2030,Oaxaca,20,San Francisco del Mar,20141,4225,4065,8290
2030,Oaxaca,20,San Gabriel Mixtepec,20153,2524,2670,5194
2030,Oaxaca,20,San Ildefonso Amatlán,20154,1254,1430,2684
2030,Oaxaca,20,San Ildefonso Sola,20155,520,517,1037
2030,Oaxaca,20,San Ildefonso Villa Alta,20156,1846,1975,3821
2030,Oaxaca,20,San Jacinto Amilpas,20157,8677,9630,18307
2030,Oaxaca,20,San Jacinto Tlacotepec,20158,1137,1186,2323
2030,Oaxaca,20,San Jerónimo Coatlán,20159,2702,2860,5562
2030,Oaxaca,20,San Jerónimo Silacayoapilla,20160,777,794,1571
2030,Oaxaca,20,San Jerónimo Sosola,20161,1396,1588,2984
2030,Oaxaca,20,San Jerónimo Taviche,20162,972,1046,2018
2030,Oaxaca,20,San Jerónimo Tecóatl,20163,835,957,1792
2030,Oaxaca,20,San Jerónimo Tlacochahuaya,20550,2894,3246,6140
2030,Oaxaca,20,San Jorge Nuchita,20164,1434,1742,3176
2030,Oaxaca,20,San José Ayuquila,20165,781,900,1681
2030,Oaxaca,20,San José Chiltepec,20166,6459,6731,13190
2030,Oaxaca,20,San José Estancia Grande,20168,561,577,1138
2030,Oaxaca,20,San José Independencia,20169,1951,2094,4045
2030,Oaxaca,20,San José Lachiguiri,20170,1685,2091,3776
2030,Oaxaca,20,San José Tenango,20171,9496,10362,19858
2030,Oaxaca,20,San José del Peñasco,20167,1108,1162,2270
2030,Oaxaca,20,San José del Progreso,20072,3526,3735,7261
2030,Oaxaca,20,San Juan Achiutla,20172,238,260,498
2030,Oaxaca,20,San Juan Atepec,20173,815,913,1728
2030,Oaxaca,20,San Juan Bautista Atatlahuca,20175,863,910,1773
2030,Oaxaca,20,San Juan Bautista Coixtlahuaca,20176,1450,1620,3070
2030,Oaxaca,20,San Juan Bautista Cuicatlán,20177,5367,5728,11095
2030,Oaxaca,20,San Juan Bautista Guelache,20178,3824,4292,8116
2030,Oaxaca,20,San Juan Bautista Jayacatlán,20179,846,838,1684
2030,Oaxaca,20,San Juan Bautista Lo de Soto,20180,1425,1457,2882
2030,Oaxaca,20,San Juan Bautista Suchitepec,20181,244,283,527
2030,Oaxaca,20,San Juan Bautista Tlachichilco,20183,709,812,1521
2030,Oaxaca,20,San Juan Bautista Tlacoatzintepec,20182,1121,1221,2342
2030,Oaxaca,20,San Juan Bautista Tuxtepec,20184,85045,92093,177138
2030,Oaxaca,20,San Juan Bautista Valle Nacional,20559,12035,12759,24794
2030,Oaxaca,20,San Juan Cacahuatepec,20185,4710,4989,9699
2030,Oaxaca,20,San Juan Chicomezúchil,20191,179,213,392
2030,Oaxaca,20,San Juan Chilateca,20192,800,932,1732
2030,Oaxaca,20,San Juan Cieneguilla,20186,323,357,680
2030,Oaxaca,20,San Juan Coatzóspam,20187,1166,1165,2331
2030,Oaxaca,20,San Juan Colorado,20188,5144,5505,10649
2030,Oaxaca,20,San Juan Comaltepec,20189,1469,1521,2990
2030,Oaxaca,20,San Juan Cotzocón,20190,12613,13242,25855
2030,Oaxaca,20,San Juan Diuxi,20195,627,670,1297
2030,Oaxaca,20,San Juan Evangelista Analco,20196,237,264,501
2030,Oaxaca,20,San Juan Guelavía,20197,1781,1918,3699
2030,Oaxaca,20,San Juan Guichicovi,20198,15563,17455,33018
2030,Oaxaca,20,San Juan Ihualtepec,20199,340,391,731
2030,Oaxaca,20,San Juan Juquila Mixes,20200,1996,2236,4232
2030,Oaxaca,20,San Juan Juquila Vijanos,20201,1003,1107,2110
2030,Oaxaca,20,San Juan Lachao,20202,2452,2605,5057
2030,Oaxaca,20,San Juan Lachigalla,20203,1684,1844,3528
2030,Oaxaca,20,San Juan Lajarcia,20204,341,414,755
2030,Oaxaca,20,San Juan Lalana,20205,8896,9320,18216
2030,Oaxaca,20,San Juan Mazatlán,20207,9928,9893,19821
2030,Oaxaca,20,San Juan Mixtepec Distrito 08,20208,3772,4355,8127
2030,Oaxaca,20,San Juan Mixtepec Distrito 26,20209,318,466,784
2030,Oaxaca,20,San Juan Ozolotepec,20211,1427,1429,2856
2030,Oaxaca,20,San Juan Petlapa,20212,1488,1588,3076
2030,Oaxaca,20,San Juan Quiahije,20213,1936,2216,4152
2030,Oaxaca,20,San Juan Quiotepec,20214,1139,1203,2342
2030,Oaxaca,20,San Juan Sayultepec,20215,417,490,907
2030,Oaxaca,20,San Juan Tabaá,20216,703,778,1481
2030,Oaxaca,20,San Juan Tamazola,20217,1609,1706,3315
2030,Oaxaca,20,San Juan Teita,20218,342,364,706
2030,Oaxaca,20,San Juan Teitipac,20219,1440,1582,3022
2030,Oaxaca,20,San Juan Tepeuxila,20220,1525,1449,2974
2030,Oaxaca,20,San Juan Teposcolula,20221,687,738,1425
2030,Oaxaca,20,San Juan Yaeé,20222,792,903,1695
2030,Oaxaca,20,San Juan Yatzona,20223,229,290,519
2030,Oaxaca,20,San Juan Yucuita,20224,322,375,697
2030,Oaxaca,20,San Juan de los Cués,20206,1342,1355,2697
2030,Oaxaca,20,San Juan del Estado,20193,1416,1555,2971
2030,Oaxaca,20,San Juan del Río,20194,680,806,1486
2030,Oaxaca,20,San Juan Ñumí,20210,3046,3474,6520
2030,Oaxaca,20,San Lorenzo,20225,3158,3407,6565
2030,Oaxaca,20,San Lorenzo Albarradas,20226,1573,1527,3100
2030,Oaxaca,20,San Lorenzo Cacaotepec,20227,8198,8899,17097
2030,Oaxaca,20,San Lorenzo Cuaunecuiltitla,20228,450,423,873
2030,Oaxaca,20,San Lorenzo Texmelúcan,20229,3880,4535,8415
2030,Oaxaca,20,San Lorenzo Victoria,20230,548,596,1144
2030,Oaxaca,20,San Lucas Camotlán,20231,1558,1650,3208
2030,Oaxaca,20,San Lucas Ojitlán,20232,10504,11196,21700
2030,Oaxaca,20,San Lucas Quiaviní,20233,837,1162,1999
2030,Oaxaca,20,San Lucas Zoquiápam,20234,3898,4164,8062
2030,Oaxaca,20,San Luis Amatlán,20235,1851,2217,4068
2030,Oaxaca,20,San Marcial Ozolotepec,20236,787,849,1636
2030,Oaxaca,20,San Marcos Arteaga,20237,732,834,1566
2030,Oaxaca,20,San Martín Huamelúlpam,20239,549,649,1198
2030,Oaxaca,20,San Martín Itunyoso,20240,1046,1326,2372
2030,Oaxaca,20,San Martín Lachilá,20241,555,682,1237
2030,Oaxaca,20,San Martín Peras,20242,5937,6412,12349
2030,Oaxaca,20,San Martín Tilcajete,20243,931,1090,2021
2030,Oaxaca,20,San Martín Toxpalan,20244,2006,2112,4118
2030,Oaxaca,20,San Martín Zacatepec,20245,702,753,1455
2030,Oaxaca,20,San Martín de los Cansecos,20238,470,486,956
2030,Oaxaca,20,San Mateo Cajonos,20246,319,394,713
2030,Oaxaca,20,San Mateo Etlatongo,20250,614,662,1276
2030,Oaxaca,20,San Mateo Nejápam,20251,584,658,1242
2030,Oaxaca,20,San Mateo Peñasco,20252,1085,1244,2329
2030,Oaxaca,20,San Mateo Piñas,20253,1177,1165,2342
2030,Oaxaca,20,San Mateo Río Hondo,20254,1711,1805,3516
2030,Oaxaca,20,San Mateo Sindihui,20255,1056,1173,2229
2030,Oaxaca,20,San Mateo Tlapiltepec,20256,119,139,258
2030,Oaxaca,20,San Mateo Yoloxochitlán,20249,1845,2028,3873
2030,Oaxaca,20,San Mateo Yucutindoo,20566,1640,1683,3323
2030,Oaxaca,20,San Mateo del Mar,20248,8176,7854,16030
2030,Oaxaca,20,San Melchor Betaza,20257,546,637,1183
2030,Oaxaca,20,San Miguel Achiutla,20258,421,473,894
2030,Oaxaca,20,San Miguel Ahuehuetitlán,20259,1241,1374,2615
2030,Oaxaca,20,San Miguel Aloápam,20260,1151,1293,2444
2030,Oaxaca,20,San Miguel Amatitlán,20261,3798,4268,8066
2030,Oaxaca,20,San Miguel Amatlán,20262,542,573,1115
2030,Oaxaca,20,San Miguel Chicahua,20264,1067,1323,2390
2030,Oaxaca,20,San Miguel Chimalapa,20265,3832,3659,7491
2030,Oaxaca,20,San Miguel Coatlán,20263,1623,1858,3481
2030,Oaxaca,20,San Miguel Ejutla,20268,504,590,1094
2030,Oaxaca,20,San Miguel Huautla,20270,601,698,1299
2030,Oaxaca,20,San Miguel Mixtepec,20271,1655,1715,3370
2030,Oaxaca,20,San Miguel Panixtlahuaca,20272,3026,3719,6745
2030,Oaxaca,20,San Miguel Peras,20273,1741,1849,3590
2030,Oaxaca,20,San Miguel Piedras,20274,686,747,1433
2030,Oaxaca,20,San Miguel Quetzaltepec,20275,4393,4334,8727
2030,Oaxaca,20,San Miguel Santa Flor,20276,418,416,834
2030,Oaxaca,20,San Miguel Soyaltepec,20278,20426,21703,42129
2030,Oaxaca,20,San Miguel Suchixtepec,20279,1426,1555,2981
2030,Oaxaca,20,San Miguel Tecomatlán,20281,182,172,354
2030,Oaxaca,20,San Miguel Tenango,20282,419,400,819
2030,Oaxaca,20,San Miguel Tequixtepec,20283,554,601,1155
2030,Oaxaca,20,San Miguel Tilquiápam,20284,1503,1884,3387
2030,Oaxaca,20,San Miguel Tlacamama,20285,1936,1993,3929
2030,Oaxaca,20,San Miguel Tlacotepec,20286,1633,1898,3531
2030,Oaxaca,20,San Miguel Tulancingo,20287,148,238,386
2030,Oaxaca,20,San Miguel Yotao,20288,308,341,649
2030,Oaxaca,20,San Miguel del Puerto,20266,4486,4519,9005
2030,Oaxaca,20,San Miguel del Río,20267,152,158,310
2030,Oaxaca,20,San Miguel el Grande,20269,2202,2549,4751
2030,Oaxaca,20,San Nicolás,20289,595,721,1316
2030,Oaxaca,20,San Nicolás Hidalgo,20290,519,600,1119
2030,Oaxaca,20,San Pablo Coatlán,20291,2223,2335,4558
2030,Oaxaca,20,San Pablo Cuatro Venados,20292,707,796,1503
2030,Oaxaca,20,San Pablo Etla,20293,9155,10144,19299
2030,Oaxaca,20,San Pablo Huitzo,20294,3679,4190,7869
2030,Oaxaca,20,San Pablo Huixtepec,20295,4957,5471,10428
2030,Oaxaca,20,San Pablo Macuiltianguis,20296,525,545,1070
2030,Oaxaca,20,San Pablo Tijaltepec,20297,1177,1389,2566
2030,Oaxaca,20,San Pablo Villa de Mitla,20298,6662,7321,13983
2030,Oaxaca,20,San Pablo Yaganiza,20299,557,632,1189
2030,Oaxaca,20,San Pedro Amuzgos,20300,3382,3842,7224
2030,Oaxaca,20,San Pedro Apóstol,20301,809,960,1769
2030,Oaxaca,20,San Pedro Atoyac,20302,2201,2484,4685
2030,Oaxaca,20,San Pedro Cajonos,20303,560,713,1273
2030,Oaxaca,20,San Pedro Comitancillo,20305,2293,2509,4802
2030,Oaxaca,20,San Pedro Coxcaltepec Cántaros,20304,418,470,888
2030,Oaxaca,20,San Pedro Huamelula,20307,5418,5435,10853
2030,Oaxaca,20,San Pedro Huilotepec,20308,1706,1713,3419
2030,Oaxaca,20,San Pedro Ixcatlán,20309,5969,6322,12291
2030,Oaxaca,20,San Pedro Ixtlahuaca,20310,4552,4817,9369
2030,Oaxaca,20,San Pedro Jaltepetongo,20311,305,345,650
2030,Oaxaca,20,San Pedro Jicayán,20312,6235,6831,13066
2030,Oaxaca,20,San Pedro Jocotipac,20313,425,504,929
2030,Oaxaca,20,San Pedro Juchatengo,20314,847,931,1778
2030,Oaxaca,20,San Pedro Mixtepec Distrito 22,20318,25332,26531,51863
2030,Oaxaca,20,San Pedro Mixtepec Distrito 26,20319,583,630,1213
2030,Oaxaca,20,San Pedro Molinos,20320,362,411,773
2030,Oaxaca,20,San Pedro Mártir,20315,838,1032,1870
2030,Oaxaca,20,San Pedro Mártir Quiechapa,20316,373,418,791
2030,Oaxaca,20,San Pedro Mártir Yucuxaco,20317,657,765,1422
2030,Oaxaca,20,San Pedro Nopala,20321,393,437,830
2030,Oaxaca,20,San Pedro Ocopetatillo,20322,418,499,917
2030,Oaxaca,20,San Pedro Ocotepec,20323,1102,1164,2266
2030,Oaxaca,20,San Pedro Pochutla,20324,24823,25513,50336
2030,Oaxaca,20,San Pedro Quiatoni,20325,5682,6016,11698
2030,Oaxaca,20,San Pedro Sochiápam,20326,2633,2735,5368
2030,Oaxaca,20,San Pedro Tapanatepec,20327,8039,8162,16201
2030,Oaxaca,20,San Pedro Taviche,20328,638,639,1277
2030,Oaxaca,20,San Pedro Teozacoalco,20329,675,719,1394
2030,Oaxaca,20,San Pedro Teutila,20330,2264,2348,4612
2030,Oaxaca,20,San Pedro Tidaá,20331,483,566,1049
2030,Oaxaca,20,San Pedro Topiltepec,20332,201,234,435
2030,Oaxaca,20,San Pedro Totolápam,20333,1424,1585,3009
2030,Oaxaca,20,San Pedro Yaneri,20335,486,519,1005
2030,Oaxaca,20,San Pedro Yucunama,20341,113,147,260
2030,Oaxaca,20,San Pedro Yólox,20336,903,979,1882
2030,Oaxaca,20,San Pedro el Alto,20306,1890,1973,3863
2030,Oaxaca,20,San Pedro y San Pablo Ayutla,20337,2636,3160,5796
2030,Oaxaca,20,San Pedro y San Pablo Teposcolula,20339,2168,2429,4597
2030,Oaxaca,20,San Pedro y San Pablo Tequixtepec,20340,929,1166,2095
2030,Oaxaca,20,San Raymundo Jalpan,20342,1726,2087,3813
2030,Oaxaca,20,San Sebastián Abasolo,20343,1054,1136,2190
2030,Oaxaca,20,San Sebastián Coatlán,20344,1405,1511,2916
2030,Oaxaca,20,San Sebastián Ixcapa,20345,2229,2272,4501
2030,Oaxaca,20,San Sebastián Nicananduta,20346,729,930,1659
2030,Oaxaca,20,San Sebastián Río Hondo,20347,1935,1960,3895
2030,Oaxaca,20,San Sebastián Tecomaxtlahuaca,20348,4313,4875,9188
2030,Oaxaca,20,San Sebastián Teitipac,20349,1021,1205,2226
2030,Oaxaca,20,San Sebastián Tutla,20350,9010,10588,19598
2030,Oaxaca,20,San Simón Almolongas,20351,1454,1649,3103
2030,Oaxaca,20,San Simón Zahuatlán,20352,2114,2137,4251
2030,Oaxaca,20,San Vicente Coatlán,20534,1943,2260,4203
2030,Oaxaca,20,San Vicente Lachixío,20535,1385,1594,2979
2030,Oaxaca,20,San Vicente Nuñú,20536,236,279,515
2030,Oaxaca,20,Santa Ana,20353,1153,1202,2355
2030,Oaxaca,20,Santa Ana Ateixtlahuaca,20354,282,293,575
2030,Oaxaca,20,Santa Ana Cuauhtémoc,20355,406,421,827
2030,Oaxaca,20,Santa Ana Tavela,20357,463,513,976
2030,Oaxaca,20,Santa Ana Tlapacoyan,20358,1123,1249,2372
2030,Oaxaca,20,Santa Ana Yareni,20359,499,556,1055
2030,Oaxaca,20,Santa Ana Zegache,20360,1973,2230,4203
2030,Oaxaca,20,Santa Ana del Valle,20356,1160,1210,2370
2030,Oaxaca,20,Santa Catalina Quierí,20361,454,569,1023
2030,Oaxaca,20,Santa Catarina Cuixtla,20362,762,955,1717
2030,Oaxaca,20,Santa Catarina Ixtepeji,20363,1413,1506,2919
2030,Oaxaca,20,Santa Catarina Juquila,20364,8054,8624,16678
2030,Oaxaca,20,Santa Catarina Lachatao,20365,619,671,1290
2030,Oaxaca,20,Santa Catarina Loxicha,20366,2045,2127,4172
2030,Oaxaca,20,Santa Catarina Mechoacán,20367,2391,2460,4851
2030,Oaxaca,20,Santa Catarina Minas,20368,1057,1092,2149
2030,Oaxaca,20,Santa Catarina Quiané,20369,1062,1103,2165
2030,Oaxaca,20,Santa Catarina Quioquitani,20074,281,306,587
2030,Oaxaca,20,Santa Catarina Tayata,20370,343,408,751
2030,Oaxaca,20,Santa Catarina Ticuá,20371,532,676,1208
2030,Oaxaca,20,Santa Catarina Yosonotú,20372,871,1083,1954
2030,Oaxaca,20,Santa Catarina Zapoquila,20373,218,236,454
2030,Oaxaca,20,Santa Cruz Acatepec,20374,792,875,1667
2030,Oaxaca,20,Santa Cruz Amilpas,20375,6383,7452,13835
2030,Oaxaca,20,Santa Cruz Itundujia,20377,5946,6481,12427
2030,Oaxaca,20,Santa Cruz Mixtepec,20378,1871,2023,3894
2030,Oaxaca,20,Santa Cruz Nundaco,20379,1458,1740,3198
2030,Oaxaca,20,Santa Cruz Papalutla,20380,1161,1223,2384
2030,Oaxaca,20,Santa Cruz Tacache de Mina,20381,1416,1573,2989
2030,Oaxaca,20,Santa Cruz Tacahua,20382,585,671,1256
2030,Oaxaca,20,Santa Cruz Tayata,20383,327,345,672
2030,Oaxaca,20,Santa Cruz Xitla,20384,2481,2681,5162
2030,Oaxaca,20,Santa Cruz Xoxocotlán,20385,47115,53129,100244
2030,Oaxaca,20,Santa Cruz Zenzontepec,20386,9338,9720,19058
2030,Oaxaca,20,Santa Cruz de Bravo,20376,203,225,428
2030,Oaxaca,20,Santa Gertrudis,20387,1579,1699,3278
2030,Oaxaca,20,Santa Inés Yatzeche,20389,461,601,1062
2030,Oaxaca,20,Santa Inés de Zaragoza,20569,883,1006,1889
2030,Oaxaca,20,Santa Inés del Monte,20388,1243,1292,2535
2030,Oaxaca,20,Santa Lucía Miahuatlán,20391,1741,1839,3580
2030,Oaxaca,20,Santa Lucía Monteverde,20392,3393,3752,7145
2030,Oaxaca,20,Santa Lucía Ocotlán,20393,1923,2248,4171
2030,Oaxaca,20,Santa Lucía del Camino,20390,25732,28288,54020
2030,Oaxaca,20,Santa Magdalena Jicotlán,20047,47,65,112
2030,Oaxaca,20,Santa María Alotepec,20394,1530,1575,3105
2030,Oaxaca,20,Santa María Apazco,20395,902,1158,2060
2030,Oaxaca,20,Santa María Atzompa,20399,17868,19237,37105
2030,Oaxaca,20,Santa María Camotlán,20400,862,1000,1862
2030,Oaxaca,20,Santa María Chachoápam,20404,403,456,859
2030,Oaxaca,20,Santa María Chilchotla,20406,10763,11175,21938
2030,Oaxaca,20,Santa María Chimalapa,20407,4872,4681,9553
2030,Oaxaca,20,Santa María Colotepec,20401,12680,12831,25511
2030,Oaxaca,20,Santa María Cortijo,20402,567,594,1161
2030,Oaxaca,20,Santa María Coyotepec,20403,1562,1737,3299
2030,Oaxaca,20,Santa María Ecatepec,20410,1869,1897,3766
2030,Oaxaca,20,Santa María Guelacé,20411,414,503,917
2030,Oaxaca,20,Santa María Guienagati,20412,1681,1675,3356
2030,Oaxaca,20,Santa María Huatulco,20413,23013,23655,46668
2030,Oaxaca,20,Santa María Huazolotitlán,20414,6200,6289,12489
2030,Oaxaca,20,Santa María Ipalapa,20415,2589,2806,5395
2030,Oaxaca,20,Santa María Ixcatlán,20416,275,312,587
2030,Oaxaca,20,Santa María Jacatepec,20417,4858,5304,10162
2030,Oaxaca,20,Santa María Jalapa del Marqués,20418,7016,7436,14452
2030,Oaxaca,20,Santa María Jaltianguis,20419,270,336,606
2030,Oaxaca,20,Santa María Lachixío,20420,925,1096,2021
2030,Oaxaca,20,Santa María Mixtequilla,20421,2502,2641,5143
2030,Oaxaca,20,Santa María Nativitas,20422,315,389,704
2030,Oaxaca,20,Santa María Nduayaco,20423,293,306,599
2030,Oaxaca,20,Santa María Ozolotepec,20424,2006,2126,4132
2030,Oaxaca,20,Santa María Petapa,20427,8604,9240,17844
2030,Oaxaca,20,Santa María Peñoles,20426,4333,4638,8971
2030,Oaxaca,20,Santa María Pápalo,20425,1148,1157,2305
2030,Oaxaca,20,Santa María Quiegolani,20428,1039,1017,2056
2030,Oaxaca,20,Santa María Sola,20429,811,857,1668
2030,Oaxaca,20,Santa María Tataltepec,20430,212,237,449
2030,Oaxaca,20,Santa María Tecomavaca,20431,907,965,1872
2030,Oaxaca,20,Santa María Temaxcalapa,20432,515,530,1045
2030,Oaxaca,20,Santa María Temaxcaltepec,20433,1241,1417,2658
2030,Oaxaca,20,Santa María Teopoxco,20434,2133,2451,4584
2030,Oaxaca,20,Santa María Tepantlali,20435,1944,2030,3974
2030,Oaxaca,20,Santa María Texcatitlán,20436,537,583,1120
2030,Oaxaca,20,Santa María Tlahuitoltepec,20437,4748,5209,9957
2030,Oaxaca,20,Santa María Tlalixtac,20438,899,930,1829
2030,Oaxaca,20,Santa María Tonameca,20439,13327,13365,26692
2030,Oaxaca,20,Santa María Totolapilla,20440,454,496,950
2030,Oaxaca,20,Santa María Xadani,20441,4632,4580,9212
2030,Oaxaca,20,Santa María Yalina,20442,149,179,328
2030,Oaxaca,20,Santa María Yavesía,20443,262,322,584
2030,Oaxaca,20,Santa María Yolotepec,20444,225,243,468
2030,Oaxaca,20,Santa María Yosoyúa,20445,877,883,1760
2030,Oaxaca,20,Santa María Yucuhiti,20446,3326,3684,7010
2030,Oaxaca,20,Santa María Zacatepec,20447,8192,9108,17300
2030,Oaxaca,20,Santa María Zaniza,20448,1089,1139,2228
2030,Oaxaca,20,Santa María Zoquitlán,20449,1714,1765,3479
2030,Oaxaca,20,Santa María del Rosario,20408,283,270,553
2030,Oaxaca,20,Santa María del Tule,20409,4596,5346,9942
2030,Oaxaca,20,Santa María la Asunción,20396,1579,2037,3616
2030,Oaxaca,20,Santiago Amoltepec,20450,6197,6641,12838
2030,Oaxaca,20,Santiago Apoala,20451,506,592,1098
2030,Oaxaca,20,Santiago Apóstol,20452,2010,2464,4474
2030,Oaxaca,20,Santiago Astata,20453,2145,2154,4299
2030,Oaxaca,20,Santiago Atitlán,20454,1637,1590,3227
2030,Oaxaca,20,Santiago Ayuquililla,20455,1389,1547,2936
2030,Oaxaca,20,Santiago Cacaloxtepec,20456,863,928,1791
2030,Oaxaca,20,Santiago Camotlán,20457,1700,1715,3415
2030,Oaxaca,20,Santiago Chazumba,20459,2291,2874,5165
2030,Oaxaca,20,Santiago Choápam,20460,2675,2874,5549
2030,Oaxaca,20,Santiago Comaltepec,20458,547,614,1161
2030,Oaxaca,20,Santiago Huajolotitlán,20462,2139,2523,4662
2030,Oaxaca,20,Santiago Huauclilla,20463,307,346,653
2030,Oaxaca,20,Santiago Ihuitlán Plumas,20464,190,242,432
2030,Oaxaca,20,Santiago Ixcuintepec,20465,841,870,1711
2030,Oaxaca,20,Santiago Ixtayutla,20466,6490,6791,13281
2030,Oaxaca,20,Santiago Jamiltepec,20467,9939,10785,20724
2030,Oaxaca,20,Santiago Jocotepec,20468,7284,7454,14738
2030,Oaxaca,20,Santiago Juxtlahuaca,20469,18247,20154,38401
2030,Oaxaca,20,Santiago Lachiguiri,20470,2631,2670,5301
2030,Oaxaca,20,Santiago Lalopa,20471,272,285,557
2030,Oaxaca,20,Santiago Laollaga,20472,1902,1925,3827
2030,Oaxaca,20,Santiago Laxopa,20473,700,790,1490
2030,Oaxaca,20,Santiago Llano Grande,20474,1799,1855,3654
2030,Oaxaca,20,Santiago Matatlán,20475,5055,5728,10783
2030,Oaxaca,20,Santiago Miltepec,20476,232,244,476
2030,Oaxaca,20,Santiago Minas,20477,769,771,1540
2030,Oaxaca,20,Santiago Nacaltepec,20478,1013,1112,2125
2030,Oaxaca,20,Santiago Nejapilla,20479,133,121,254
2030,Oaxaca,20,Santiago Niltepec,20066,3030,3068,6098
2030,Oaxaca,20,Santiago Nundiche,20480,506,553,1059
2030,Oaxaca,20,Santiago Nuyoó,20481,969,1093,2062
2030,Oaxaca,20,Santiago Pinotepa Nacional,20482,27830,29257,57087
2030,Oaxaca,20,Santiago Suchilquitongo,20483,5481,5867,11348
2030,Oaxaca,20,Santiago Tamazola,20484,2284,2597,4881
2030,Oaxaca,20,Santiago Tapextla,20485,1711,1630,3341
2030,Oaxaca,20,Santiago Tenango,20487,1117,1121,2238
2030,Oaxaca,20,Santiago Tepetlapa,20488,65,81,146
2030,Oaxaca,20,Santiago Tetepec,20489,2643,2635,5278
2030,Oaxaca,20,Santiago Texcalcingo,20490,1569,1702,3271
2030,Oaxaca,20,Santiago Textitlán,20491,2252,2264,4516
2030,Oaxaca,20,Santiago Tilantongo,20492,1541,1827,3368
2030,Oaxaca,20,Santiago Tillo,20493,290,333,623
2030,Oaxaca,20,Santiago Tlazoyaltepec,20494,2342,2773,5115
2030,Oaxaca,20,Santiago Xanica,20495,1637,1620,3257
2030,Oaxaca,20,Santiago Xiacuí,20496,1112,1223,2335
2030,Oaxaca,20,Santiago Yaitepec,20497,2058,2443,4501
2030,Oaxaca,20,Santiago Yaveo,20498,3809,3735,7544
2030,Oaxaca,20,Santiago Yolomécatl,20499,1078,1270,2348
2030,Oaxaca,20,Santiago Yosondúa,20500,4383,4926,9309
2030,Oaxaca,20,Santiago Yucuyachi,20501,514,582,1096
2030,Oaxaca,20,Santiago Zacatepec,20502,2847,2944,5791
2030,Oaxaca,20,Santiago Zoochila,20503,217,231,448
2030,Oaxaca,20,Santiago del Río,20461,323,357,680
2030,Oaxaca,20,Santo Domingo Albarradas,20506,415,466,881
2030,Oaxaca,20,Santo Domingo Armenta,20507,1869,1843,3712
2030,Oaxaca,20,Santo Domingo Chihuitán,20508,851,880,1731
2030,Oaxaca,20,Santo Domingo Ingenio,20505,4502,4568,9070
2030,Oaxaca,20,Santo Domingo Ixcatlán,20510,297,369,666
2030,Oaxaca,20,Santo Domingo Nuxaá,20511,1706,1794,3500
2030,Oaxaca,20,Santo Domingo Ozolotepec,20512,432,460,892
2030,Oaxaca,20,Santo Domingo Petapa,20513,5029,4944,9973
2030,Oaxaca,20,Santo Domingo Roayaga,20514,531,570,1101
2030,Oaxaca,20,Santo Domingo Tehuantepec,20515,34598,36611,71209
2030,Oaxaca,20,Santo Domingo Teojomulco,20516,2615,2722,5337
2030,Oaxaca,20,Santo Domingo Tepuxtepec,20517,2824,3237,6061
2030,Oaxaca,20,Santo Domingo Tlatayápam,20518,75,88,163
2030,Oaxaca,20,Santo Domingo Tomaltepec,20519,1624,1670,3294
2030,Oaxaca,20,Santo Domingo Tonaltepec,20521,123,164,287
2030,Oaxaca,20,Santo Domingo Tonalá,20520,3606,4081,7687
2030,Oaxaca,20,Santo Domingo Xagacía,20522,613,697,1310
2030,Oaxaca,20,Santo Domingo Yanhuitlán,20523,834,957,1791
2030,Oaxaca,20,Santo Domingo Yodohino,20524,178,192,370
2030,Oaxaca,20,Santo Domingo Zanatepec,20525,6684,6742,13426
2030,Oaxaca,20,Santo Domingo de Morelos,20509,5468,5966,11434
2030,Oaxaca,20,Santo Tomás Jalieza,20530,1835,2006,3841
2030,Oaxaca,20,Santo Tomás Mazaltepec,20531,1400,1498,2898
2030,Oaxaca,20,Santo Tomás Ocotepec,20532,1970,2253,4223
2030,Oaxaca,20,Santo Tomás Tamazulapan,20533,1186,1265,2451
2030,Oaxaca,20,Santos Reyes Nopala,20526,9021,9589,18610
2030,Oaxaca,20,Santos Reyes Pápalo,20527,1349,1453,2802
2030,Oaxaca,20,Santos Reyes Tepejillo,20528,515,655,1170
2030,Oaxaca,20,Santos Reyes Yucuná,20529,670,682,1352
2030,Oaxaca,20,Silacayoápam,20537,3594,4177,7771
2030,Oaxaca,20,Sitio de Xitlapehua,20538,358,404,762
2030,Oaxaca,20,Soledad Etla,20539,3004,3158,6162
2030,Oaxaca,20,Tamazulápam del Espíritu Santo,20031,3634,4442,8076
2030,Oaxaca,20,Tanetze de Zaragoza,20541,908,978,1886
2030,Oaxaca,20,Taniche,20542,427,512,939
2030,Oaxaca,20,Tataltepec de Valdés,20543,2992,3168,6160
2030,Oaxaca,20,Teococuilco de Marcos Pérez,20544,529,600,1129
2030,Oaxaca,20,Teotitlán de Flores Magón,20545,5043,5693,10736
2030,Oaxaca,20,Teotitlán del Valle,20546,3130,3444,6574
2030,Oaxaca,20,Teotongo,20547,508,607,1115
2030,Oaxaca,20,Tepelmeme Villa de Morelos,20548,837,997,1834
2030,Oaxaca,20,Tlacolula de Matamoros,20551,11639,13298,24937
2030,Oaxaca,20,Tlacotepec Plumas,20552,250,274,524
2030,Oaxaca,20,Tlalixtac de Cabrera,20553,5338,5925,11263
2030,Oaxaca,20,Totontepec Villa de Morelos,20554,2833,3082,5915
2030,Oaxaca,20,Trinidad Zaachila,20555,1571,1764,3335
2030,Oaxaca,20,Unión Hidalgo,20557,8375,8859,17234
2030,Oaxaca,20,Valerio Trujano,20558,732,873,1605
2030,Oaxaca,20,Villa Díaz Ordaz,20560,3479,4082,7561
2030,Oaxaca,20,Villa Hidalgo,20038,1047,1170,2217
2030,Oaxaca,20,Villa Sola de Vega,20277,6574,6763,13337
2030,Oaxaca,20,Villa Talea de Castro,20280,1246,1377,2623
2030,Oaxaca,20,Villa Tejúpam de la Unión,20486,1312,1431,2743
2030,Oaxaca,20,Villa Tezoatlán de Segura y Luna,20549,5691,6765,12456
2030,Oaxaca,20,Villa de Chilapa de Díaz,20405,1057,1346,2403
2030,Oaxaca,20,Villa de Etla,20338,5605,6234,11839
2030,Oaxaca,20,Villa de Tamazulápam del Progreso,20540,3893,4520,8413
2030,Oaxaca,20,Villa de Tututepec de Melchor Ocampo,20334,24172,24991,49163
2030,Oaxaca,20,Villa de Zaachila,20565,22339,24695,47034
2030,Oaxaca,20,Yaxe,20561,1459,1574,3033
2030,Oaxaca,20,Yogana,20563,679,785,1464
2030,Oaxaca,20,Yutanduchi de Guerrero,20564,626,698,1324
2030,Oaxaca,20,Zapotitlán Lagunas,20567,1643,1860,3503
2030,Oaxaca,20,Zapotitlán Palmas,20568,748,879,1627
2030,Oaxaca,20,Zimatlán de Álvarez,20570,10265,11652,21917
2030,Oaxaca,20,Ánimas Trujano,20174,2065,2311,4376
2030,Puebla,21,Acajete,21001,35361,37767,73128
2030,Puebla,21,Acateno,21002,5516,5398,10914
2030,Puebla,21,Acatlán,21003,19348,22457,41805
2030,Puebla,21,Acatzingo,21004,32095,33117,65212
2030,Puebla,21,Acteopan,21005,1688,1838,3526
2030,Puebla,21,Ahuacatlán,21006,8563,9561,18124
2030,Puebla,21,Ahuatlán,21007,1844,1996,3840
2030,Puebla,21,Ahuazotepec,21008,6421,6618,13039
2030,Puebla,21,Ahuehuetitla,21009,1038,1194,2232
2030,Puebla,21,Ajalpan,21010,35648,37512,73160
2030,Puebla,21,Albino Zertuche,21011,989,1157,2146
2030,Puebla,21,Aljojuca,21012,3759,4075,7834
2030,Puebla,21,Altepexi,21013,11733,12338,24071
2030,Puebla,21,Amixtlán,21014,2764,3021,5785
2030,Puebla,21,Amozoc,21015,63994,66517,130511
2030,Puebla,21,Aquixtla,21016,5042,5100,10142
2030,Puebla,21,Atempan,21017,14640,16522,31162
2030,Puebla,21,Atexcal,21018,2152,2311,4463
2030,Puebla,21,Atlequizayan,21080,1496,1652,3148
2030,Puebla,21,Atlixco,21019,74681,83368,158049
2030,Puebla,21,Atoyatempan,21020,3848,4052,7900
2030,Puebla,21,Atzala,21021,738,797,1535
2030,Puebla,21,Atzitzihuacán,21022,6787,7584,14371
2030,Puebla,21,Atzitzintla,21023,5200,5215,10415
2030,Puebla,21,Axutla,21024,561,646,1207
2030,Puebla,21,Ayotoxco de Guerrero,21025,4919,4989,9908
2030,Puebla,21,Calpan,21026,8138,8913,17051
2030,Puebla,21,Caltepec,21027,2247,2616,4863
2030,Puebla,21,Camocuautla,21028,1487,1507,2994
2030,Puebla,21,Caxhuacan,21029,2106,2288,4394
2030,Puebla,21,Cañada Morelos,21099,10744,11347,22091
2030,Puebla,21,Chalchicomula de Sesma,21045,26328,28431,54759
2030,Puebla,21,Chapulco,21046,4177,4475,8652
2030,Puebla,21,Chiautla,21047,11494,12225,23719
2030,Puebla,21,Chiautzingo,21048,11198,12213,23411
2030,Puebla,21,Chichiquila,21050,13845,14794,28639
2030,Puebla,21,Chiconcuautla,21049,9036,9480,18516
2030,Puebla,21,Chietla,21051,19929,21259,41188
2030,Puebla,21,Chigmecatitlán,21052,665,802,1467
2030,Puebla,21,Chignahuapan,21053,35269,36129,71398
2030,Puebla,21,Chignautla,21054,18181,19115,37296
2030,Puebla,21,Chila,21055,2608,2896,5504
2030,Puebla,21,Chila de la Sal,21056,872,957,1829
2030,Puebla,21,Chilchotla,21058,11215,11148,22363
2030,Puebla,21,Chinantla,21059,1283,1468,2751
2030,Puebla,21,Coatepec,21030,439,485,924
2030,Puebla,21,Coatzingo,21031,1679,1866,3545
2030,Puebla,21,Cohetzala,21032,847,850,1697
2030,Puebla,21,Cohuecan,21033,2746,2932,5678
2030,Puebla,21,Coronango,21034,22563,23218,45781
2030,Puebla,21,Coxcatlán,21035,11373,12470,23843
2030,Puebla,21,Coyomeapan,21036,7491,8262,15753
2030,Puebla,21,Coyotepec,21037,1321,1564,2885
2030,Puebla,21,Cuapiaxtla de Madero,21038,5558,5576,11134
2030,Puebla,21,Cuautempan,21039,5225,5591,10816
2030,Puebla,21,Cuautinchán,21040,5692,5712,11404
2030,Puebla,21,Cuautlancingo,21041,64779,68008,132787
2030,Puebla,21,Cuayuca de Andrade,21042,1859,2008,3867
2030,Puebla,21,Cuetzalan del Progreso,21043,27085,28420,55505
2030,Puebla,21,Cuyoaco,21044,8747,9394,18141
2030,Puebla,21,Domingo Arenas,21060,4029,4416,8445
2030,Puebla,21,Eloxochitlán,21061,6866,7313,14179
2030,Puebla,21,Epatlán,21062,2760,2929,5689
2030,Puebla,21,Esperanza,21063,8351,8811,17162
2030,Puebla,21,Francisco Z. Mena,21064,10221,10059,20280
2030,Puebla,21,General Felipe Ángeles,21065,11125,12152,23277
2030,Puebla,21,Guadalupe,21066,3279,3843,7122
2030,Puebla,21,Guadalupe Victoria,21067,9463,9975,19438
2030,Puebla,21,Hermenegildo Galeana,21068,4492,4555,9047
2030,Puebla,21,Honey,21057,4428,4713,9141
2030,Puebla,21,Huaquechula,21069,13860,15645,29505
2030,Puebla,21,Huatlatlauca,21070,3595,4402,7997
2030,Puebla,21,Huauchinango,21071,56779,62976,119755
2030,Puebla,21,Huehuetla,21072,10684,10971,21655
2030,Puebla,21,Huehuetlán el Chico,21073,4962,5177,10139
2030,Puebla,21,Huehuetlán el Grande,21150,4145,4398,8543
2030,Puebla,21,Huejotzingo,21074,40971,42629,83600
2030,Puebla,21,Hueyapan,21075,6893,7303,14196
2030,Puebla,21,Hueytamalco,21076,15222,15437,30659
2030,Puebla,21,Hueytlalpan,21077,3103,3203,6306
2030,Puebla,21,Huitzilan de Serdán,21078,8448,8288,16736
2030,Puebla,21,Huitziltepec,21079,3060,3237,6297
2030,Puebla,21,Ixcamilpa de Guerrero,21081,2088,2284,4372
2030,Puebla,21,Ixcaquixtla,21082,4880,5363,10243
2030,Puebla,21,Ixtacamaxtitlán,21083,14463,14550,29013
2030,Puebla,21,Ixtepec,21084,3948,4161,8109
2030,Puebla,21,Izúcar de Matamoros,21085,42842,47756,90598
2030,Puebla,21,Jalpan,21086,6880,7244,14124
2030,Puebla,21,Jolalpan,21087,7369,7858,15227
2030,Puebla,21,Jonotla,21088,2674,2764,5438
2030,Puebla,21,Jopala,21089,7470,7710,15180
2030,Puebla,21,Juan C. Bonilla,21090,11611,12480,24091
2030,Puebla,21,Juan Galindo,21091,5799,6688,12487
2030,Puebla,21,Juan N. Méndez,21092,3054,3118,6172
2030,Puebla,21,La Magdalena Tlatlauquitepec,21095,336,334,670
2030,Puebla,21,Lafragua,21093,4777,4880,9657
2030,Puebla,21,Libres,21094,18689,19600,38289
2030,Puebla,21,Los Reyes de Juárez,21118,15083,15429,30512
2030,Puebla,21,Mazapiltepec de Juárez,21096,1634,1652,3286
2030,Puebla,21,Mixtla,21097,1284,1446,2730
2030,Puebla,21,Molcaxac,21098,3392,3785,7177
2030,Puebla,21,Naupan,21100,5462,6024,11486
2030,Puebla,21,Nauzontla,21101,1973,2186,4159
2030,Puebla,21,Nealtican,21102,6721,7312,14033
2030,Puebla,21,Nicolás Bravo,21103,3462,3679,7141
2030,Puebla,21,Nopalucan,21104,16977,17313,34290
2030,Puebla,21,Ocotepec,21105,2746,2933,5679
2030,Puebla,21,Ocoyucan,21106,15023,16697,31720
2030,Puebla,21,Olintla,21107,6692,7002,13694
2030,Puebla,21,Oriental,21108,10048,10652,20700
2030,Puebla,21,Pahuatlán,21109,12125,13213,25338
2030,Puebla,21,Palmar de Bravo,21110,25566,25861,51427
2030,Puebla,21,Pantepec,21111,10697,11227,21924
2030,Puebla,21,Petlalcingo,21112,5401,6161,11562
2030,Puebla,21,Piaxtla,21113,2636,2890,5526
2030,Puebla,21,Puebla,21114,886074,970485,1856559
2030,Puebla,21,Quecholac,21115,27872,28721,56593
2030,Puebla,21,Quimixtlán,21116,12298,12571,24869
2030,Puebla,21,Rafael Lara Grajales,21117,7706,8222,15928
2030,Puebla,21,San Andrés Cholula,21119,80473,81847,162320
2030,Puebla,21,San Antonio Cañada,21120,2899,3281,6180
2030,Puebla,21,San Diego la Mesa Tochimiltzingo,21121,712,702,1414
2030,Puebla,21,San Felipe Teotlalcingo,21122,5847,6189,12036
2030,Puebla,21,San Felipe Tepatlán,21123,2311,2357,4668
2030,Puebla,21,San Gabriel Chilac,21124,8562,9506,18068
2030,Puebla,21,San Gregorio Atzompa,21125,5119,5343,10462
2030,Puebla,21,San Jerónimo Tecuanipan,21126,3424,3717,7141
2030,Puebla,21,San Jerónimo Xayacatlán,21127,1992,2311,4303
2030,Puebla,21,San José Chiapa,21128,4954,5004,9958
2030,Puebla,21,San José Miahuatlán,21129,7413,7985,15398
2030,Puebla,21,San Juan Atenco,21130,1888,2143,4031
2030,Puebla,21,San Juan Atzompa,21131,526,488,1014
2030,Puebla,21,San Martín Texmelucan,21132,84419,90226,174645
2030,Puebla,21,San Martín Totoltepec,21133,362,392,754
2030,Puebla,21,San Matías Tlalancaleca,21134,11566,11868,23434
2030,Puebla,21,San Miguel Ixitlán,21135,317,348,665
2030,Puebla,21,San Miguel Xoxtla,21136,6938,7293,14231
2030,Puebla,21,San Nicolás Buenos Aires,21137,5554,5745,11299
2030,Puebla,21,San Nicolás de los Ranchos,21138,6791,6972,13763
2030,Puebla,21,San Pablo Anicano,21139,2017,2204,4221
2030,Puebla,21,San Pedro Cholula,21140,72239,78360,150599
2030,Puebla,21,San Pedro Yeloixtlahuaca,21141,1914,2083,3997
2030,Puebla,21,San Salvador Huixcolotla,21144,8253,8351,16604
2030,Puebla,21,San Salvador el Seco,21142,16942,17774,34716
2030,Puebla,21,San Salvador el Verde,21143,17622,18014,35636
2030,Puebla,21,San Sebastián Tlacotepec,21145,7801,7956,15757
2030,Puebla,21,Santa Catarina Tlaltempan,21146,490,507,997
2030,Puebla,21,Santa Inés Ahuatempan,21147,3564,3947,7511
2030,Puebla,21,Santa Isabel Cholula,21148,4864,5274,10138
2030,Puebla,21,Santiago Miahuatlán,21149,13708,14484,28192
2030,Puebla,21,Santo Tomás Hueyotlipan,21151,4736,5091,9827
2030,Puebla,21,Soltepec,21152,7084,7335,14419
2030,Puebla,21,Tecali de Herrera,21153,12351,12873,25224
2030,Puebla,21,Tecamachalco,21154,42007,44323,86330
2030,Puebla,21,Tecomatlán,21155,3298,3443,6741
2030,Puebla,21,Tehuacán,21156,170279,189271,359550
2030,Puebla,21,Tehuitzingo,21157,6410,7200,13610
2030,Puebla,21,Tenampulco,21158,4257,4403,8660
2030,Puebla,21,Teopantlán,21159,2111,2623,4734
2030,Puebla,21,Teotlalco,21160,1861,1917,3778
2030,Puebla,21,Tepanco de López,21161,11061,12184,23245
2030,Puebla,21,Tepango de Rodríguez,21162,2274,2488,4762
2030,Puebla,21,Tepatlaxco de Hidalgo,21163,9621,10145,19766
2030,Puebla,21,Tepeaca,21164,43431,47085,90516
2030,Puebla,21,Tepemaxalco,21165,622,639,1261
2030,Puebla,21,Tepeojuma,21166,4709,5446,10155
2030,Puebla,21,Tepetzintla,21167,6257,6710,12967
2030,Puebla,21,Tepexco,21168,3790,3958,7748
2030,Puebla,21,Tepexi de Rodríguez,21169,12159,12447,24606
2030,Puebla,21,Tepeyahualco,21170,9746,9859,19605
2030,Puebla,21,Tepeyahualco de Cuauhtémoc,21171,1983,2127,4110
2030,Puebla,21,Tetela de Ocampo,21172,15899,16964,32863
2030,Puebla,21,Teteles de Ávila Castillo,21173,3082,3672,6754
2030,Puebla,21,Teziutlán,21174,53423,59631,113054
2030,Puebla,21,Tianguismanalco,21175,7023,7543,14566
2030,Puebla,21,Tilapa,21176,4834,5165,9999
2030,Puebla,21,Tlachichuca,21179,16610,17072,33682
2030,Puebla,21,Tlacotepec de Benito Juárez,21177,27877,30067,57944
2030,Puebla,21,Tlacuilotepec,21178,9715,9933,19648
2030,Puebla,21,Tlahuapan,21180,22725,22727,45452
2030,Puebla,21,Tlaltenango,21181,3957,4027,7984
2030,Puebla,21,Tlanepantla,21182,2676,2914,5590
2030,Puebla,21,Tlaola,21183,11022,11673,22695
2030,Puebla,21,Tlapacoya,21184,3691,3795,7486
2030,Puebla,21,Tlapanalá,21185,4741,5111,9852
2030,Puebla,21,Tlatlauquitepec,21186,29649,32757,62406
2030,Puebla,21,Tlaxco,21187,3227,3199,6426
2030,Puebla,21,Tochimilco,21188,10062,10926,20988
2030,Puebla,21,Tochtepec,21189,11642,12366,24008
2030,Puebla,21,Totoltepec de Guerrero,21190,679,821,1500
2030,Puebla,21,Tulcingo,21191,5188,5973,11161
2030,Puebla,21,Tuzamapan de Galeana,21192,3747,3892,7639
2030,Puebla,21,Tzicatlacoyan,21193,4041,4140,8181
2030,Puebla,21,Venustiano Carranza,21194,16560,17629,34189
2030,Puebla,21,Vicente Guerrero,21195,13357,14169,27526
2030,Puebla,21,Xayacatlán de Bravo,21196,873,1055,1928
2030,Puebla,21,Xicotepec,21197,44775,48095,92870
2030,Puebla,21,Xicotlán,21198,683,758,1441
2030,Puebla,21,Xiutetelco,21199,21547,23123,44670
2030,Puebla,21,Xochiapulco,21200,1973,2174,4147
2030,Puebla,21,Xochiltepec,21201,1782,2114,3896
2030,Puebla,21,Xochitlán Todos Santos,21203,3488,3867,7355
2030,Puebla,21,Xochitlán de Vicente Suárez,21202,7028,7564,14592
2030,Puebla,21,Yaonáhuac,21204,4368,4768,9136
2030,Puebla,21,Yehualtepec,21205,13634,14159,27793
2030,Puebla,21,Zacapala,21206,2490,2767,5257
2030,Puebla,21,Zacapoaxtla,21207,30213,33164,63377
2030,Puebla,21,Zacatlán,21208,45097,49762,94859
2030,Puebla,21,Zapotitlán,21209,4618,5413,10031
2030,Puebla,21,Zapotitlán de Méndez,21210,3286,3299,6585
2030,Puebla,21,Zaragoza,21211,8655,10011,18666
2030,Puebla,21,Zautla,21212,10350,11850,22200
2030,Puebla,21,Zihuateutla,21213,7507,7800,15307
2030,Puebla,21,Zinacatepec,21214,9341,10160,19501
2030,Puebla,21,Zongozotla,21215,2849,2914,5763
2030,Puebla,21,Zoquiapan,21216,1383,1555,2938
2030,Puebla,21,Zoquitlán,21217,10288,11019,21307
2030,Querétaro,22,Amealco de Bonfil,22001,38784,41012,79796
2030,Querétaro,22,Arroyo Seco,22003,8945,9385,18330
2030,Querétaro,22,Cadereyta de Montes,22004,43181,46330,89511
2030,Querétaro,22,Colón,22005,39887,39065,78952
2030,Querétaro,22,Corregidora,22006,117101,123620,240721
2030,Querétaro,22,El Marqués,22011,102692,99862,202554
2030,Querétaro,22,Ezequiel Montes,22007,25492,27267,52759
2030,Querétaro,22,Huimilpan,22008,23396,25133,48529
2030,Querétaro,22,Jalpan de Serra,22009,16813,18283,35096
2030,Querétaro,22,Landa de Matamoros,22010,11958,12667,24625
2030,Querétaro,22,Pedro Escobedo,22012,43766,44230,87996
2030,Querétaro,22,Peñamiller,22013,13036,13238,26274
2030,Querétaro,22,Pinal de Amoles,22002,16396,17201,33597
2030,Querétaro,22,Querétaro,22014,563360,574818,1138178
2030,Querétaro,22,San Joaquín,22015,5717,6367,12084
2030,Querétaro,22,San Juan del Río,22016,171193,177723,348916
2030,Querétaro,22,Tequisquiapan,22017,45127,46854,91981
2030,Querétaro,22,Tolimán,22018,17836,18564,36400
2030,Quintana Roo,23,Bacalar,23010,28133,27819,55952
2030,Quintana Roo,23,Benito Juárez,23005,502058,495986,998044
2030,Quintana Roo,23,Cozumel,23001,62968,62908,125876
2030,Quintana Roo,23,Felipe Carrillo Puerto,23002,58665,58291,116956
2030,Quintana Roo,23,Isla Mujeres,23003,15332,14040,29372
2030,Quintana Roo,23,José María Morelos,23006,28084,26244,54328
2030,Quintana Roo,23,Lázaro Cárdenas,23007,20300,19310,39610
2030,Quintana Roo,23,Othón P. Blanco,23004,167739,174436,342175
2030,Quintana Roo,23,Solidaridad,23008,142010,127875,269885
2030,Quintana Roo,23,Tulum,23009,22907,20555,43462
2030,San Luis Potosí,24,Ahualulco,24001,9594,10733,20327
2030,San Luis Potosí,24,Alaquines,24002,4732,4821,9553
2030,San Luis Potosí,24,Aquismón,24003,26668,26020,52688
2030,San Luis Potosí,24,Armadillo de los Infante,24004,2440,2492,4932
2030,San Luis Potosí,24,Axtla de Terrazas,24053,20452,21024,41476
2030,San Luis Potosí,24,Catorce,24006,5728,5529,11257
2030,San Luis Potosí,24,Cedral,24007,10430,10860,21290
2030,San Luis Potosí,24,Cerritos,24008,11996,12978,24974
2030,San Luis Potosí,24,Cerro de San Pedro,24009,2525,2456,4981
2030,San Luis Potosí,24,Charcas,24015,11685,12073,23758
2030,San Luis Potosí,24,Ciudad Fernández,24011,24473,25799,50272
2030,San Luis Potosí,24,Ciudad Valles,24013,96527,103574,200101
2030,San Luis Potosí,24,Ciudad del Maíz,24010,19700,19738,39438
2030,San Luis Potosí,24,Coxcatlán,24014,8884,8797,17681
2030,San Luis Potosí,24,Cárdenas,24005,10323,11288,21611
2030,San Luis Potosí,24,Ebano,24016,24104,24896,49000
2030,San Luis Potosí,24,El Naranjo,24058,12288,12172,24460
2030,San Luis Potosí,24,Guadalcázar,24017,15280,15003,30283
2030,San Luis Potosí,24,Huehuetlán,24018,8663,8973,17636
2030,San Luis Potosí,24,Lagunillas,24019,3283,3366,6649
2030,San Luis Potosí,24,Matehuala,24020,53151,56538,109689
2030,San Luis Potosí,24,Matlapa,24057,16857,16989,33846
2030,San Luis Potosí,24,Mexquitic de Carmona,24021,29956,32329,62285
2030,San Luis Potosí,24,Moctezuma,24022,10503,11349,21852
2030,San Luis Potosí,24,Rayón,24023,8843,9280,18123
2030,San Luis Potosí,24,Rioverde,24024,51809,54856,106665
2030,San Luis Potosí,24,Salinas,24025,16661,17891,34552
2030,San Luis Potosí,24,San Antonio,24026,5219,5089,10308
2030,San Luis Potosí,24,San Ciro de Acosta,24027,5804,6174,11978
2030,San Luis Potosí,24,San Luis Potosí,24028,439603,476528,916131
2030,San Luis Potosí,24,San Martín Chalchicuautla,24029,12076,12227,24303
2030,San Luis Potosí,24,San Nicolás Tolentino,24030,2995,3290,6285
2030,San Luis Potosí,24,San Vicente Tancuayalab,24034,8314,8270,16584
2030,San Luis Potosí,24,Santa Catarina,24031,6273,6570,12843
2030,San Luis Potosí,24,Santa María del Río,24032,21235,23184,44419
2030,San Luis Potosí,24,Santo Domingo,24033,6903,6866,13769
2030,San Luis Potosí,24,Soledad de Graciano Sánchez,24035,164462,173400,337862
2030,San Luis Potosí,24,Tamasopo,24036,17179,16761,33940
2030,San Luis Potosí,24,Tamazunchale,24037,52971,54122,107093
2030,San Luis Potosí,24,Tampacán,24038,8931,8725,17656
2030,San Luis Potosí,24,Tampamolón Corona,24039,8446,8629,17075
2030,San Luis Potosí,24,Tamuín,24040,21528,22022,43550
2030,San Luis Potosí,24,Tancanhuitz,24012,11349,11743,23092
2030,San Luis Potosí,24,Tanlajás,24041,10945,10702,21647
2030,San Luis Potosí,24,Tanquián de Escobedo,24042,8340,8754,17094
2030,San Luis Potosí,24,Tierra Nueva,24043,4833,5546,10379
2030,San Luis Potosí,24,Vanegas,24044,4366,4261,8627
2030,San Luis Potosí,24,Venado,24045,8171,8436,16607
2030,San Luis Potosí,24,Villa Hidalgo,24051,8496,8581,17077
2030,San Luis Potosí,24,Villa Juárez,24052,5901,6047,11948
2030,San Luis Potosí,24,Villa de Arista,24056,8391,8377,16768
2030,San Luis Potosí,24,Villa de Arriaga,24046,9692,9796,19488
2030,San Luis Potosí,24,Villa de Guadalupe,24047,5707,5664,11371
2030,San Luis Potosí,24,Villa de Ramos,24049,20022,20802,40824
2030,San Luis Potosí,24,Villa de Reyes,24050,26595,26744,53339
2030,San Luis Potosí,24,Villa de la Paz,24048,3030,3020,6050
2030,San Luis Potosí,24,Xilitla,24054,28247,29036,57283
2030,San Luis Potosí,24,Zaragoza,24055,13906,14236,28142
2030,Sinaloa,25,Ahome,25001,250723,260781,511504
2030,Sinaloa,25,Angostura,25002,28225,28132,56357
2030,Sinaloa,25,Badiraguato,25003,18342,16912,35254
2030,Sinaloa,25,Choix,25007,19202,18106,37308
2030,Sinaloa,25,Concordia,25004,16340,15899,32239
2030,Sinaloa,25,Cosalá,25005,9466,8999,18465
2030,Sinaloa,25,Culiacán,25006,496401,518275,1014676
2030,Sinaloa,25,El Fuerte,25010,59384,58360,117744
2030,Sinaloa,25,Elota,25008,31652,29302,60954
2030,Sinaloa,25,Escuinapa,25009,34007,33069,67076
2030,Sinaloa,25,Guasave,25011,169583,172925,342508
2030,Sinaloa,25,Mazatlán,25012,280115,288972,569087
2030,Sinaloa,25,Mocorito,25013,27967,26448,54415
2030,Sinaloa,25,Navolato,25018,87471,83559,171030
2030,Sinaloa,25,Rosario,25014,31710,30635,62345
2030,Sinaloa,25,Salvador Alvarado,25015,45691,47985,93676
2030,Sinaloa,25,San Ignacio,25016,12985,11877,24862
2030,Sinaloa,25,Sinaloa,25017,52566,51124,103690
2030,Sonora,26,Aconchi,26001,1824,1675,3499
2030,Sonora,26,Agua Prieta,26002,47776,47177,94953
2030,Sonora,26,Alamos,26003,16754,15690,32444
2030,Sonora,26,Altar,26004,5689,5605,11294
2030,Sonora,26,Arivechi,26005,808,774,1582
2030,Sonora,26,Arizpe,26006,1850,1754,3604
2030,Sonora,26,Atil,26007,395,381,776
2030,Sonora,26,Bacadéhuachi,26008,776,708,1484
2030,Sonora,26,Bacanora,26009,592,520,1112
2030,Sonora,26,Bacerac,26010,936,883,1819
2030,Sonora,26,Bacoachi,26011,1045,1035,2080
2030,Sonora,26,Banámichi,26013,1080,1054,2134
2030,Sonora,26,Bavispe,26015,1026,903,1929
2030,Sonora,26,Baviácora,26014,2268,2141,4409
2030,Sonora,26,Benito Juárez,26071,13506,13522,27028
2030,Sonora,26,Benjamín Hill,26016,3205,3335,6540
2030,Sonora,26,Bácum,26012,14279,14070,28349
2030,Sonora,26,Caborca,26017,51264,50447,101711
2030,Sonora,26,Cajeme,26018,256564,270441,527005
2030,Sonora,26,Cananea,26019,21025,21615,42640
2030,Sonora,26,Carbó,26020,3126,2871,5997
2030,Sonora,26,Cucurpe,26022,708,560,1268
2030,Sonora,26,Cumpas,26023,4038,3974,8012
2030,Sonora,26,Divisaderos,26024,502,490,992
2030,Sonora,26,Empalme,26025,34073,34393,68466
2030,Sonora,26,Etchojoa,26026,39668,38420,78088
2030,Sonora,26,Fronteras,26027,5211,5020,10231
2030,Sonora,26,General Plutarco Elías Calles,26070,10124,9951,20075
2030,Sonora,26,Granados,26028,715,699,1414
2030,Sonora,26,Guaymas,26029,96144,97726,193870
2030,Sonora,26,Hermosillo,26030,509307,525431,1034738
2030,Sonora,26,Huachinera,26031,868,810,1678
2030,Sonora,26,Huatabampo,26033,49685,49755,99440
2030,Sonora,26,Huásabas,26032,637,567,1204
2030,Sonora,26,Huépac,26034,681,659,1340
2030,Sonora,26,Imuris,26035,7659,7562,15221
2030,Sonora,26,La Colorada,26021,1460,1150,2610
2030,Sonora,26,Magdalena,26036,18682,19024,37706
2030,Sonora,26,Mazatán,26037,876,747,1623
2030,Sonora,26,Moctezuma,26038,3026,3120,6146
2030,Sonora,26,Naco,26039,3710,3696,7406
2030,Sonora,26,Nacozari de García,26041,8065,7868,15933
2030,Sonora,26,Navojoa,26042,97428,102287,199715
2030,Sonora,26,Nogales,26043,135280,135676,270956
2030,Sonora,26,Nácori Chico,26040,1376,1239,2615
2030,Sonora,26,Onavas,26044,316,276,592
2030,Sonora,26,Opodepe,26045,1877,1650,3527
2030,Sonora,26,Oquitoa,26046,249,272,521
2030,Sonora,26,Pitiquito,26047,5905,5537,11442
2030,Sonora,26,Puerto Peñasco,26048,39387,38335,77722
2030,Sonora,26,Quiriego,26049,1991,1710,3701
2030,Sonora,26,Rayón,26050,1076,978,2054
2030,Sonora,26,Rosario,26051,3421,3125,6546
2030,Sonora,26,Sahuaripa,26052,3829,3527,7356
2030,Sonora,26,San Felipe de Jesús,26053,282,269,551
2030,Sonora,26,San Ignacio Río Muerto,26072,9094,8595,17689
2030,Sonora,26,San Javier,26054,439,325,764
2030,Sonora,26,San Luis Río Colorado,26055,114088,113053,227141
2030,Sonora,26,San Miguel de Horcasitas,26056,5709,4811,10520
2030,Sonora,26,San Pedro de la Cueva,26057,1107,948,2055
2030,Sonora,26,Santa Ana,26058,9894,10217,20111
2030,Sonora,26,Santa Cruz,26059,1109,1137,2246
2030,Sonora,26,Soyopa,26061,1016,840,1856
2030,Sonora,26,Suaqui Grande,26062,790,665,1455
2030,Sonora,26,Sáric,26060,931,882,1813
2030,Sonora,26,Tepache,26063,1041,959,2000
2030,Sonora,26,Trincheras,26064,1159,943,2102
2030,Sonora,26,Tubutama,26065,732,685,1417
2030,Sonora,26,Ures,26066,5923,5653,11576
2030,Sonora,26,Villa Hidalgo,26067,1082,977,2059
2030,Sonora,26,Villa Pesqueira,26068,843,718,1561
2030,Sonora,26,Yécora,26069,3687,3563,7250
2030,Tabasco,27,Balancán,27001,36236,36170,72406
2030,Tabasco,27,Centla,27003,63984,64509,128493
2030,Tabasco,27,Centro,27004,394757,417684,812441
2030,Tabasco,27,Comalcalco,27005,117775,122111,239886
2030,Tabasco,27,Cunduacán,27006,79515,82078,161593
2030,Tabasco,27,Cárdenas,27002,148159,153958,302117
2030,Tabasco,27,Emiliano Zapata,27007,17568,19429,36997
2030,Tabasco,27,Huimanguillo,27008,108640,110903,219543
2030,Tabasco,27,Jalapa,27009,23185,23178,46363
2030,Tabasco,27,Jalpa de Méndez,27010,51246,51899,103145
2030,Tabasco,27,Jonuta,27011,18297,18243,36540
2030,Tabasco,27,Macuspana,27012,95138,99510,194648
2030,Tabasco,27,Nacajuca,27013,77945,81370,159315
2030,Tabasco,27,Paraíso,27014,55498,56280,111778
2030,Tabasco,27,Tacotalpa,27015,28850,28473,57323
2030,Tabasco,27,Teapa,27016,33579,34934,68513
2030,Tabasco,27,Tenosique,27017,34720,36705,71425
2030,Tamaulipas,28,Abasolo,28001,7389,7267,14656
2030,Tamaulipas,28,Aldama,28002,17407,16778,34185
2030,Tamaulipas,28,Altamira,28003,131920,133245,265165
2030,Tamaulipas,28,Antiguo Morelos,28004,5954,5847,11801
2030,Tamaulipas,28,Burgos,28005,2928,2699,5627
2030,Tamaulipas,28,Bustamante,28006,4976,4545,9521
2030,Tamaulipas,28,Camargo,28007,9084,8886,17970
2030,Tamaulipas,28,Casas,28008,2643,2332,4975
2030,Tamaulipas,28,Ciudad Madero,28009,116834,129959,246793
2030,Tamaulipas,28,Cruillas,28010,1166,1122,2288
2030,Tamaulipas,28,El Mante,28021,68441,72801,141242
2030,Tamaulipas,28,González,28012,25657,25624,51281
2030,Tamaulipas,28,Guerrero,28014,2789,2560,5349
2030,Tamaulipas,28,Gustavo Díaz Ordaz,28015,9504,9381,18885
2030,Tamaulipas,28,Gómez Farías,28011,5632,5336,10968
2030,Tamaulipas,28,Güémez,28013,9670,8859,18529
2030,Tamaulipas,28,Hidalgo,28016,14612,13781,28393
2030,Tamaulipas,28,Jaumave,28017,9245,8880,18125
2030,Tamaulipas,28,Jiménez,28018,4781,4756,9537
2030,Tamaulipas,28,Llera,28019,10750,10135,20885
2030,Tamaulipas,28,Mainero,28020,1650,1565,3215
2030,Tamaulipas,28,Matamoros,28022,282206,294256,576462
2030,Tamaulipas,28,Mier,28024,2531,2567,5098
2030,Tamaulipas,28,Miguel Alemán,28025,15709,15817,31526
2030,Tamaulipas,28,Miquihuana,28026,2259,2049,4308
2030,Tamaulipas,28,Méndez,28023,2420,2213,4633
2030,Tamaulipas,28,Nuevo Laredo,28027,220037,222163,442200
2030,Tamaulipas,28,Nuevo Morelos,28028,2179,1971,4150
2030,Tamaulipas,28,Ocampo,28029,8638,8082,16720
2030,Tamaulipas,28,Padilla,28030,8455,8283,16738
2030,Tamaulipas,28,Palmillas,28031,1103,1030,2133
2030,Tamaulipas,28,Reynosa,28032,353031,356675,709706
2030,Tamaulipas,28,Río Bravo,28033,71716,71944,143660
2030,Tamaulipas,28,San Carlos,28034,5756,5219,10975
2030,Tamaulipas,28,San Fernando,28035,32789,32403,65192
2030,Tamaulipas,28,San Nicolás,28036,649,570,1219
2030,Tamaulipas,28,Soto la Marina,28037,14985,14008,28993
2030,Tamaulipas,28,Tampico,28038,177231,196073,373304
2030,Tamaulipas,28,Tula,28039,17306,17262,34568
2030,Tamaulipas,28,Valle Hermoso,28040,36207,37525,73732
2030,Tamaulipas,28,Victoria,28041,191342,201793,393135
2030,Tamaulipas,28,Villagrán,28042,3984,3726,7710
2030,Tamaulipas,28,Xicoténcatl,28043,14176,14157,28333
2030,Tlaxcala,29,Acuamanala de Miguel Hidalgo,29022,3933,3887,7820
2030,Tlaxcala,29,Altzayanca,29004,10305,10205,20510
2030,Tlaxcala,29,Amaxac de Guerrero,29001,6526,6735,13261
2030,Tlaxcala,29,Apetatitlán de Antonio Carvajal,29002,8700,9313,18013
2030,Tlaxcala,29,Apizaco,29005,44714,49209,93923
2030,Tlaxcala,29,Atlangatepec,29003,3807,3910,7717
2030,Tlaxcala,29,Benito Juárez,29045,3505,3565,7070
2030,Tlaxcala,29,Calpulalpan,29006,27736,29061,56797
2030,Tlaxcala,29,Chiautempan,29010,41823,45094,86917
2030,Tlaxcala,29,Contla de Juan Cuamatzi,29018,22317,22846,45163
2030,Tlaxcala,29,Cuapiaxtla,29008,8836,8822,17658
2030,Tlaxcala,29,Cuaxomulco,29009,3136,3188,6324
2030,Tlaxcala,29,El Carmen Tequexquitla,29007,9754,9939,19693
2030,Tlaxcala,29,Emiliano Zapata,29046,2600,2673,5273
2030,Tlaxcala,29,Españita,29012,5201,5256,10457
2030,Tlaxcala,29,Huamantla,29013,52994,55320,108314
2030,Tlaxcala,29,Hueyotlipan,29014,8625,8723,17348
2030,Tlaxcala,29,Ixtacuixtla de Mariano Matamoros,29015,22968,24004,46972
2030,Tlaxcala,29,Ixtenco,29016,4210,4605,8815
2030,Tlaxcala,29,La Magdalena Tlaltelulco,29048,10421,11261,21682
2030,Tlaxcala,29,Lázaro Cárdenas,29047,1797,1801,3598
2030,Tlaxcala,29,Mazatecochco de José María Morelos,29017,6282,6363,12645
2030,Tlaxcala,29,Muñoz de Domingo Arenas,29011,2688,2680,5368
2030,Tlaxcala,29,Nanacamilpa de Mariano Arista,29021,10585,11003,21588
2030,Tlaxcala,29,Natívitas,29023,14814,15780,30594
2030,Tlaxcala,29,Panotla,29024,15655,16757,32412
2030,Tlaxcala,29,Papalotla de Xicohténcatl,29041,17247,18401,35648
2030,Tlaxcala,29,San Damián Texóloc,29049,3401,3441,6842
2030,Tlaxcala,29,San Francisco Tetlanohcan,29050,6307,6577,12884
2030,Tlaxcala,29,San Jerónimo Zacualpan,29051,2225,2468,4693
2030,Tlaxcala,29,San José Teacalco,29052,3499,3687,7186
2030,Tlaxcala,29,San Juan Huactzinco,29053,4271,4690,8961
2030,Tlaxcala,29,San Lorenzo Axocomanitla,29054,3265,3514,6779
2030,Tlaxcala,29,San Lucas Tecopilco,29055,1850,1954,3804
2030,Tlaxcala,29,San Pablo del Monte,29025,44049,44098,88147
2030,Tlaxcala,29,Sanctórum de Lázaro Cárdenas,29020,5961,6085,12046
2030,Tlaxcala,29,Santa Ana Nopalucan,29056,4555,4718,9273
2030,Tlaxcala,29,Santa Apolonia Teacalco,29057,2635,2931,5566
2030,Tlaxcala,29,Santa Catarina Ayometla,29058,5128,5579,10707
2030,Tlaxcala,29,Santa Cruz Quilehtla,29059,4157,4183,8340
2030,Tlaxcala,29,Santa Cruz Tlaxcala,29026,11857,12285,24142
2030,Tlaxcala,29,Santa Isabel Xiloxoxtla,29060,2853,3012,5865
2030,Tlaxcala,29,Tenancingo,29027,7676,7931,15607
2030,Tlaxcala,29,Teolocholco,29028,13766,14522,28288
2030,Tlaxcala,29,Tepetitla de Lardizábal,29019,11945,12811,24756
2030,Tlaxcala,29,Tepeyanco,29029,8020,8876,16896
2030,Tlaxcala,29,Terrenate,29030,9138,8957,18095
2030,Tlaxcala,29,Tetla de la Solidaridad,29031,18602,19027,37629
2030,Tlaxcala,29,Tetlatlahuca,29032,8587,9070,17657
2030,Tlaxcala,29,Tlaxcala,29033,54119,59745,113864
2030,Tlaxcala,29,Tlaxco,29034,24581,25385,49966
2030,Tlaxcala,29,Tocatlán,29035,3409,3482,6891
2030,Tlaxcala,29,Totolac,29036,12805,14046,26851
2030,Tlaxcala,29,Tzompantepec,29038,9856,10510,20366
2030,Tlaxcala,29,Xaloztoc,29039,14033,13891,27924
2030,Tlaxcala,29,Xaltocan,29040,6383,6815,13198
2030,Tlaxcala,29,Xicohtzinco,29042,7809,8676,16485
2030,Tlaxcala,29,Yauhquemehcan,29043,21863,23052,44915
2030,Tlaxcala,29,Zacatelco,29044,25349,27763,53112
2030,Tlaxcala,29,Ziltlaltépec de Trinidad Sánchez Santos,29037,5084,5546,10630
2030,Veracruz,30,Acajete,30001,4734,4581,9315
2030,Veracruz,30,Acatlán,30002,1700,1749,3449
2030,Veracruz,30,Acayucan,30003,45609,49048,94657
2030,Veracruz,30,Actopan,30004,24503,25079,49582
2030,Veracruz,30,Acula,30005,3067,3036,6103
2030,Veracruz,30,Acultzingo,30006,11839,12238,24077
2030,Veracruz,30,Agua Dulce,30204,25969,27631,53600
2030,Veracruz,30,Alpatláhuac,30008,5357,5407,10764
2030,Veracruz,30,Alto Lucero de Gutiérrez Barrios,30009,16739,16500,33239
2030,Veracruz,30,Altotonga,30010,33281,35735,69016
2030,Veracruz,30,Alvarado,30011,29901,30913,60814
2030,Veracruz,30,Amatitlán,30012,4480,4707,9187
2030,Veracruz,30,Amatlán de los Reyes,30014,23968,25980,49948
2030,Veracruz,30,Angel R. Cabada,30015,18767,19999,38766
2030,Veracruz,30,Apazapan,30017,2303,2324,4627
2030,Veracruz,30,Aquila,30018,973,1026,1999
2030,Veracruz,30,Astacinga,30019,3149,3525,6674
2030,Veracruz,30,Atlahuilco,30020,5482,5729,11211
2030,Veracruz,30,Atoyac,30021,12963,13634,26597
2030,Veracruz,30,Atzacan,30022,11188,11473,22661
2030,Veracruz,30,Atzalan,30023,27583,27503,55086
2030,Veracruz,30,Ayahualulco,30025,13975,14148,28123
2030,Veracruz,30,Banderilla,30026,12334,13754,26088
2030,Veracruz,30,Benito Juárez,30027,9350,10025,19375
2030,Veracruz,30,Boca del Río,30028,76557,88127,164684
2030,Veracruz,30,Calcahualco,30029,6697,6772,13469
2030,Veracruz,30,Camarón de Tejeda,30007,3636,3600,7236
2030,Veracruz,30,Camerino Z. Mendoza,30030,21983,25156,47139
2030,Veracruz,30,Carlos A. Carrillo,30208,13596,14982,28578
2030,Veracruz,30,Carrillo Puerto,30031,9104,9170,18274
2030,Veracruz,30,Castillo de Teayo,30157,11200,10915,22115
2030,Veracruz,30,Catemaco,30032,26174,27890,54064
2030,Veracruz,30,Cazones de Herrera,30033,12847,13628,26475
2030,Veracruz,30,Cerro Azul,30034,14451,16541,30992
2030,Veracruz,30,Chacaltianguis,30054,6960,7291,14251
2030,Veracruz,30,Chalma,30055,7468,7774,15242
2030,Veracruz,30,Chiconamel,30056,3568,3832,7400
2030,Veracruz,30,Chiconquiaco,30057,7537,7551,15088
2030,Veracruz,30,Chicontepec,30058,31033,33027,64060
2030,Veracruz,30,Chinameca,30059,8730,9088,17818
2030,Veracruz,30,Chinampa de Gorostiza,30060,9033,9335,18368
2030,Veracruz,30,Chocamán,30062,11183,11139,22322
2030,Veracruz,30,Chontla,30063,8144,8298,16442
2030,Veracruz,30,Chumatlán,30064,2044,2182,4226
2030,Veracruz,30,Citlaltépetl,30035,6514,6846,13360
2030,Veracruz,30,Coacoatzintla,30036,5356,5569,10925
2030,Veracruz,30,Coahuitlán,30037,4412,4550,8962
2030,Veracruz,30,Coatepec,30038,48571,53167,101738
2030,Veracruz,30,Coatzacoalcos,30039,169792,181615,351407
2030,Veracruz,30,Coatzintla,30040,29951,31872,61823
2030,Veracruz,30,Coetzala,30041,1202,1246,2448
2030,Veracruz,30,Colipa,30042,3110,3204,6314
2030,Veracruz,30,Comapa,30043,11172,10603,21775
2030,Veracruz,30,Cosamaloapan de Carpio,30045,31540,34701,66241
2030,Veracruz,30,Cosautlán de Carvajal,30046,8850,8903,17753
2030,Veracruz,30,Coscomatepec,30047,29865,30713,60578
2030,Veracruz,30,Cosoleacaque,30048,70685,75304,145989
2030,Veracruz,30,Cotaxtla,30049,11558,11469,23027
2030,Veracruz,30,Coxquihui,30050,8920,9326,18246
2030,Veracruz,30,Coyutla,30051,11779,12676,24455
2030,Veracruz,30,Cuichapa,30052,6422,6999,13421
2030,Veracruz,30,Cuitláhuac,30053,14697,16095,30792
2030,Veracruz,30,Córdoba,30044,111086,126580,237666
2030,Veracruz,30,El Higo,30205,11020,11167,22187
2030,Veracruz,30,Emiliano Zapata,30065,41495,44570,86065
2030,Veracruz,30,Espinal,30066,14632,15242,29874
2030,Veracruz,30,Filomeno Mata,30067,9406,9460,18866
2030,Veracruz,30,Fortín,30068,34136,38370,72506
2030,Veracruz,30,Gutiérrez Zamora,30069,13272,15041,28313
2030,Veracruz,30,Hidalgotitlán,30070,10825,10317,21142
2030,Veracruz,30,Huatusco,30071,31061,33581,64642
2030,Veracruz,30,Huayacocotla,30072,11318,12114,23432
2030,Veracruz,30,Hueyapan de Ocampo,30073,23279,24451,47730
2030,Veracruz,30,Huiloapan de Cuauhtémoc,30074,3801,4111,7912
2030,Veracruz,30,Ignacio de la Llave,30075,9479,10436,19915
2030,Veracruz,30,Ilamatlán,30076,7045,7837,14882
2030,Veracruz,30,Isla,30077,22998,23893,46891
2030,Veracruz,30,Ixcatepec,30078,7546,7668,15214
2030,Veracruz,30,Ixhuacán de los Reyes,30079,6160,6100,12260
2030,Veracruz,30,Ixhuatlancillo,30081,12957,14206,27163
2030,Veracruz,30,Ixhuatlán de Madero,30083,29066,30818,59884
2030,Veracruz,30,Ixhuatlán del Café,30080,12261,12260,24521
2030,Veracruz,30,Ixhuatlán del Sureste,30082,8578,8408,16986
2030,Veracruz,30,Ixmatlahuacan,30084,3272,3301,6573
2030,Veracruz,30,Ixtaczoquitlán,30085,35962,38203,74165
2030,Veracruz,30,Jalacingo,30086,22471,23637,46108
2030,Veracruz,30,Jalcomulco,30088,2894,2878,5772
2030,Veracruz,30,Jamapa,30090,6169,6473,12642
2030,Veracruz,30,Jesús Carranza,30091,15977,15958,31935
2030,Veracruz,30,Jilotepec,30093,8852,9297,18149
2030,Veracruz,30,José Azueta,30169,12694,13022,25716
2030,Veracruz,30,Juan Rodríguez Clara,30094,21398,21747,43145
2030,Veracruz,30,Juchique de Ferrer,30095,9031,8968,17999
2030,Veracruz,30,Jáltipan,30089,22211,24369,46580
2030,Veracruz,30,La Antigua,30016,14384,15588,29972
2030,Veracruz,30,La Perla,30127,13806,14220,28026
2030,Veracruz,30,Landero y Coss,30096,889,948,1837
2030,Veracruz,30,Las Choapas,30061,43182,44666,87848
2030,Veracruz,30,Las Minas,30107,1598,1555,3153
2030,Veracruz,30,Las Vigas de Ramírez,30132,10292,10473,20765
2030,Veracruz,30,Lerdo de Tejada,30097,10618,12325,22943
2030,Veracruz,30,Los Reyes,30137,3056,3092,6148
2030,Veracruz,30,Magdalena,30098,1592,1623,3215
2030,Veracruz,30,Maltrata,30099,9287,9876,19163
2030,Veracruz,30,Manlio Fabio Altamirano,30100,12926,13396,26322
2030,Veracruz,30,Mariano Escobedo,30101,18464,19935,38399
2030,Veracruz,30,Martínez de la Torre,30102,56076,61190,117266
2030,Veracruz,30,Mecatlán,30103,6400,6620,13020
2030,Veracruz,30,Mecayapan,30104,9033,9278,18311
2030,Veracruz,30,Medellín,30105,40399,43975,84374
2030,Veracruz,30,Miahuatlán,30106,2467,2556,5023
2030,Veracruz,30,Minatitlán,30108,85821,91661,177482
2030,Veracruz,30,Misantla,30109,35040,36682,71722
2030,Veracruz,30,Mixtla de Altamirano,30110,6107,6003,12110
2030,Veracruz,30,Moloacán,30111,9276,9771,19047
2030,Veracruz,30,Nanchital de Lázaro Cárdenas del Rio,30206,15906,16821,32727
2030,Veracruz,30,Naolinco,30112,11669,12162,23831
2030,Veracruz,30,Naranjal,30113,2389,2557,4946
2030,Veracruz,30,Naranjos Amatlán,30013,15196,17133,32329
2030,Veracruz,30,Nautla,30114,6138,6371,12509
2030,Veracruz,30,Nogales,30115,19674,21835,41509
2030,Veracruz,30,Oluta,30116,8588,9287,17875
2030,Veracruz,30,Omealca,30117,12816,13606,26422
2030,Veracruz,30,Orizaba,30118,65817,79192,145009
2030,Veracruz,30,Otatitlán,30119,3044,3344,6388
2030,Veracruz,30,Oteapan,30120,8551,8864,17415
2030,Veracruz,30,Ozuluama de Mascareñas,30121,13568,13007,26575
2030,Veracruz,30,Pajapan,30122,9296,9156,18452
2030,Veracruz,30,Papantla,30124,87231,89216,176447
2030,Veracruz,30,Paso de Ovejas,30126,18766,18951,37717
2030,Veracruz,30,Paso del Macho,30125,17086,17299,34385
2030,Veracruz,30,Perote,30128,38247,39062,77309
2030,Veracruz,30,Platón Sánchez,30129,10033,10453,20486
2030,Veracruz,30,Playa Vicente,30130,20815,22123,42938
2030,Veracruz,30,Poza Rica de Hidalgo,30131,107582,121898,229480
2030,Veracruz,30,Pueblo Viejo,30133,31453,31740,63193
2030,Veracruz,30,Puente Nacional,30134,12426,12753,25179
2030,Veracruz,30,Pánuco,30123,55452,55903,111355
2030,Veracruz,30,Rafael Delgado,30135,11831,12369,24200
2030,Veracruz,30,Rafael Lucio,30136,4132,4390,8522
2030,Veracruz,30,Río Blanco,30138,22155,25442,47597
2030,Veracruz,30,Saltabarranca,30139,3427,3681,7108
2030,Veracruz,30,San Andrés Tenejapan,30140,1490,1577,3067
2030,Veracruz,30,San Andrés Tuxtla,30141,86311,92936,179247
2030,Veracruz,30,San Juan Evangelista,30142,18549,19069,37618
2030,Veracruz,30,San Rafael,30211,16226,17015,33241
2030,Veracruz,30,Santiago Sochiapan,30212,6809,7311,14120
2030,Veracruz,30,Santiago Tuxtla,30143,30860,33113,63973
2030,Veracruz,30,Sayula de Alemán,30144,17577,17928,35505
2030,Veracruz,30,Sochiapa,30146,1929,1942,3871
2030,Veracruz,30,Soconusco,30145,8511,8904,17415
2030,Veracruz,30,Soledad Atzompa,30147,11852,11990,23842
2030,Veracruz,30,Soledad de Doblado,30148,15368,15655,31023
2030,Veracruz,30,Soteapan,30149,17701,18208,35909
2030,Veracruz,30,Tamalín,30150,6516,6496,13012
2030,Veracruz,30,Tamiahua,30151,13573,13557,27130
2030,Veracruz,30,Tampico Alto,30152,7436,6955,14391
2030,Veracruz,30,Tancoco,30153,3219,3442,6661
2030,Veracruz,30,Tantima,30154,7570,7366,14936
2030,Veracruz,30,Tantoyuca,30155,55524,57426,112950
2030,Veracruz,30,Tatahuicapan de Juárez,30209,8484,8687,17171
2030,Veracruz,30,Tatatila,30156,3233,3004,6237
2030,Veracruz,30,Tecolutla,30158,13445,13744,27189
2030,Veracruz,30,Tehuipango,30159,12888,13636,26524
2030,Veracruz,30,Tempoal,30161,19750,20308,40058
2030,Veracruz,30,Tenampa,30162,3609,3677,7286
2030,Veracruz,30,Tenochtitlán,30163,2795,2908,5703
2030,Veracruz,30,Teocelo,30164,8901,9454,18355
2030,Veracruz,30,Tepatlaxco,30165,4729,4404,9133
2030,Veracruz,30,Tepetlán,30166,5438,5194,10632
2030,Veracruz,30,Tepetzintla,30167,8040,8311,16351
2030,Veracruz,30,Tequila,30168,7813,8090,15903
2030,Veracruz,30,Texcatepec,30170,5714,5864,11578
2030,Veracruz,30,Texhuacán,30171,2741,2966,5707
2030,Veracruz,30,Texistepec,30172,11495,11388,22883
2030,Veracruz,30,Tezonapa,30173,30650,31296,61946
2030,Veracruz,30,Tierra Blanca,30174,56473,60812,117285
2030,Veracruz,30,Tihuatlán,30175,51383,53604,104987
2030,Veracruz,30,Tlachichilco,30180,6309,6432,12741
2030,Veracruz,30,Tlacojalpan,30176,2734,2818,5552
2030,Veracruz,30,Tlacolulan,30177,5988,5807,11795
2030,Veracruz,30,Tlacotalpan,30178,7398,8181,15579
2030,Veracruz,30,Tlacotepec de Mejía,30179,2140,2185,4325
2030,Veracruz,30,Tlalixcoyan,30181,21153,21905,43058
2030,Veracruz,30,Tlalnelhuayocan,30182,9587,9934,19521
2030,Veracruz,30,Tlaltetela,30024,8479,8202,16681
2030,Veracruz,30,Tlapacoyan,30183,32495,34462,66957
2030,Veracruz,30,Tlaquilpa,30184,3763,4254,8017
2030,Veracruz,30,Tlilapan,30185,2706,2867,5573
2030,Veracruz,30,Tomatlán,30186,3787,3879,7666
2030,Veracruz,30,Tonayán,30187,2929,3097,6026
2030,Veracruz,30,Totutla,30188,9443,9468,18911
2030,Veracruz,30,Tres Valles,30207,25150,26322,51472
2030,Veracruz,30,Tuxpan,30189,85895,91483,177378
2030,Veracruz,30,Tuxtilla,30190,1285,1323,2608
2030,Veracruz,30,Ursulo Galván,30191,16981,18056,35037
2030,Veracruz,30,Uxpanapa,30210,15975,15316,31291
2030,Veracruz,30,Vega de Alatorre,30192,11079,11733,22812
2030,Veracruz,30,Veracruz,30193,308457,341630,650087
2030,Veracruz,30,Villa Aldama,30194,6018,6217,12235
2030,Veracruz,30,Xalapa,30087,246773,282839,529612
2030,Veracruz,30,Xico,30092,20214,21005,41219
2030,Veracruz,30,Xoxocotla,30195,2903,2813,5716
2030,Veracruz,30,Yanga,30196,9492,10756,20248
2030,Veracruz,30,Yecuatla,30197,6730,6849,13579
2030,Veracruz,30,Zacualpan,30198,3880,4143,8023
2030,Veracruz,30,Zaragoza,30199,5823,6027,11850
2030,Veracruz,30,Zentla,30200,7486,7297,14783
2030,Veracruz,30,Zongolica,30201,23184,23590,46774
2030,Veracruz,30,Zontecomatlán de López y Fuentes,30202,7598,7887,15485
2030,Veracruz,30,Zozocolco de Hidalgo,30203,7984,8314,16298
2030,Veracruz,30,Álamo Temapache,30160,58201,58954,117155
2030,Yucatán,31,Abalá,31001,3965,3756,7721
2030,Yucatán,31,Acanceh,31002,9547,9530,19077
2030,Yucatán,31,Akil,31003,6275,6507,12782
2030,Yucatán,31,Baca,31004,3592,3689,7281
2030,Yucatán,31,Bokobá,31005,1351,1308,2659
2030,Yucatán,31,Buctzotz,31006,5366,5344,10710
2030,Yucatán,31,Cacalchén,31007,4455,4231,8686
2030,Yucatán,31,Calotmul,31008,2482,2466,4948
2030,Yucatán,31,Cansahcab,31009,2855,2948,5803
2030,Yucatán,31,Cantamayec,31010,1520,1394,2914
2030,Yucatán,31,Celestún,31011,4584,4318,8902
2030,Yucatán,31,Cenotillo,31012,2356,2494,4850
2030,Yucatán,31,Chacsinkín,31016,1740,1685,3425
2030,Yucatán,31,Chankom,31017,2749,2638,5387
2030,Yucatán,31,Chapab,31018,1923,1886,3809
2030,Yucatán,31,Chemax,31019,20536,20184,40720
2030,Yucatán,31,Chichimilá,31021,4815,4765,9580
2030,Yucatán,31,Chicxulub Pueblo,31020,2725,2593,5318
2030,Yucatán,31,Chikindzonot,31022,2421,2342,4763
2030,Yucatán,31,Chocholá,31023,2881,2809,5690
2030,Yucatán,31,Chumayel,31024,1938,1951,3889
2030,Yucatán,31,Conkal,31013,6570,6565,13135
2030,Yucatán,31,Cuncunul,31014,970,931,1901
2030,Yucatán,31,Cuzamá,31015,3070,2985,6055
2030,Yucatán,31,Dzemul,31026,2297,2288,4585
2030,Yucatán,31,Dzidzantún,31027,5156,5004,10160
2030,Yucatán,31,Dzilam González,31029,3828,3614,7442
2030,Yucatán,31,Dzilam de Bravo,31028,1677,1557,3234
2030,Yucatán,31,Dzitás,31030,2321,2221,4542
2030,Yucatán,31,Dzoncauich,31031,1623,1652,3275
2030,Yucatán,31,Dzán,31025,3065,3158,6223
2030,Yucatán,31,Espita,31032,9502,9307,18809
2030,Yucatán,31,Halachó,31033,12062,11781,23843
2030,Yucatán,31,Hocabá,31034,3701,3682,7383
2030,Yucatán,31,Hoctún,31035,3540,3638,7178
2030,Yucatán,31,Homún,31036,4602,4414,9016
2030,Yucatán,31,Huhí,31037,3166,3037,6203
2030,Yucatán,31,Hunucmá,31038,18908,18995,37903
2030,Yucatán,31,Ixil,31039,2430,2364,4794
2030,Yucatán,31,Izamal,31040,15951,16346,32297
2030,Yucatán,31,Kanasín,31041,56395,57346,113741
2030,Yucatán,31,Kantunil,31042,3185,3321,6506
2030,Yucatán,31,Kaua,31043,1791,1730,3521
2030,Yucatán,31,Kinchil,31044,4216,4124,8340
2030,Yucatán,31,Kopomá,31045,1580,1498,3078
2030,Yucatán,31,Mama,31046,1808,1923,3731
2030,Yucatán,31,Maní,31047,3249,3389,6638
2030,Yucatán,31,Maxcanú,31048,13457,13232,26689
2030,Yucatán,31,Mayapán,31049,2113,1972,4085
2030,Yucatán,31,Mocochá,31051,1991,1961,3952
2030,Yucatán,31,Motul,31052,21434,21853,43287
2030,Yucatán,31,Muna,31053,7504,7695,15199
2030,Yucatán,31,Muxupip,31054,1696,1767,3463
2030,Yucatán,31,Mérida,31050,512657,560171,1072828
2030,Yucatán,31,Opichén,31055,4021,3862,7883
2030,Yucatán,31,Oxkutzcab,31056,17314,18684,35998
2030,Yucatán,31,Panabá,31057,4645,4677,9322
2030,Yucatán,31,Peto,31058,14651,14839,29490
2030,Yucatán,31,Progreso,31059,34510,35049,69559
2030,Yucatán,31,Quintana Roo,31060,596,592,1188
2030,Yucatán,31,Río Lagartos,31061,2193,2049,4242
2030,Yucatán,31,Sacalum,31062,2897,2763,5660
2030,Yucatán,31,Samahil,31063,3063,3029,6092
2030,Yucatán,31,San Felipe,31065,1205,1118,2323
2030,Yucatán,31,Sanahcat,31064,1038,1029,2067
2030,Yucatán,31,Santa Elena,31066,2291,2364,4655
2030,Yucatán,31,Seyé,31067,5846,5552,11398
2030,Yucatán,31,Sinanché,31068,2036,1883,3919
2030,Yucatán,31,Sotuta,31069,5346,5157,10503
2030,Yucatán,31,Sucilá,31070,2434,2335,4769
2030,Yucatán,31,Sudzal,31071,1062,968,2030
2030,Yucatán,31,Suma,31072,1172,1146,2318
2030,Yucatán,31,Tahdziú,31073,2848,2705,5553
2030,Yucatán,31,Tahmek,31074,2353,2279,4632
2030,Yucatán,31,Teabo,31075,3818,3803,7621
2030,Yucatán,31,Tecoh,31076,10361,10311,20672
2030,Yucatán,31,Tekal de Venegas,31077,1624,1574,3198
2030,Yucatán,31,Tekantó,31078,2328,2362,4690
2030,Yucatán,31,Tekax,31079,24369,25029,49398
2030,Yucatán,31,Tekit,31080,6026,5863,11889
2030,Yucatán,31,Tekom,31081,1856,1910,3766
2030,Yucatán,31,Telchac Pueblo,31082,2370,2357,4727
2030,Yucatán,31,Telchac Puerto,31083,1111,1014,2125
2030,Yucatán,31,Temax,31084,4408,4385,8793
2030,Yucatán,31,Temozón,31085,9068,8849,17917
2030,Yucatán,31,Tepakán,31086,1412,1359,2771
2030,Yucatán,31,Tetiz,31087,2962,2939,5901
2030,Yucatán,31,Teya,31088,1211,1209,2420
2030,Yucatán,31,Ticul,31089,23141,23864,47005
2030,Yucatán,31,Timucuy,31090,4361,4200,8561
2030,Yucatán,31,Tinum,31091,7008,6804,13812
2030,Yucatán,31,Tixcacalcupul,31092,4098,4028,8126
2030,Yucatán,31,Tixkokob,31093,10734,10968,21702
2030,Yucatán,31,Tixmehuac,31094,2826,2827,5653
2030,Yucatán,31,Tixpéhual,31095,3288,3399,6687
2030,Yucatán,31,Tizimín,31096,44635,45932,90567
2030,Yucatán,31,Tunkás,31097,2201,2109,4310
2030,Yucatán,31,Tzucacab,31098,8632,8481,17113
2030,Yucatán,31,Uayma,31099,2406,2313,4719
2030,Yucatán,31,Ucú,31100,2202,2158,4360
2030,Yucatán,31,Umán,31101,31577,31561,63138
2030,Yucatán,31,Valladolid,31102,45611,46587,92198
2030,Yucatán,31,Xocchel,31103,2112,2033,4145
2030,Yucatán,31,Yaxcabá,31104,9132,8593,17725
2030,Yucatán,31,Yaxkukul,31105,1867,1874,3741
2030,Yucatán,31,Yobaín,31106,1426,1367,2793
2030,Zacatecas,32,Apozol,32001,3387,3643,7030
2030,Zacatecas,32,Apulco,32002,2615,2876,5491
2030,Zacatecas,32,Atolinga,32003,1451,1596,3047
2030,Zacatecas,32,Benito Juárez,32004,2341,2328,4669
2030,Zacatecas,32,Calera,32005,24185,24120,48305
2030,Zacatecas,32,Cañitas de Felipe Pescador,32006,4658,4759,9417
2030,Zacatecas,32,Chalchihuites,32009,6387,6733,13120
2030,Zacatecas,32,Concepción del Oro,32007,7635,7546,15181
2030,Zacatecas,32,Cuauhtémoc,32008,6781,7127,13908
2030,Zacatecas,32,El Plateado de Joaquín Amaro,32015,679,726,1405
2030,Zacatecas,32,El Salvador,32041,1438,1406,2844
2030,Zacatecas,32,Fresnillo,32010,125398,129351,254749
2030,Zacatecas,32,Genaro Codina,32012,4465,4610,9075
2030,Zacatecas,32,General Enrique Estrada,32013,3472,3511,6983
2030,Zacatecas,32,General Francisco R. Murguía,32014,12171,12760,24931
2030,Zacatecas,32,General Pánfilo Natera,32016,12627,13143,25770
2030,Zacatecas,32,Guadalupe,32017,99929,104965,204894
2030,Zacatecas,32,Huanusco,32018,2334,2510,4844
2030,Zacatecas,32,Jalpa,32019,13401,14128,27529
2030,Zacatecas,32,Jerez,32020,33129,35647,68776
2030,Zacatecas,32,Jiménez del Teul,32021,2371,2450,4821
2030,Zacatecas,32,Juan Aldama,32022,11836,12505,24341
2030,Zacatecas,32,Juchipila,32023,6923,7848,14771
2030,Zacatecas,32,Loreto,32024,29103,29531,58634
2030,Zacatecas,32,Luis Moya,32025,7346,7454,14800
2030,Zacatecas,32,Mazapil,32026,10562,9685,20247
2030,Zacatecas,32,Melchor Ocampo,32027,1828,1582,3410
2030,Zacatecas,32,Mezquital del Oro,32028,1397,1510,2907
2030,Zacatecas,32,Miguel Auza,32029,12808,13353,26161
2030,Zacatecas,32,Momax,32030,1372,1508,2880
2030,Zacatecas,32,Monte Escobedo,32031,5314,5581,10895
2030,Zacatecas,32,Morelos,32032,6875,6927,13802
2030,Zacatecas,32,Moyahua de Estrada,32033,2259,2633,4892
2030,Zacatecas,32,Nochistlán de Mejía,32034,15264,17083,32347
2030,Zacatecas,32,Noria de Ángeles,32035,9165,9368,18533
2030,Zacatecas,32,Ojocaliente,32036,23189,24086,47275
2030,Zacatecas,32,Pinos,32038,39704,41392,81096
2030,Zacatecas,32,Pánuco,32037,9824,9768,19592
2030,Zacatecas,32,Río Grande,32039,35061,37222,72283
2030,Zacatecas,32,Sain Alto,32040,12101,12705,24806
2030,Zacatecas,32,Santa María de la Paz,32058,1488,1546,3034
2030,Zacatecas,32,Sombrerete,32042,34609,35631,70240
2030,Zacatecas,32,Susticacán,32043,763,838,1601
2030,Zacatecas,32,Tabasco,32044,8552,9080,17632
2030,Zacatecas,32,Tepechitlán,32045,4808,5301,10109
2030,Zacatecas,32,Tepetongo,32046,4143,4511,8654
2030,Zacatecas,32,Teúl de González Ortega,32047,2882,3068,5950
2030,Zacatecas,32,Tlaltenango de Sánchez Román,32048,14582,15376,29958
2030,Zacatecas,32,Trancoso,32057,10514,10770,21284
2030,Zacatecas,32,Trinidad García de la Cadena,32011,1651,1755,3406
2030,Zacatecas,32,Valparaíso,32049,18796,19701,38497
2030,Zacatecas,32,Vetagrande,32050,5423,5525,10948
2030,Zacatecas,32,Villa García,32052,10442,10518,20960
2030,Zacatecas,32,Villa González Ortega,32053,7168,7591,14759
2030,Zacatecas,32,Villa Hidalgo,32054,10484,10616,21100
2030,Zacatecas,32,Villa de Cos,32051,19910,19534,39444
2030,Zacatecas,32,Villanueva,32055,17020,17943,34963
2030,Zacatecas,32,Zacatecas,32056,79545,85141,164686
